id,district_id,electoral_district_id,eligible_voters,voters,invalid_votes,valid_votes,vote_yes,vote_no,voter_turnout,invalid_votes_percentage,valid_votes_percentage,vote_yes_percentage,vote_no_percentage
011A,01,1A,0,521,1,520,293,227,inf,0.19193857965451055,99.80806142034548,56.23800383877159,43.5700575815739
011B,01,1B,0,541,1,540,333,207,inf,0.18484288354898337,99.81515711645102,61.552680221811464,38.262476894639555
011C,01,1C,0,539,2,537,310,227,inf,0.3710575139146568,99.62894248608535,57.5139146567718,42.11502782931355
011D,01,1D,0,544,2,542,306,236,inf,0.3676470588235294,99.63235294117648,56.25,43.38235294117647
011E,01,1E,0,544,2,542,353,189,inf,0.3676470588235294,99.63235294117648,64.88970588235294,34.74264705882353
011F,01,1F,0,1097,1,1096,676,420,inf,0.09115770282588878,99.90884229717412,61.62260711030082,38.28623518687329
011G,01,1G,0,1053,0,1053,632,421,inf,0.0,100.0,60.01899335232669,39.98100664767331
011H,01,1H,0,1091,1,1090,664,426,inf,0.09165902841429881,99.9083409715857,60.861594867094404,39.04674610449129
011J,01,1J,0,1101,1,1100,669,431,inf,0.09082652134423251,99.90917347865576,60.76294277929155,39.14623069936422
011K,01,1K,0,1095,1,1094,711,383,inf,0.091324200913242,99.90867579908675,64.93150684931507,34.977168949771695
011L,01,1L,0,1082,4,1078,663,415,inf,0.36968576709796674,99.63031423290202,61.275415896487985,38.35489833641405
011M,01,1M,0,1067,1,1066,657,409,inf,0.09372071227741331,99.90627928772258,61.57450796626054,38.33177132146204
011N,01,1N,0,1093,1,1092,677,415,inf,0.09149130832570906,99.90850869167429,61.939615736505026,37.96889295516926
011O,01,1O,0,1080,2,1078,674,404,inf,0.1851851851851852,99.81481481481481,62.40740740740741,37.407407407407405
011P,01,1P,0,1072,1,1071,677,394,inf,0.09328358208955223,99.90671641791045,63.15298507462687,36.75373134328358
011Q,01,1Q,0,543,1,542,353,189,inf,0.1841620626151013,99.8158379373849,65.00920810313076,34.806629834254146
011R,01,1R,0,544,1,543,306,237,inf,0.1838235294117647,99.81617647058823,56.25,43.56617647058824
011S,01,1S,0,539,1,538,310,228,inf,0.1855287569573284,99.81447124304268,57.5139146567718,42.30055658627087
011T,01,1T,0,541,0,541,333,208,inf,0.0,100.0,61.552680221811464,38.447319778188536
011U,01,1U,0,521,0,521,293,228,inf,0.0,100.0,56.23800383877159,43.7619961612284
01100,01,100,3071,594,2,592,291,301,19.342233800065127,0.33670033670033667,99.66329966329967,48.98989898989899,50.67340067340067
01101,01,101,2429,533,3,530,281,249,21.943186496500616,0.5628517823639775,99.43714821763602,52.72045028142589,46.71669793621013
01105,01,105,3960,882,2,880,410,470,22.272727272727273,0.22675736961451248,99.77324263038548,46.48526077097506,53.28798185941043
01107,01,107,3531,744,1,743,274,469,21.07051826677995,0.13440860215053765,99.86559139784946,36.82795698924731,63.03763440860215
01111,01,111,2213,540,2,538,183,355,24.401265250790782,0.3703703703703704,99.62962962962963,33.88888888888889,65.74074074074075
01112,01,112,2396,558,1,557,198,359,23.28881469115192,0.17921146953405018,99.82078853046595,35.483870967741936,64.33691756272401
01115,01,115,3153,632,2,630,244,386,20.04440215667618,0.31645569620253167,99.68354430379746,38.607594936708864,61.07594936708861
01118,01,118,2499,532,0,532,247,285,21.288515406162464,0.0,100.0,46.42857142857143,53.57142857142857
01120,01,120,3512,817,4,813,615,198,23.263097949886106,0.4895960832313341,99.51040391676867,75.27539779681763,24.23500611995104
01121,01,121,2958,589,3,586,283,303,19.91210277214334,0.5093378607809848,99.49066213921901,48.04753820033956,51.44312393887945
01129,01,129,3031,566,2,564,398,166,18.673705047838997,0.35335689045936397,99.64664310954063,70.31802120141343,29.328621908127207
01200,01,200,2117,537,1,536,261,275,25.36608408124705,0.186219739292365,99.81378026070763,48.60335195530726,51.21042830540037
01202,01,202,3393,737,0,737,313,424,21.721190686707928,0.0,100.0,42.469470827679785,57.53052917232022
01205,01,205,2979,637,2,635,236,399,21.38301443437395,0.3139717425431711,99.68602825745683,37.04866562009419,62.637362637362635
01207,01,207,3147,556,1,555,231,324,17.667619955513185,0.1798561151079137,99.82014388489209,41.54676258992806,58.27338129496403
01209,01,209,3996,723,7,716,292,424,18.093093093093092,0.9681881051175657,99.03181189488244,40.387275242047025,58.64453665283541
01212,01,212,3477,676,1,675,186,489,19.44204774230659,0.14792899408284024,99.85207100591717,27.514792899408285,72.33727810650888
01214,01,214,3099,609,1,608,189,419,19.651500484027107,0.16420361247947454,99.83579638752053,31.03448275862069,68.80131362889983
01217,01,217,2240,471,2,469,176,293,21.026785714285715,0.42462845010615713,99.57537154989384,37.367303609341825,62.20806794055201
01219,01,219,3303,859,2,857,301,556,26.00666061156524,0.23282887077997672,99.76717112922002,35.0407450523865,64.72642607683353
01221,01,221,3930,876,3,873,246,627,22.290076335877863,0.3424657534246575,99.65753424657534,28.08219178082192,71.57534246575342
01300,01,300,3173,904,1,903,604,299,28.49038764576111,0.11061946902654868,99.88938053097345,66.8141592920354,33.07522123893805
01302,01,302,2838,753,2,751,501,250,26.53276955602537,0.2656042496679947,99.734395750332,66.53386454183267,33.200531208499335
01305,01,305,3105,916,4,912,474,438,29.500805152979066,0.43668122270742354,99.56331877729258,51.7467248908297,47.81659388646288
01307,01,307,2578,631,5,626,368,258,24.47633824670287,0.7923930269413629,99.20760697305863,58.32012678288431,40.88748019017432
01308,01,308,1978,372,1,371,235,136,18.806875631951467,0.2688172043010753,99.73118279569893,63.17204301075269,36.55913978494624
01312,01,312,2375,724,2,722,369,353,30.484210526315792,0.2762430939226519,99.72375690607734,50.966850828729285,48.75690607734807
01315,01,315,2305,740,2,738,450,288,32.10412147505423,0.2702702702702703,99.72972972972973,60.810810810810814,38.91891891891892
01317,01,317,3717,1126,4,1122,728,394,30.293247242399783,0.3552397868561279,99.64476021314387,64.65364120781527,34.9911190053286
01321,01,321,2390,627,0,627,445,182,26.234309623430963,0.0,100.0,70.97288676236045,29.02711323763955
01323,01,323,2146,533,0,533,336,197,24.83690587138863,0.0,100.0,63.03939962476548,36.96060037523452
01325,01,325,2460,480,0,480,290,190,19.51219512195122,0.0,100.0,60.416666666666664,39.58333333333333
01327,01,327,2798,521,3,518,335,183,18.6204431736955,0.5758157389635317,99.42418426103646,64.29942418426103,35.12476007677543
01400,01,400,3083,651,5,646,430,216,21.115796302302954,0.7680491551459293,99.23195084485407,66.05222734254991,33.17972350230415
01403,01,403,2556,614,1,613,354,259,24.02190923317684,0.16286644951140067,99.8371335504886,57.65472312703584,42.18241042345277
01404,01,404,2418,551,0,551,328,223,22.787427626137305,0.0,100.0,59.528130671506354,40.471869328493646
01405,01,405,1858,477,4,473,323,150,25.672766415500536,0.8385744234800839,99.16142557651992,67.71488469601678,31.446540880503143
01409,01,409,3035,714,1,713,402,311,23.525535420098848,0.1400560224089636,99.85994397759103,56.30252100840336,43.55742296918768
01414,01,414,1926,392,0,392,252,140,20.35306334371755,0.0,100.0,64.28571428571429,35.714285714285715
01415,01,415,2749,604,3,601,400,201,21.97162604583485,0.49668874172185434,99.50331125827815,66.22516556291392,33.27814569536424
01416,01,416,3317,810,2,808,482,326,24.419656315948146,0.24691358024691357,99.75308641975309,59.50617283950618,40.24691358024691
01421,01,421,2591,576,1,575,321,254,22.230798919336163,0.1736111111111111,99.82638888888889,55.729166666666664,44.09722222222222
01425,01,425,2563,557,2,555,342,213,21.732344908310573,0.3590664272890485,99.64093357271095,61.40035906642729,38.240574506283664
01427,01,427,2690,581,3,578,300,278,21.598513011152416,0.5163511187607573,99.48364888123923,51.63511187607573,47.84853700516351
01431,01,431,2887,520,4,516,293,223,18.011776931070315,0.7692307692307693,99.23076923076923,56.34615384615385,42.88461538461538
01500,01,500,3170,856,0,856,656,200,27.003154574132495,0.0,100.0,76.63551401869158,23.364485981308412
01504,01,504,3044,710,1,709,508,201,23.324572930354794,0.14084507042253522,99.85915492957747,71.54929577464789,28.30985915492958
01505,01,505,2653,922,0,922,656,266,34.753109687146626,0.0,100.0,71.14967462039046,28.850325379609544
01508,01,508,2252,613,2,611,435,176,27.2202486678508,0.3262642740619902,99.673735725938,70.96247960848288,28.711256117455136
01510,01,510,2218,544,0,544,460,84,24.526600541027953,0.0,100.0,84.55882352941177,15.441176470588236
01512,01,512,2062,549,0,549,391,158,26.624636275460716,0.0,100.0,71.22040072859745,28.77959927140255
01513,01,513,2497,476,3,473,344,129,19.06287545054065,0.6302521008403361,99.36974789915966,72.26890756302521,27.100840336134453
01516,01,516,2992,769,4,765,506,259,25.701871657754012,0.5201560468140443,99.47984395318595,65.7997399219766,33.68010403120936
01519,01,519,2371,739,2,737,504,233,31.16828342471531,0.2706359945872801,99.72936400541272,68.20027063599458,31.52909336941813
01522,01,522,2315,451,0,451,325,126,19.481641468682508,0.0,100.0,72.06208425720621,27.93791574279379
01524,01,524,1892,382,1,381,208,173,20.190274841437635,0.2617801047120419,99.73821989528795,54.45026178010471,45.287958115183244
01528,01,528,2906,657,0,657,400,257,22.608396421197522,0.0,100.0,60.882800608828006,39.117199391171994
01600,01,600,2060,431,2,429,310,119,20.92233009708738,0.46403712296983757,99.53596287703016,71.92575406032483,27.610208816705335
01601,01,601,2678,414,0,414,269,145,15.459297983569828,0.0,100.0,64.97584541062803,35.02415458937198
01602,01,602,1895,527,0,527,330,197,27.810026385224273,0.0,100.0,62.61859582542695,37.381404174573056
01603,01,603,2708,505,1,504,379,125,18.648449039881832,0.19801980198019803,99.8019801980198,75.04950495049505,24.752475247524753
01605,01,605,2733,474,0,474,254,220,17.34357848518112,0.0,100.0,53.58649789029536,46.41350210970464
01612,01,612,1962,385,1,384,237,147,19.62283384301733,0.2597402597402597,99.74025974025975,61.55844155844156,38.18181818181819
01613,01,613,2950,534,2,532,346,186,18.10169491525424,0.37453183520599254,99.625468164794,64.7940074906367,34.831460674157306
01617,01,617,2082,345,0,345,226,119,16.570605187319885,0.0,100.0,65.5072463768116,34.492753623188406
01620,01,620,1936,277,0,277,186,91,14.307851239669422,0.0,100.0,67.14801444043322,32.851985559566785
01623,01,623,2753,508,1,507,342,165,18.452597166727205,0.19685039370078738,99.80314960629921,67.32283464566929,32.48031496062992
01624,01,624,2115,389,0,389,266,123,18.39243498817967,0.0,100.0,68.38046272493573,31.619537275064268
01627,01,627,2706,462,1,461,313,148,17.073170731707318,0.21645021645021645,99.78354978354979,67.74891774891775,32.03463203463203
01632,01,632,2260,556,2,554,348,206,24.601769911504427,0.3597122302158274,99.64028776978418,62.589928057553955,37.05035971223021
01634,01,634,2429,453,2,451,257,194,18.64965006175381,0.44150110375275936,99.55849889624724,56.73289183222958,42.82560706401766
021A,02,1A,0,686,2,684,349,335,inf,0.2915451895043732,99.70845481049562,50.87463556851311,48.8338192419825
021B,02,1B,0,810,1,809,399,410,inf,0.12345679012345678,99.87654320987654,49.25925925925926,50.617283950617285
021C,02,1C,0,853,0,853,386,467,inf,0.0,100.0,45.25205158264947,54.74794841735052
021D,02,1D,0,793,4,789,339,450,inf,0.5044136191677175,99.49558638083228,42.74905422446406,56.746532156368225
021E,02,1E,0,803,1,802,326,476,inf,0.12453300124533001,99.87546699875467,40.59775840597759,59.27770859277709
021F,02,1F,0,693,3,690,304,386,inf,0.4329004329004329,99.56709956709958,43.867243867243864,55.6998556998557
021G,02,1G,0,690,1,689,300,389,inf,0.14492753623188406,99.85507246376811,43.47826086956522,56.376811594202906
021H,02,1H,0,788,3,785,351,434,inf,0.3807106598984772,99.61928934010153,44.54314720812182,55.0761421319797
021J,02,1J,0,683,0,683,279,404,inf,0.0,100.0,40.849194729136165,59.150805270863835
021K,02,1K,0,656,3,653,278,375,inf,0.45731707317073167,99.54268292682927,42.3780487804878,57.16463414634146
021L,02,1L,0,674,0,674,282,392,inf,0.0,100.0,41.839762611275965,58.160237388724035
021M,02,1M,0,682,3,679,277,402,inf,0.43988269794721413,99.56011730205279,40.615835777126094,58.94428152492669
021N,02,1N,0,688,1,687,262,425,inf,0.14534883720930233,99.8546511627907,38.08139534883721,61.77325581395349
021O,02,1O,0,678,2,676,295,381,inf,0.2949852507374631,99.70501474926253,43.51032448377581,56.19469026548673
021P,02,1P,0,682,0,682,271,411,inf,0.0,100.0,39.73607038123167,60.26392961876833
021Q,02,1Q,0,683,2,681,288,393,inf,0.29282576866764276,99.70717423133236,42.16691068814056,57.540263543191806
02101,02,101,1915,372,5,367,204,163,19.425587467362924,1.3440860215053763,98.65591397849462,54.83870967741935,43.81720430107527
02102,02,102,982,201,0,201,120,81,20.468431771894092,0.0,100.0,59.70149253731343,40.298507462686565
02103,02,103,705,170,0,170,119,51,24.113475177304963,0.0,100.0,70.0,30.0
02104,02,104,943,212,0,212,120,92,22.481442205726403,0.0,100.0,56.60377358490566,43.39622641509434
02105,02,105,3476,982,2,980,486,494,28.250863060989644,0.20366598778004072,99.79633401221996,49.490835030549896,50.30549898167006
02106,02,106,2602,819,3,816,408,408,31.475787855495774,0.3663003663003663,99.63369963369964,49.81684981684982,49.81684981684982
02107,02,107,1412,474,2,472,237,235,33.56940509915014,0.42194092827004215,99.57805907172997,50.0,49.57805907172996
02108,02,108,3730,1244,1,1243,612,631,33.35120643431635,0.08038585209003216,99.91961414790997,49.19614147909968,50.72347266881029
02109,02,109,977,344,0,344,127,217,35.20982599795291,0.0,100.0,36.91860465116279,63.08139534883721
02110,02,110,2330,759,1,758,275,483,32.57510729613734,0.13175230566534915,99.86824769433466,36.231884057971016,63.63636363636363
02111,02,111,2339,761,3,758,335,423,32.53527148353997,0.39421813403416556,99.60578186596584,44.021024967148485,55.584756898817346
02112,02,112,2531,811,2,809,355,454,32.04267088107468,0.2466091245376079,99.75339087546239,43.77311960542541,55.980271270036994
02113,02,113,1257,318,0,318,261,57,25.29832935560859,0.0,100.0,82.0754716981132,17.92452830188679
02114,02,114,921,193,0,193,133,60,20.955483170466884,0.0,100.0,68.9119170984456,31.088082901554404
02115,02,115,1944,457,3,454,300,154,23.508230452674898,0.6564551422319475,99.34354485776805,65.64551422319475,33.69803063457331
02116,02,116,1002,180,0,180,140,40,17.964071856287426,0.0,100.0,77.77777777777779,22.22222222222222
02117,02,117,3007,769,1,768,533,235,25.573661456601265,0.13003901170351106,99.8699609882965,69.3107932379714,30.559167750325102
02118,02,118,916,241,1,240,158,82,26.31004366812227,0.4149377593360996,99.5850622406639,65.56016597510373,34.024896265560166
02119,02,119,1120,385,1,384,192,192,34.375,0.2597402597402597,99.74025974025975,49.87012987012987,49.87012987012987
02120,02,120,3198,1054,3,1051,402,649,32.958098811757345,0.2846299810246679,99.71537001897534,38.1404174573055,61.574952561669825
02121,02,121,1129,431,2,429,148,281,38.17537643932683,0.46403712296983757,99.53596287703016,34.33874709976798,65.19721577726219
02122,02,122,1057,326,0,326,142,184,30.842005676442763,0.0,100.0,43.558282208588956,56.44171779141104
02123,02,123,1880,650,3,647,310,337,34.57446808510639,0.46153846153846156,99.53846153846155,47.69230769230769,51.84615384615384
02124,02,124,2345,733,5,728,292,436,31.257995735607675,0.6821282401091405,99.31787175989086,39.83628922237381,59.481582537517056
02125,02,125,3211,749,2,747,292,455,23.326066645904703,0.26702269692923897,99.73297730307075,38.98531375166889,60.747663551401864
02126,02,126,1102,278,1,277,93,184,25.226860254083483,0.3597122302158274,99.64028776978418,33.45323741007194,66.18705035971223
02127,02,127,1374,406,0,406,117,289,29.54876273653566,0.0,100.0,28.817733990147783,71.18226600985221
02128,02,128,775,154,0,154,51,103,19.870967741935484,0.0,100.0,33.116883116883116,66.88311688311688
02129,02,129,1029,286,0,286,112,174,27.793974732750243,0.0,100.0,39.16083916083916,60.83916083916085
02130,02,130,1990,417,1,416,230,186,20.954773869346734,0.2398081534772182,99.76019184652279,55.15587529976019,44.60431654676259
02131,02,131,1687,421,0,421,343,78,24.955542382928275,0.0,100.0,81.47268408551069,18.52731591448931
02132,02,132,1027,200,0,200,96,104,19.474196689386563,0.0,100.0,48.0,52.0
02133,02,133,1063,279,1,278,234,44,26.246472248353715,0.35842293906810035,99.6415770609319,83.87096774193549,15.770609318996415
02134,02,134,2251,454,2,452,141,311,20.16881386050644,0.4405286343612335,99.55947136563876,31.05726872246696,68.5022026431718
02135,02,135,1065,222,1,221,75,146,20.845070422535212,0.45045045045045046,99.54954954954955,33.78378378378378,65.76576576576578
02136,02,136,1212,302,0,302,136,166,24.917491749174918,0.0,100.0,45.033112582781456,54.966887417218544
02137,02,137,1304,315,2,313,101,212,24.15644171779141,0.6349206349206349,99.36507936507937,32.06349206349206,67.3015873015873
02138,02,138,3152,748,3,745,246,499,23.730964467005077,0.4010695187165776,99.59893048128342,32.887700534759354,66.71122994652407
02139,02,139,1148,317,0,317,102,215,27.61324041811847,0.0,100.0,32.17665615141956,67.82334384858044
02140,02,140,1801,444,0,444,193,251,24.652970571904497,0.0,100.0,43.468468468468465,56.531531531531535
02141,02,141,2505,682,4,678,217,461,27.225548902195605,0.5865102639296188,99.41348973607037,31.818181818181817,67.59530791788856
02142,02,142,2256,534,4,530,255,275,23.670212765957448,0.7490636704119851,99.25093632958801,47.752808988764045,51.49812734082397
02143,02,143,1397,332,2,330,107,223,23.76521116678597,0.6024096385542169,99.3975903614458,32.22891566265061,67.16867469879519
02144,02,144,2296,538,0,538,136,402,23.432055749128917,0.0,100.0,25.27881040892193,74.72118959107806
02145,02,145,1025,227,2,225,84,141,22.146341463414636,0.881057268722467,99.11894273127754,37.00440528634361,62.11453744493392
02146,02,146,2191,527,1,526,173,353,24.05294386125057,0.18975332068311196,99.81024667931689,32.82732447817837,66.98292220113852
02147,02,147,626,205,0,205,75,130,32.74760383386581,0.0,100.0,36.58536585365854,63.41463414634146
02148,02,148,987,280,0,280,110,170,28.368794326241137,0.0,100.0,39.285714285714285,60.71428571428571
02149,02,149,2110,409,0,409,117,292,19.38388625592417,0.0,100.0,28.606356968215156,71.39364303178483
02150,02,150,1218,206,1,205,74,131,16.912972085385878,0.48543689320388345,99.51456310679612,35.92233009708738,63.59223300970874
02151,02,151,1248,227,1,226,89,137,18.189102564102562,0.4405286343612335,99.55947136563876,39.20704845814978,60.352422907488986
02152,02,152,898,181,0,181,58,123,20.155902004454344,0.0,100.0,32.04419889502763,67.95580110497238
02153,02,153,2200,477,0,477,140,337,21.681818181818183,0.0,100.0,29.350104821802937,70.64989517819707
02154,02,154,1358,264,3,261,89,172,19.44035346097202,1.1363636363636365,98.86363636363636,33.71212121212121,65.15151515151516
02155,02,155,1417,257,1,256,94,162,18.136908962597037,0.38910505836575876,99.61089494163424,36.57587548638132,63.035019455252915
02156,02,156,2505,505,2,503,160,343,20.159680638722556,0.39603960396039606,99.60396039603961,31.683168316831683,67.92079207920793
02157,02,157,1104,228,0,228,73,155,20.652173913043477,0.0,100.0,32.01754385964912,67.98245614035088
02158,02,158,1231,308,0,308,101,207,25.02030869212023,0.0,100.0,32.7922077922078,67.20779220779221
02159,02,159,1947,525,0,525,153,372,26.964560862865948,0.0,100.0,29.142857142857142,70.85714285714285
02160,02,160,1354,345,0,345,92,253,25.480059084194977,0.0,100.0,26.666666666666668,73.33333333333333
02161,02,161,1298,295,1,294,73,221,22.727272727272727,0.3389830508474576,99.66101694915255,24.74576271186441,74.91525423728814
02162,02,162,3878,723,2,721,180,541,18.643630737493552,0.2766251728907331,99.72337482710927,24.896265560165975,74.8271092669433
02163,02,163,1120,234,0,234,65,169,20.892857142857142,0.0,100.0,27.77777777777778,72.22222222222221
02164,02,164,5451,1228,3,1225,297,928,22.527976518070076,0.24429967426710095,99.7557003257329,24.185667752442995,75.57003257328991
02165,02,165,2400,468,0,468,143,325,19.5,0.0,100.0,30.555555555555557,69.44444444444444
02166,02,166,4049,898,6,892,209,683,22.17831563348975,0.6681514476614699,99.33184855233853,23.2739420935412,76.05790645879733
02167,02,167,2332,500,0,500,137,363,21.440823327615778,0.0,100.0,27.400000000000002,72.6
02168,02,168,3714,711,4,707,185,522,19.143780290791597,0.5625879043600562,99.43741209563994,26.019690576652604,73.41772151898735
02169,02,169,1401,300,0,300,78,222,21.413276231263385,0.0,100.0,26.0,74.0
02170,02,170,2548,493,2,491,163,328,19.34850863422292,0.4056795131845842,99.59432048681542,33.062880324543606,66.5314401622718
02171,02,171,1393,265,0,265,76,189,19.023689877961232,0.0,100.0,28.67924528301887,71.32075471698113
02172,02,172,4042,723,1,722,196,526,17.88718456209797,0.13831258644536654,99.86168741355463,27.10926694329184,72.75242047026279
02173,02,173,3844,739,5,734,188,546,19.224765868886575,0.6765899864682002,99.3234100135318,25.43978349120433,73.88362652232748
02174,02,174,1425,259,1,258,84,174,18.17543859649123,0.3861003861003861,99.61389961389962,32.432432432432435,67.18146718146718
02175,02,175,2477,511,0,511,140,371,20.629794105773115,0.0,100.0,27.397260273972602,72.6027397260274
02176,02,176,3519,632,1,631,195,436,17.95964762716681,0.15822784810126583,99.84177215189874,30.854430379746834,68.9873417721519
02177,02,177,2784,502,0,502,154,348,18.031609195402297,0.0,100.0,30.677290836653388,69.32270916334662
02178,02,178,1200,284,1,283,99,184,23.666666666666668,0.35211267605633806,99.64788732394366,34.859154929577464,64.7887323943662
02179,02,179,1280,309,2,307,96,211,24.140625,0.6472491909385114,99.35275080906149,31.06796116504854,68.28478964401295
02180,02,180,4117,791,2,789,230,559,19.213019188729657,0.2528445006321113,99.74715549936789,29.077117572692796,70.67003792667509
02181,02,181,915,242,2,240,63,177,26.44808743169399,0.8264462809917356,99.17355371900827,26.033057851239672,73.14049586776859
02182,02,182,1294,287,3,284,96,188,22.179289026275114,1.0452961672473868,98.95470383275261,33.44947735191638,65.50522648083623
02183,02,183,2455,500,1,499,144,355,20.366598778004075,0.2,99.8,28.799999999999997,71.0
02184,02,184,1248,320,1,319,90,229,25.64102564102564,0.3125,99.6875,28.125,71.5625
02185,02,185,2427,555,1,554,163,391,22.867737948084056,0.18018018018018017,99.81981981981983,29.36936936936937,70.45045045045045
02186,02,186,2061,446,3,443,99,344,21.63998059194566,0.672645739910314,99.32735426008968,22.19730941704036,77.13004484304933
02187,02,187,2381,406,1,405,115,290,17.051658966820664,0.24630541871921183,99.75369458128078,28.32512315270936,71.42857142857143
031A,03,1A,0,1300,0,1300,485,815,inf,0.0,100.0,37.30769230769231,62.69230769230769
031B,03,1B,0,1240,1,1239,449,790,inf,0.08064516129032258,99.91935483870968,36.20967741935484,63.70967741935484
032A,03,2A,0,1218,2,1216,446,770,inf,0.16420361247947454,99.83579638752053,36.61740558292282,63.2183908045977
032B,03,2B,0,1254,1,1253,432,821,inf,0.07974481658692185,99.92025518341308,34.44976076555024,65.47049441786284
033B,03,3B,0,1414,1,1413,483,930,inf,0.07072135785007072,99.92927864214994,34.15841584158416,65.77086280056577
034A,03,4A,0,1109,1,1108,389,719,inf,0.09017132551848511,99.90982867448152,35.07664562669071,64.8331830477908
035B,03,5B,0,1216,0,1216,403,813,inf,0.0,100.0,33.14144736842105,66.85855263157895
036A,03,6A,0,1318,2,1316,461,855,inf,0.15174506828528073,99.84825493171472,34.977238239757206,64.87101669195751
036B,03,6B,0,1243,0,1243,433,810,inf,0.0,100.0,34.83507642799678,65.16492357200322
037A,03,7A,0,1191,1,1190,454,736,inf,0.08396305625524769,99.91603694374476,38.11922753988245,61.7968094038623
037B,03,7B,0,1188,0,1188,447,741,inf,0.0,100.0,37.62626262626262,62.37373737373737
038A,03,8A,0,1208,1,1207,424,783,inf,0.08278145695364239,99.91721854304636,35.099337748344375,64.81788079470199
038B,03,8B,0,1217,2,1215,430,785,inf,0.16433853738701726,99.83566146261298,35.33278553820871,64.50287592440426
039A,03,9A,0,1247,2,1245,435,810,inf,0.16038492381716118,99.83961507618284,34.883720930232556,64.95589414595028
039B,03,9B,0,1225,2,1223,441,782,inf,0.163265306122449,99.83673469387755,36.0,63.83673469387755
03101,03,101,2349,475,1,474,209,265,20.22137079608344,0.21052631578947367,99.78947368421053,44.0,55.78947368421052
03102,03,102,2241,358,2,356,122,234,15.975011155734048,0.5586592178770949,99.4413407821229,34.07821229050279,65.36312849162012
03103,03,103,1574,339,2,337,103,234,21.53748411689962,0.5899705014749262,99.41002949852508,30.383480825958703,69.02654867256636
03104,03,104,1173,215,0,215,69,146,18.32907075873828,0.0,100.0,32.093023255813954,67.90697674418604
03105,03,105,1046,113,0,113,49,64,10.803059273422562,0.0,100.0,43.36283185840708,56.63716814159292
03106,03,106,896,132,0,132,48,84,14.732142857142858,0.0,100.0,36.36363636363637,63.63636363636363
03107,03,107,1474,258,0,258,77,181,17.503392130257804,0.0,100.0,29.844961240310074,70.15503875968993
03108,03,108,3455,720,1,719,323,396,20.839363241678726,0.1388888888888889,99.86111111111111,44.861111111111114,55.00000000000001
03109,03,109,3033,626,0,626,255,371,20.6396307286515,0.0,100.0,40.73482428115016,59.26517571884984
03110,03,110,1336,278,1,277,122,155,20.808383233532936,0.3597122302158274,99.64028776978418,43.884892086330936,55.75539568345324
03111,03,111,1200,342,1,341,109,232,28.499999999999996,0.29239766081871343,99.70760233918129,31.871345029239766,67.83625730994152
03112,03,112,2981,885,0,885,328,557,29.6880241529688,0.0,100.0,37.06214689265537,62.93785310734463
03113,03,113,1048,286,1,285,109,176,27.29007633587786,0.34965034965034963,99.65034965034964,38.111888111888106,61.53846153846154
03114,03,114,1470,441,0,441,191,250,30.0,0.0,100.0,43.31065759637188,56.68934240362812
03115,03,115,3012,684,0,684,285,399,22.709163346613543,0.0,100.0,41.66666666666667,58.333333333333336
03116,03,116,1442,301,2,299,136,163,20.87378640776699,0.6644518272425249,99.33554817275747,45.182724252491695,54.15282392026578
03117,03,117,3107,678,0,678,259,419,21.821692951400067,0.0,100.0,38.200589970501476,61.799410029498524
03201,03,201,830,184,0,184,88,96,22.16867469879518,0.0,100.0,47.82608695652174,52.17391304347826
03202,03,202,618,123,0,123,78,45,19.902912621359224,0.0,100.0,63.41463414634146,36.58536585365854
03203,03,203,2804,560,2,558,246,312,19.971469329529242,0.35714285714285715,99.64285714285714,43.92857142857143,55.714285714285715
03204,03,204,2688,542,0,542,269,273,20.163690476190478,0.0,100.0,49.6309963099631,50.3690036900369
03205,03,205,1174,286,0,286,151,135,24.361158432708688,0.0,100.0,52.7972027972028,47.2027972027972
03206,03,206,2516,626,2,624,348,276,24.880763116057235,0.3194888178913738,99.68051118210862,55.59105431309904,44.08945686900959
03207,03,207,2147,564,1,563,257,306,26.26921285514672,0.1773049645390071,99.822695035461,45.56737588652482,54.25531914893617
03208,03,208,1493,366,0,366,200,166,24.514400535833893,0.0,100.0,54.644808743169406,45.3551912568306
03209,03,209,2853,668,0,668,254,414,23.413950227830355,0.0,100.0,38.02395209580838,61.97604790419161
03210,03,210,3036,777,0,777,326,451,25.592885375494074,0.0,100.0,41.95624195624196,58.04375804375804
03211,03,211,1280,288,0,288,130,158,22.5,0.0,100.0,45.13888888888889,54.861111111111114
03212,03,212,2783,733,0,733,287,446,26.338483650736617,0.0,100.0,39.15416098226466,60.84583901773534
03213,03,213,2838,698,3,695,252,443,24.59478505990134,0.42979942693409745,99.5702005730659,36.10315186246418,63.467048710601716
03214,03,214,1288,222,0,222,76,146,17.236024844720497,0.0,100.0,34.234234234234236,65.76576576576578
03215,03,215,1377,348,0,348,130,218,25.272331154684096,0.0,100.0,37.35632183908046,62.643678160919535
03216,03,216,1536,408,0,408,142,266,26.5625,0.0,100.0,34.80392156862745,65.19607843137256
03301,03,301,2503,654,1,653,231,422,26.128645625249703,0.1529051987767584,99.84709480122325,35.321100917431195,64.52599388379205
03302,03,302,1021,226,0,226,86,140,22.135161606268365,0.0,100.0,38.05309734513274,61.94690265486725
03303,03,303,2377,496,3,493,148,345,20.86663862010938,0.6048387096774194,99.39516129032258,29.838709677419356,69.55645161290323
03304,03,304,1187,221,1,220,69,151,18.618365627632688,0.4524886877828055,99.5475113122172,31.221719457013574,68.32579185520362
03305,03,305,2394,606,4,602,198,404,25.31328320802005,0.6600660066006601,99.33993399339934,32.67326732673268,66.66666666666666
03306,03,306,1120,302,1,301,88,213,26.96428571428571,0.33112582781456956,99.66887417218543,29.13907284768212,70.52980132450331
03307,03,307,1039,290,0,290,82,208,27.911453320500478,0.0,100.0,28.27586206896552,71.72413793103448
03308,03,308,1123,282,0,282,68,214,25.111308993766695,0.0,100.0,24.113475177304963,75.88652482269504
03309,03,309,2392,553,0,553,151,402,23.118729096989966,0.0,100.0,27.305605786618447,72.69439421338156
03310,03,310,2439,623,1,622,158,464,25.543255432554325,0.16051364365971107,99.83948635634029,25.36115569823435,74.47833065810595
03311,03,311,1120,258,0,258,69,189,23.035714285714285,0.0,100.0,26.744186046511626,73.25581395348837
03312,03,312,2812,698,0,698,179,519,24.822190611664297,0.0,100.0,25.644699140401144,74.35530085959886
03313,03,313,1321,404,2,402,64,338,30.582891748675245,0.49504950495049505,99.5049504950495,15.841584158415841,83.66336633663366
03314,03,314,1092,272,0,272,64,208,24.90842490842491,0.0,100.0,23.52941176470588,76.47058823529412
03315,03,315,2237,473,0,473,127,346,21.144389807778275,0.0,100.0,26.849894291754755,73.15010570824523
03316,03,316,1344,298,1,297,71,226,22.172619047619047,0.33557046979865773,99.66442953020133,23.825503355704697,75.83892617449665
03317,03,317,2482,612,1,611,178,433,24.65753424657534,0.16339869281045752,99.83660130718954,29.08496732026144,70.75163398692811
03318,03,318,914,189,0,189,47,142,20.678336980306344,0.0,100.0,24.867724867724867,75.13227513227513
03401,03,401,2494,535,0,535,237,298,21.45148356054531,0.0,100.0,44.299065420560744,55.700934579439256
03402,03,402,2382,522,0,522,207,315,21.91435768261965,0.0,100.0,39.6551724137931,60.3448275862069
03403,03,403,1019,228,0,228,79,149,22.374877330716387,0.0,100.0,34.64912280701755,65.35087719298247
03404,03,404,2202,472,0,472,161,311,21.435059037238872,0.0,100.0,34.11016949152542,65.88983050847457
03405,03,405,1203,196,0,196,59,137,16.29260182876143,0.0,100.0,30.102040816326532,69.89795918367348
03406,03,406,1381,268,0,268,89,179,19.40622737146995,0.0,100.0,33.2089552238806,66.7910447761194
03407,03,407,2650,614,1,613,218,395,23.169811320754715,0.16286644951140067,99.8371335504886,35.50488599348534,64.33224755700326
03408,03,408,2238,395,0,395,150,245,17.649687220732797,0.0,100.0,37.9746835443038,62.0253164556962
03409,03,409,1253,223,0,223,100,123,17.79728651237031,0.0,100.0,44.843049327354265,55.15695067264574
03410,03,410,1147,210,0,210,56,154,18.30863121185702,0.0,100.0,26.666666666666668,73.33333333333333
03411,03,411,2639,522,0,522,172,350,19.78021978021978,0.0,100.0,32.95019157088122,67.04980842911877
03412,03,412,1006,185,0,185,62,123,18.389662027833,0.0,100.0,33.513513513513516,66.48648648648648
03413,03,413,751,156,0,156,67,89,20.77230359520639,0.0,100.0,42.94871794871795,57.05128205128205
03414,03,414,2244,478,1,477,158,319,21.301247771836007,0.20920502092050208,99.7907949790795,33.054393305439326,66.73640167364016
03415,03,415,2567,500,1,499,172,327,19.477989871445267,0.2,99.8,34.4,65.4
03416,03,416,1452,233,0,233,57,176,16.046831955922865,0.0,100.0,24.463519313304722,75.53648068669528
03501,03,501,2816,629,0,629,200,429,22.336647727272727,0.0,100.0,31.79650238473768,68.20349761526232
03502,03,502,3059,570,1,569,181,388,18.633540372670808,0.17543859649122806,99.82456140350877,31.75438596491228,68.0701754385965
03503,03,503,1565,378,1,377,107,270,24.15335463258786,0.26455026455026454,99.73544973544973,28.306878306878307,71.42857142857143
03504,03,504,2510,548,0,548,162,386,21.832669322709165,0.0,100.0,29.56204379562044,70.43795620437956
03505,03,505,2203,463,1,462,128,334,21.016795279164775,0.21598272138228944,99.78401727861771,27.645788336933048,72.13822894168467
03506,03,506,2930,559,1,558,187,371,19.07849829351536,0.17889087656529518,99.82110912343471,33.452593917710196,66.3685152057245
03507,03,507,2233,470,0,470,117,353,21.04791759964174,0.0,100.0,24.893617021276597,75.1063829787234
03508,03,508,2366,476,0,476,144,332,20.118343195266274,0.0,100.0,30.252100840336134,69.74789915966386
03509,03,509,2385,472,2,470,147,323,19.79035639412998,0.423728813559322,99.57627118644068,31.14406779661017,68.4322033898305
03510,03,510,2738,532,0,532,176,356,19.430241051862673,0.0,100.0,33.08270676691729,66.9172932330827
03511,03,511,1167,229,2,227,74,153,19.622964867180805,0.8733624454148471,99.12663755458514,32.314410480349345,66.8122270742358
03512,03,512,2241,567,2,565,183,382,25.301204819277107,0.3527336860670194,99.64726631393297,32.27513227513227,67.3721340388007
03513,03,513,1237,385,0,385,140,245,31.123686337914307,0.0,100.0,36.36363636363637,63.63636363636363
03514,03,514,818,263,1,262,61,201,32.15158924205379,0.38022813688212925,99.61977186311786,23.193916349809886,76.42585551330798
03601,03,601,1158,310,0,310,86,224,26.770293609671846,0.0,100.0,27.741935483870968,72.25806451612902
03602,03,602,1302,226,2,224,69,155,17.357910906298002,0.8849557522123894,99.11504424778761,30.53097345132743,68.58407079646017
03603,03,603,1321,292,1,291,84,207,22.10446631339894,0.3424657534246575,99.65753424657534,28.767123287671232,70.8904109589041
03604,03,604,2436,570,0,570,175,395,23.39901477832512,0.0,100.0,30.701754385964914,69.2982456140351
03605,03,605,1864,437,0,437,107,330,23.44420600858369,0.0,100.0,24.485125858123567,75.51487414187643
03606,03,606,2408,589,2,587,162,425,24.46013289036545,0.3395585738539898,99.66044142614601,27.504244482173174,72.15619694397284
03607,03,607,1662,334,0,334,78,256,20.09626955475331,0.0,100.0,23.353293413173652,76.64670658682635
03608,03,608,1729,405,1,404,123,281,23.423944476576057,0.24691358024691357,99.75308641975309,30.37037037037037,69.38271604938272
03609,03,609,1836,398,0,398,109,289,21.67755991285403,0.0,100.0,27.386934673366838,72.61306532663316
03610,03,610,2218,498,0,498,145,353,22.452660054102797,0.0,100.0,29.116465863453815,70.88353413654619
03611,03,611,1681,450,1,449,144,305,26.76977989292088,0.2222222222222222,99.77777777777777,32.0,67.77777777777779
03612,03,612,1642,378,1,377,114,263,23.020706455542022,0.26455026455026454,99.73544973544973,30.158730158730158,69.57671957671958
03613,03,613,902,158,2,156,59,97,17.516629711751662,1.2658227848101267,98.73417721518987,37.34177215189873,61.39240506329114
03614,03,614,783,180,2,178,63,115,22.988505747126435,1.1111111111111112,98.88888888888889,35.0,63.888888888888886
03615,03,615,1668,366,1,365,88,277,21.942446043165468,0.273224043715847,99.72677595628416,24.043715846994534,75.68306010928961
03616,03,616,1914,326,1,325,80,245,17.03239289446186,0.3067484662576687,99.69325153374233,24.539877300613497,75.15337423312883
03617,03,617,2146,418,5,413,136,277,19.478098788443614,1.1961722488038278,98.80382775119617,32.535885167464116,66.26794258373205
03618,03,618,1876,381,0,381,95,286,20.3091684434968,0.0,100.0,24.93438320209974,75.06561679790026
03619,03,619,1705,352,1,351,122,229,20.64516129032258,0.2840909090909091,99.7159090909091,34.659090909090914,65.05681818181817
03701,03,701,1372,242,1,241,109,132,17.63848396501458,0.4132231404958678,99.58677685950413,45.04132231404959,54.54545454545454
03702,03,702,2835,503,2,501,194,307,17.742504409171076,0.3976143141153081,99.60238568588468,38.56858846918489,61.0337972166998
03703,03,703,2884,431,2,429,175,254,14.944521497919554,0.46403712296983757,99.53596287703016,40.60324825986079,58.93271461716937
03704,03,704,2390,462,0,462,135,327,19.330543933054393,0.0,100.0,29.22077922077922,70.77922077922078
03705,03,705,1566,204,3,201,74,127,13.026819923371647,1.4705882352941175,98.52941176470588,36.27450980392157,62.254901960784316
03706,03,706,1485,267,0,267,88,179,17.97979797979798,0.0,100.0,32.958801498127336,67.04119850187266
03707,03,707,1385,253,1,252,92,160,18.267148014440433,0.3952569169960474,99.60474308300395,36.36363636363637,63.24110671936759
03708,03,708,1502,262,0,262,94,168,17.44340878828229,0.0,100.0,35.87786259541985,64.12213740458014
03709,03,709,2331,447,2,445,154,291,19.176319176319176,0.44742729306487694,99.55257270693512,34.45190156599553,65.1006711409396
03710,03,710,2146,489,1,488,135,353,22.786579683131407,0.2044989775051125,99.79550102249489,27.607361963190186,72.1881390593047
03711,03,711,967,189,1,188,50,138,19.54498448810755,0.5291005291005291,99.47089947089947,26.455026455026452,73.01587301587301
03712,03,712,2509,548,2,546,182,364,21.84137106416899,0.36496350364963503,99.63503649635037,33.21167883211679,66.42335766423358
03713,03,713,1139,250,2,248,84,164,21.94907813871817,0.8,99.2,33.6,65.60000000000001
03714,03,714,1096,216,1,215,64,151,19.708029197080293,0.4629629629629629,99.53703703703704,29.629629629629626,69.9074074074074
03715,03,715,1516,324,1,323,99,224,21.372031662269126,0.30864197530864196,99.69135802469135,30.555555555555557,69.1358024691358
03716,03,716,2177,376,2,374,102,272,17.271474506201194,0.5319148936170213,99.46808510638297,27.127659574468083,72.3404255319149
03717,03,717,1313,242,1,241,87,154,18.43107387661843,0.4132231404958678,99.58677685950413,35.9504132231405,63.63636363636363
03801,03,801,2049,380,1,379,137,242,18.545632015617375,0.2631578947368421,99.73684210526315,36.05263157894737,63.68421052631579
03802,03,802,1357,253,1,252,71,181,18.64406779661017,0.3952569169960474,99.60474308300395,28.063241106719367,71.54150197628458
03803,03,803,1151,234,2,232,80,152,20.330147697654212,0.8547008547008548,99.14529914529915,34.18803418803419,64.95726495726495
03804,03,804,2484,494,2,492,142,350,19.887278582930755,0.4048582995951417,99.59514170040485,28.74493927125506,70.8502024291498
03805,03,805,1171,239,0,239,78,161,20.40990606319385,0.0,100.0,32.63598326359833,67.36401673640168
03806,03,806,1303,294,2,292,106,186,22.56331542594014,0.6802721088435374,99.31972789115646,36.054421768707485,63.26530612244898
03807,03,807,2282,563,0,563,133,430,24.67134092900964,0.0,100.0,23.623445825932503,76.3765541740675
03808,03,808,1686,384,3,381,95,286,22.77580071174377,0.78125,99.21875,24.739583333333336,74.47916666666666
03809,03,809,2155,500,4,496,171,325,23.201856148491878,0.8,99.2,34.2,65.0
03810,03,810,2133,484,0,484,156,328,22.691045475855603,0.0,100.0,32.231404958677686,67.76859504132231
03811,03,811,1150,269,0,269,84,185,23.391304347826086,0.0,100.0,31.226765799256505,68.77323420074349
03812,03,812,1364,326,5,321,96,225,23.900293255131967,1.5337423312883436,98.46625766871165,29.447852760736197,69.01840490797547
03813,03,813,1150,233,1,232,76,156,20.26086956521739,0.4291845493562232,99.57081545064378,32.61802575107296,66.95278969957081
03814,03,814,2284,546,0,546,166,380,23.90542907180385,0.0,100.0,30.4029304029304,69.59706959706959
03815,03,815,1069,247,0,247,70,177,23.10570626753976,0.0,100.0,28.34008097165992,71.65991902834008
03816,03,816,1965,473,2,471,127,344,24.07124681933842,0.42283298097251587,99.57716701902748,26.849894291754755,72.72727272727273
03817,03,817,1112,229,0,229,72,157,20.593525179856115,0.0,100.0,31.4410480349345,68.5589519650655
03818,03,818,1345,332,0,332,95,237,24.684014869888475,0.0,100.0,28.614457831325304,71.3855421686747
03901,03,901,2581,557,0,557,152,405,21.580782642386673,0.0,100.0,27.289048473967686,72.71095152603232
03902,03,902,2326,486,0,486,154,332,20.894239036973346,0.0,100.0,31.68724279835391,68.3127572016461
03903,03,903,1143,290,0,290,95,195,25.371828521434818,0.0,100.0,32.758620689655174,67.24137931034483
03904,03,904,726,136,0,136,38,98,18.732782369146005,0.0,100.0,27.941176470588236,72.05882352941177
03905,03,905,1265,314,1,313,103,210,24.82213438735178,0.3184713375796179,99.68152866242038,32.802547770700635,66.87898089171973
03906,03,906,2509,483,1,482,167,315,19.25069748903946,0.2070393374741201,99.79296066252587,34.57556935817806,65.21739130434783
03907,03,907,2502,451,2,449,170,279,18.025579536370902,0.4434589800443459,99.55654101995566,37.6940133037694,61.86252771618626
03908,03,908,789,127,0,127,39,88,16.09632446134347,0.0,100.0,30.708661417322837,69.29133858267717
03909,03,909,1082,195,1,194,75,119,18.02218114602588,0.5128205128205128,99.48717948717949,38.46153846153847,61.02564102564103
03910,03,910,1132,298,1,297,90,207,26.325088339222614,0.33557046979865773,99.66442953020133,30.201342281879196,69.46308724832215
03911,03,911,1264,229,1,228,80,148,18.117088607594937,0.43668122270742354,99.56331877729258,34.93449781659388,64.62882096069869
03912,03,912,2878,592,2,590,195,395,20.569840166782488,0.33783783783783783,99.66216216216216,32.939189189189186,66.72297297297297
03913,03,913,1408,318,1,317,90,227,22.585227272727273,0.3144654088050315,99.68553459119497,28.30188679245283,71.38364779874213
03914,03,914,1097,297,0,297,113,184,27.07383773928897,0.0,100.0,38.04713804713805,61.95286195286195
03915,03,915,2247,521,1,520,166,354,23.186470850022253,0.19193857965451055,99.80806142034548,31.861804222648754,67.94625719769674
03916,03,916,1198,371,3,368,110,258,30.96828046744574,0.8086253369272237,99.19137466307278,29.649595687331537,69.54177897574124
03917,03,917,2425,547,2,545,160,385,22.556701030927833,0.3656307129798903,99.6343692870201,29.250457038391225,70.38391224862889
03918,03,918,2508,422,1,421,137,284,16.826156299840513,0.23696682464454977,99.76303317535546,32.46445497630332,67.29857819905213
03919,03,919,2058,313,1,312,93,219,15.2089407191448,0.3194888178913738,99.68051118210862,29.712460063897762,69.96805111821087
041A,04,1A,0,1141,1,1140,857,283,inf,0.0876424189307625,99.91235758106923,75.10955302366345,24.802804557405782
041B,04,1B,0,1076,1,1075,861,214,inf,0.09293680297397769,99.90706319702602,80.0185873605948,19.888475836431226
041C,04,1C,0,1044,0,1044,806,238,inf,0.0,100.0,77.20306513409962,22.796934865900383
041D,04,1D,0,1105,1,1104,817,287,inf,0.09049773755656108,99.90950226244344,73.93665158371041,25.972850678733035
041E,04,1E,0,1007,2,1005,736,269,inf,0.19860973187686196,99.80139026812313,73.08838133068521,26.713008937437934
041F,04,1F,0,1099,1,1098,818,280,inf,0.09099181073703368,99.90900818926298,74.43130118289353,25.477707006369428
041G,04,1G,0,1047,0,1047,794,253,inf,0.0,100.0,75.83572110792741,24.164278892072588
041H,04,1H,0,938,4,934,733,201,inf,0.42643923240938164,99.57356076759062,78.14498933901919,21.428571428571427
041J,04,1J,0,1018,0,1018,794,224,inf,0.0,100.0,77.99607072691552,22.00392927308448
041K,04,1K,0,1106,0,1106,800,306,inf,0.0,100.0,72.33273056057867,27.66726943942134
041L,04,1L,0,1062,2,1060,767,293,inf,0.18832391713747645,99.81167608286252,72.22222222222221,27.5894538606403
041M,04,1M,0,1027,0,1027,792,235,inf,0.0,100.0,77.11781888997079,22.88218111002921
041N,04,1N,0,986,6,980,728,252,inf,0.6085192697768762,99.39148073022312,73.83367139959432,25.557809330628807
041O,04,1O,0,1090,0,1090,849,241,inf,0.0,100.0,77.88990825688073,22.110091743119266
041P,04,1P,0,1096,2,1094,821,273,inf,0.18248175182481752,99.81751824817519,74.90875912408758,24.90875912408759
041Q,04,1Q,0,1150,1,1149,850,299,inf,0.08695652173913043,99.91304347826086,73.91304347826086,26.0
041R,04,1R,0,1207,2,1205,911,294,inf,0.16570008285004142,99.83429991714996,75.47638773819388,24.35791217895609
041S,04,1S,0,1114,2,1112,845,267,inf,0.17953321364452424,99.82046678635548,75.8527827648115,23.967684021543985
041T,04,1T,0,1085,0,1085,807,278,inf,0.0,100.0,74.3778801843318,25.622119815668203
041U,04,1U,0,1106,0,1106,840,266,inf,0.0,100.0,75.9493670886076,24.050632911392405
041V,04,1V,0,973,0,973,749,224,inf,0.0,100.0,76.97841726618705,23.021582733812952
041W,04,1W,0,1068,1,1067,808,259,inf,0.09363295880149813,99.90636704119851,75.65543071161048,24.250936329588015
041X,04,1X,0,965,1,964,719,245,inf,0.10362694300518134,99.89637305699482,74.5077720207254,25.38860103626943
041Y,04,1Y,0,999,5,994,730,264,inf,0.5005005005005005,99.4994994994995,73.07307307307308,26.426426426426424
041Z,04,1Z,0,1032,1,1031,785,246,inf,0.09689922480620156,99.90310077519379,76.06589147286822,23.837209302325583
04101,04,101,1761,471,1,470,386,84,26.74616695059625,0.21231422505307856,99.78768577494692,81.95329087048833,17.8343949044586
04102,04,102,2019,470,1,469,396,73,23.278850916295195,0.2127659574468085,99.7872340425532,84.25531914893617,15.53191489361702
04103,04,103,1583,414,0,414,337,77,26.152874289324068,0.0,100.0,81.40096618357488,18.59903381642512
04104,04,104,1733,516,0,516,399,117,29.77495672244662,0.0,100.0,77.32558139534885,22.674418604651162
04105,04,105,1379,387,3,384,310,74,28.063814358230605,0.7751937984496124,99.2248062015504,80.10335917312662,19.12144702842377
04106,04,106,2116,540,1,539,443,96,25.51984877126654,0.1851851851851852,99.81481481481481,82.03703703703704,17.77777777777778
04107,04,107,2053,494,2,492,424,68,24.062347783731123,0.4048582995951417,99.59514170040485,85.82995951417004,13.765182186234817
04108,04,108,1211,287,2,285,199,86,23.699421965317917,0.6968641114982579,99.30313588850174,69.33797909407666,29.965156794425084
04109,04,109,1419,404,0,404,311,93,28.4707540521494,0.0,100.0,76.98019801980197,23.01980198019802
04110,04,110,1526,421,0,421,298,123,27.58846657929227,0.0,100.0,70.78384798099762,29.216152019002372
04111,04,111,2011,535,0,535,349,186,26.603679761312783,0.0,100.0,65.23364485981308,34.76635514018692
04112,04,112,1972,611,0,611,391,220,30.983772819472616,0.0,100.0,63.99345335515548,36.00654664484452
04113,04,113,1243,349,1,348,234,114,28.077232502011263,0.28653295128939826,99.7134670487106,67.0487106017192,32.664756446991404
04114,04,114,1268,477,1,476,337,139,37.618296529968454,0.20964360587002098,99.79035639412997,70.64989517819707,29.140461215932913
04115,04,115,2193,827,0,827,690,137,37.7108983128135,0.0,100.0,83.4340991535671,16.56590084643289
04116,04,116,2023,745,2,743,570,173,36.826495304003956,0.2684563758389262,99.73154362416108,76.51006711409396,23.221476510067113
04117,04,117,1309,436,0,436,350,86,33.30786860198625,0.0,100.0,80.27522935779817,19.724770642201836
04118,04,118,1835,671,2,669,537,132,36.566757493188014,0.29806259314456035,99.70193740685544,80.02980625931446,19.672131147540984
04119,04,119,1820,641,1,640,487,153,35.21978021978022,0.15600624024961,99.84399375975039,75.97503900156006,23.868954758190327
04120,04,120,1653,542,1,541,411,130,32.78886872353297,0.18450184501845018,99.81549815498155,75.83025830258303,23.985239852398525
04121,04,121,1600,378,0,378,291,87,23.625,0.0,100.0,76.98412698412699,23.015873015873016
04122,04,122,874,215,0,215,149,66,24.59954233409611,0.0,100.0,69.30232558139535,30.697674418604652
04123,04,123,1515,378,1,377,248,129,24.95049504950495,0.26455026455026454,99.73544973544973,65.60846560846561,34.12698412698413
04124,04,124,1350,413,0,413,295,118,30.592592592592595,0.0,100.0,71.42857142857143,28.57142857142857
04125,04,125,1416,408,0,408,285,123,28.8135593220339,0.0,100.0,69.85294117647058,30.14705882352941
04126,04,126,1471,535,0,535,411,124,36.36981645139361,0.0,100.0,76.82242990654206,23.177570093457945
04127,04,127,1686,541,3,538,410,128,32.08778173190985,0.5545286506469501,99.44547134935306,75.78558225508318,23.65988909426987
04128,04,128,1565,559,2,557,436,121,35.71884984025559,0.35778175313059035,99.6422182468694,77.99642218246869,21.645796064400717
04129,04,129,1500,472,3,469,365,104,31.466666666666665,0.6355932203389831,99.36440677966102,77.33050847457628,22.033898305084744
04130,04,130,2155,721,1,720,553,167,33.45707656612529,0.13869625520110956,99.86130374479889,76.69902912621359,23.1622746185853
04131,04,131,1687,667,4,663,515,148,39.53764078245406,0.5997001499250375,99.40029985007496,77.21139430284857,22.188905547226387
04132,04,132,1571,542,1,541,407,134,34.50031826861871,0.18450184501845018,99.81549815498155,75.09225092250922,24.723247232472325
04133,04,133,712,308,0,308,231,77,43.258426966292134,0.0,100.0,75.0,25.0
04134,04,134,1340,410,0,410,291,119,30.597014925373134,0.0,100.0,70.97560975609755,29.024390243902438
04135,04,135,1562,529,0,529,382,147,33.866837387964146,0.0,100.0,72.2117202268431,27.788279773156898
04136,04,136,1594,441,1,440,291,149,27.666248431618566,0.22675736961451248,99.77324263038548,65.98639455782312,33.78684807256236
04137,04,137,1329,374,0,374,222,152,28.141459744168547,0.0,100.0,59.35828877005348,40.64171122994652
04138,04,138,1264,403,1,402,255,147,31.88291139240506,0.24813895781637718,99.75186104218362,63.27543424317618,36.47642679900744
04139,04,139,1717,402,0,402,250,152,23.41292952824694,0.0,100.0,62.189054726368155,37.81094527363184
04140,04,140,1801,487,0,487,215,272,27.040533037201552,0.0,100.0,44.14784394250513,55.85215605749486
04141,04,141,1919,489,7,482,251,231,25.482021886399163,1.4314928425357873,98.56850715746421,51.32924335378323,47.239263803680984
04142,04,142,1732,480,2,478,321,157,27.713625866050805,0.4166666666666667,99.58333333333333,66.875,32.708333333333336
04143,04,143,1475,487,0,487,356,131,33.016949152542374,0.0,100.0,73.1006160164271,26.899383983572893
04144,04,144,1623,531,2,529,364,165,32.71719038817005,0.3766478342749529,99.62335216572504,68.54990583804144,31.07344632768362
04145,04,145,2079,600,3,597,404,193,28.86002886002886,0.5,99.5,67.33333333333333,32.166666666666664
04146,04,146,1408,451,2,449,279,170,32.03125,0.4434589800443459,99.55654101995566,61.86252771618626,37.6940133037694
04147,04,147,1728,502,0,502,310,192,29.050925925925924,0.0,100.0,61.75298804780876,38.24701195219124
04148,04,148,1896,644,2,642,374,268,33.9662447257384,0.3105590062111801,99.68944099378882,58.07453416149069,41.61490683229814
04149,04,149,1803,511,1,510,317,193,28.341652800887413,0.19569471624266144,99.80430528375733,62.03522504892368,37.76908023483366
04150,04,150,2076,637,1,636,390,246,30.684007707129098,0.15698587127158556,99.84301412872841,61.224489795918366,38.61852433281005
04151,04,151,1806,448,1,447,294,153,24.8062015503876,0.2232142857142857,99.77678571428571,65.625,34.151785714285715
04152,04,152,2132,567,0,567,401,166,26.594746716697937,0.0,100.0,70.72310405643739,29.276895943562607
04153,04,153,1421,411,2,409,268,141,28.92329345531316,0.48661800486618007,99.51338199513383,65.20681265206812,34.306569343065696
04154,04,154,1041,241,0,241,169,72,23.150816522574445,0.0,100.0,70.12448132780082,29.87551867219917
04155,04,155,1447,279,0,279,189,90,19.281271596406356,0.0,100.0,67.74193548387096,32.25806451612903
04156,04,156,1141,340,0,340,216,124,29.798422436459248,0.0,100.0,63.52941176470588,36.470588235294116
04157,04,157,1481,373,1,372,280,92,25.185685347738012,0.2680965147453083,99.73190348525469,75.06702412868633,24.664879356568363
04158,04,158,1626,409,0,409,310,99,25.153751537515372,0.0,100.0,75.79462102689487,24.205378973105134
04159,04,159,1810,427,0,427,269,158,23.591160220994475,0.0,100.0,62.997658079625296,37.00234192037471
04160,04,160,1015,296,1,295,201,94,29.16256157635468,0.33783783783783783,99.66216216216216,67.9054054054054,31.756756756756754
04161,04,161,1904,515,2,513,349,164,27.04831932773109,0.3883495145631068,99.6116504854369,67.76699029126215,31.844660194174757
04162,04,162,1300,374,0,374,246,128,28.76923076923077,0.0,100.0,65.77540106951871,34.22459893048128
04163,04,163,1837,457,0,457,286,171,24.87751769188895,0.0,100.0,62.58205689277899,37.41794310722101
04164,04,164,1860,459,0,459,294,165,24.677419354838708,0.0,100.0,64.05228758169935,35.947712418300654
04165,04,165,1681,424,0,424,276,148,25.223081499107675,0.0,100.0,65.09433962264151,34.90566037735849
04166,04,166,1726,483,1,482,312,170,27.983777520278096,0.2070393374741201,99.79296066252587,64.59627329192547,35.196687370600415
04167,04,167,1982,503,0,503,371,132,25.378405650857722,0.0,100.0,73.75745526838966,26.24254473161034
04168,04,168,2146,583,1,582,424,158,27.166821994408203,0.17152658662092624,99.82847341337907,72.72727272727273,27.101200686106345
04169,04,169,1680,526,0,526,356,170,31.30952380952381,0.0,100.0,67.68060836501901,32.31939163498099
04170,04,170,1610,367,0,367,268,99,22.795031055900623,0.0,100.0,73.02452316076294,26.975476839237057
04171,04,171,893,313,1,312,248,64,35.05039193729003,0.3194888178913738,99.68051118210862,79.2332268370607,20.447284345047922
04172,04,172,2154,710,4,706,513,193,32.9619312906221,0.5633802816901409,99.43661971830986,72.25352112676056,27.1830985915493
04173,04,173,1768,528,2,526,394,132,29.86425339366516,0.3787878787878788,99.62121212121212,74.62121212121212,25.0
04174,04,174,1691,566,1,565,405,160,33.471318746303965,0.17667844522968199,99.82332155477032,71.5547703180212,28.26855123674912
04175,04,175,1646,513,2,511,415,96,31.166464155528555,0.3898635477582846,99.61013645224172,80.89668615984405,18.71345029239766
04176,04,176,1699,580,0,580,438,142,34.13772807533844,0.0,100.0,75.51724137931033,24.482758620689655
04177,04,177,1530,553,2,551,427,124,36.1437908496732,0.3616636528028933,99.63833634719711,77.21518987341773,22.423146473779383
04178,04,178,2050,718,0,718,568,150,35.02439024390244,0.0,100.0,79.10863509749304,20.891364902506965
04179,04,179,1625,492,0,492,407,85,30.27692307692308,0.0,100.0,82.72357723577237,17.276422764227643
04180,04,180,1709,518,2,516,410,106,30.310122878876538,0.3861003861003861,99.61389961389962,79.15057915057915,20.463320463320464
04181,04,181,1621,453,1,452,367,85,27.94571252313387,0.22075055187637968,99.77924944812362,81.01545253863135,18.76379690949227
04182,04,182,1579,547,0,547,447,100,34.64217859404686,0.0,100.0,81.71846435100548,18.281535648994517
04183,04,183,2144,701,0,701,468,233,32.69589552238806,0.0,100.0,66.76176890156918,33.238231098430816
04184,04,184,2080,698,3,695,492,203,33.55769230769231,0.42979942693409745,99.5702005730659,70.48710601719198,29.083094555873924
04185,04,185,1733,490,0,490,379,111,28.27466820542412,0.0,100.0,77.3469387755102,22.653061224489797
04186,04,186,1681,529,0,529,370,159,31.469363474122545,0.0,100.0,69.94328922495274,30.056710775047257
04187,04,187,1680,553,0,553,434,119,32.916666666666664,0.0,100.0,78.48101265822784,21.518987341772153
04188,04,188,1873,491,0,491,383,108,26.21462893753337,0.0,100.0,78.00407331975559,21.9959266802444
04189,04,189,943,265,1,264,189,75,28.101802757158005,0.37735849056603776,99.62264150943396,71.32075471698113,28.30188679245283
04190,04,190,1539,473,0,473,381,92,30.734243014944767,0.0,100.0,80.54968287526427,19.45031712473573
04191,04,191,1611,481,0,481,344,137,29.857231533209188,0.0,100.0,71.51767151767152,28.482328482328484
04192,04,192,1362,365,1,364,248,116,26.798825256975036,0.273972602739726,99.72602739726028,67.94520547945206,31.780821917808222
04193,04,193,1608,475,0,475,325,150,29.539800995024873,0.0,100.0,68.42105263157895,31.57894736842105
04194,04,194,1586,412,2,410,311,99,25.97730138713745,0.48543689320388345,99.51456310679612,75.48543689320388,24.029126213592235
04195,04,195,1523,501,2,499,347,152,32.89560078791858,0.39920159680638717,99.60079840319361,69.26147704590818,30.33932135728543
04196,04,196,1647,568,2,566,370,196,34.4869459623558,0.35211267605633806,99.64788732394366,65.14084507042254,34.50704225352113
04197,04,197,1599,502,0,502,363,139,31.39462163852408,0.0,100.0,72.31075697211156,27.689243027888445
04198,04,198,1111,394,3,391,299,92,35.46354635463546,0.7614213197969544,99.23857868020305,75.88832487309645,23.3502538071066
04199,04,199,1338,451,0,451,330,121,33.70702541106129,0.0,100.0,73.17073170731707,26.82926829268293
04200,04,200,1669,532,3,529,384,145,31.875374475733974,0.5639097744360901,99.43609022556392,72.18045112781954,27.25563909774436
04201,04,201,1980,598,1,597,387,210,30.2020202020202,0.16722408026755853,99.83277591973244,64.71571906354515,35.11705685618729
04202,04,202,1980,681,1,680,412,268,34.39393939393939,0.14684287812041116,99.85315712187959,60.4992657856094,39.353891336270195
04203,04,203,1408,427,0,427,282,145,30.326704545454547,0.0,100.0,66.04215456674473,33.957845433255265
04204,04,204,2036,657,0,657,428,229,32.26915520628684,0.0,100.0,65.14459665144597,34.855403348554034
04205,04,205,1877,587,0,587,378,209,31.273308470964306,0.0,100.0,64.39522998296422,35.604770017035776
04206,04,206,2063,652,2,650,419,231,31.604459524963644,0.3067484662576687,99.69325153374233,64.2638036809816,35.42944785276074
04207,04,207,1754,480,0,480,326,154,27.366020524515395,0.0,100.0,67.91666666666667,32.083333333333336
04208,04,208,1957,704,2,702,485,217,35.973428717424625,0.2840909090909091,99.7159090909091,68.89204545454545,30.823863636363637
04209,04,209,1753,632,1,631,428,203,36.05248146035368,0.15822784810126583,99.84177215189874,67.72151898734177,32.120253164556964
04210,04,210,2087,829,3,826,486,340,39.72208912314327,0.3618817852834741,99.63811821471653,58.6248492159228,41.01326899879373
04211,04,211,921,278,0,278,194,84,30.184581976112923,0.0,100.0,69.7841726618705,30.215827338129497
04212,04,212,1805,544,0,544,447,97,30.13850415512465,0.0,100.0,82.16911764705883,17.830882352941178
04213,04,213,1802,622,2,620,440,180,34.517203107658155,0.3215434083601286,99.67845659163987,70.7395498392283,28.938906752411576
04214,04,214,931,286,1,285,192,93,30.71965628356606,0.34965034965034963,99.65034965034964,67.13286713286713,32.51748251748251
04215,04,215,1540,533,1,532,351,181,34.61038961038961,0.18761726078799248,99.812382739212,65.85365853658537,33.95872420262664
04216,04,216,1756,617,1,616,484,132,35.136674259681094,0.1620745542949757,99.83792544570503,78.44408427876823,21.39384116693679
04217,04,217,1612,667,1,666,419,247,41.37717121588089,0.14992503748125938,99.85007496251875,62.81859070464768,37.031484257871064
04218,04,218,1532,700,2,698,426,272,45.69190600522193,0.2857142857142857,99.71428571428571,60.857142857142854,38.857142857142854
04219,04,219,1966,660,2,658,470,188,33.5707019328586,0.30303030303030304,99.69696969696969,71.21212121212122,28.484848484848484
04220,04,220,1797,730,1,729,397,332,40.62326099053979,0.136986301369863,99.86301369863013,54.38356164383562,45.47945205479452
04221,04,221,2127,816,1,815,393,422,38.3638928067701,0.12254901960784313,99.87745098039215,48.161764705882355,51.71568627450981
04222,04,222,1573,630,0,630,362,268,40.05085823267641,0.0,100.0,57.460317460317455,42.53968253968254
04223,04,223,1758,618,0,618,399,219,35.153583617747444,0.0,100.0,64.56310679611651,35.43689320388349
04224,04,224,1715,620,2,618,368,250,36.15160349854227,0.3225806451612903,99.67741935483872,59.354838709677416,40.32258064516129
04225,04,225,1562,603,2,601,422,179,38.60435339308579,0.33167495854063017,99.66832504145937,69.98341625207297,29.684908789386398
04226,04,226,1805,731,0,731,439,292,40.498614958448755,0.0,100.0,60.0547195622435,39.945280437756495
04227,04,227,1665,691,0,691,509,182,41.5015015015015,0.0,100.0,73.66136034732273,26.33863965267728
04228,04,228,1668,566,1,565,417,148,33.932853717026376,0.17667844522968199,99.82332155477032,73.67491166077738,26.148409893992934
04229,04,229,1598,435,3,432,274,158,27.221526908635795,0.6896551724137931,99.3103448275862,62.98850574712643,36.321839080459775
04230,04,230,1805,430,1,429,316,113,23.822714681440445,0.23255813953488372,99.76744186046511,73.48837209302326,26.27906976744186
04231,04,231,1490,309,0,309,223,86,20.738255033557046,0.0,100.0,72.168284789644,27.831715210355988
051A,05,1A,0,680,2,678,548,130,inf,0.29411764705882354,99.70588235294117,80.58823529411765,19.11764705882353
051B,05,1B,0,826,1,825,662,163,inf,0.12106537530266344,99.87893462469734,80.1452784503632,19.73365617433414
051C,05,1C,0,777,1,776,625,151,inf,0.1287001287001287,99.87129987129987,80.43758043758044,19.433719433719435
051D,05,1D,0,811,0,811,629,182,inf,0.0,100.0,77.55856966707768,22.44143033292232
051E,05,1E,0,741,0,741,557,184,inf,0.0,100.0,75.16869095816465,24.831309041835357
051F,05,1F,0,654,0,654,510,144,inf,0.0,100.0,77.98165137614679,22.018348623853214
051G,05,1G,0,628,0,628,500,128,inf,0.0,100.0,79.61783439490446,20.382165605095544
051H,05,1H,0,492,0,492,402,90,inf,0.0,100.0,81.70731707317073,18.29268292682927
051I,05,1I,0,698,0,698,544,154,inf,0.0,100.0,77.93696275071633,22.063037249283667
051K,05,1K,0,693,1,692,535,157,inf,0.1443001443001443,99.85569985569985,77.2005772005772,22.655122655122657
051L,05,1L,0,717,2,715,588,127,inf,0.2789400278940028,99.72105997210599,82.00836820083683,17.712691771269178
051M,05,1M,0,736,0,736,567,169,inf,0.0,100.0,77.03804347826086,22.96195652173913
051N,05,1N,0,777,1,776,629,147,inf,0.1287001287001287,99.87129987129987,80.95238095238095,18.91891891891892
051O,05,1O,0,786,1,785,638,147,inf,0.1272264631043257,99.87277353689568,81.1704834605598,18.702290076335878
051P,05,1P,0,767,0,767,610,157,inf,0.0,100.0,79.53063885267275,20.469361147327252
051Q,05,1Q,0,727,1,726,559,167,inf,0.1375515818431912,99.86244841815682,76.89133425034387,22.97111416781293
051R,05,1R,0,780,2,778,620,158,inf,0.2564102564102564,99.74358974358975,79.48717948717949,20.256410256410255
051S,05,1S,0,836,2,834,657,177,inf,0.23923444976076555,99.76076555023924,78.58851674641149,21.17224880382775
051T,05,1T,0,783,2,781,590,191,inf,0.2554278416347382,99.74457215836526,75.35121328224777,24.393358876117496
051U,05,1U,0,734,0,734,553,181,inf,0.0,100.0,75.34059945504087,24.65940054495913
05101,05,101,852,212,1,211,109,102,24.88262910798122,0.4716981132075472,99.52830188679245,51.41509433962265,48.113207547169814
05102,05,102,1399,466,3,463,314,149,33.30950679056469,0.6437768240343348,99.35622317596567,67.38197424892704,31.97424892703863
05103,05,103,824,242,0,242,150,92,29.36893203883495,0.0,100.0,61.98347107438017,38.01652892561984
05104,05,104,1568,388,1,387,288,99,24.744897959183675,0.25773195876288657,99.74226804123711,74.22680412371135,25.51546391752577
05105,05,105,1867,598,1,597,456,141,32.0299946438136,0.16722408026755853,99.83277591973244,76.2541806020067,23.578595317725753
05106,05,106,2481,564,1,563,445,118,22.732769044740024,0.1773049645390071,99.822695035461,78.90070921985816,20.921985815602838
05107,05,107,1922,706,0,706,465,241,36.73257023933403,0.0,100.0,65.86402266288952,34.13597733711048
05108,05,108,2370,652,1,651,417,234,27.51054852320675,0.15337423312883436,99.84662576687117,63.95705521472392,35.88957055214724
05109,05,109,1035,282,0,282,207,75,27.246376811594203,0.0,100.0,73.40425531914893,26.595744680851062
05110,05,110,1142,258,0,258,207,51,22.59194395796848,0.0,100.0,80.23255813953489,19.767441860465116
05111,05,111,930,217,1,216,131,85,23.333333333333332,0.4608294930875576,99.53917050691244,60.36866359447005,39.1705069124424
05112,05,112,846,191,0,191,135,56,22.576832151300234,0.0,100.0,70.68062827225131,29.31937172774869
05113,05,113,912,332,0,332,218,114,36.40350877192983,0.0,100.0,65.66265060240963,34.33734939759036
05114,05,114,556,122,1,121,90,31,21.942446043165468,0.819672131147541,99.18032786885246,73.77049180327869,25.40983606557377
05115,05,115,880,163,0,163,127,36,18.522727272727273,0.0,100.0,77.91411042944786,22.085889570552148
05116,05,116,1807,437,0,437,370,67,24.183729939125623,0.0,100.0,84.66819221967964,15.331807780320366
05117,05,117,1706,524,1,523,404,119,30.71512309495897,0.19083969465648853,99.80916030534351,77.09923664122137,22.709923664122137
05118,05,118,1972,482,0,482,384,98,24.442190669371197,0.0,100.0,79.66804979253112,20.33195020746888
05119,05,119,2552,490,1,489,394,95,19.20062695924765,0.20408163265306123,99.79591836734694,80.40816326530611,19.387755102040817
05120,05,120,791,167,0,167,136,31,21.11251580278129,0.0,100.0,81.437125748503,18.562874251497004
05121,05,121,2113,489,0,489,333,156,23.142451490771414,0.0,100.0,68.09815950920245,31.901840490797547
05122,05,122,1493,353,1,352,250,102,23.64367046215673,0.28328611898017,99.71671388101983,70.82152974504248,28.89518413597734
05123,05,123,671,176,0,176,116,60,26.229508196721312,0.0,100.0,65.9090909090909,34.090909090909086
05124,05,124,758,219,0,219,158,61,28.891820580474935,0.0,100.0,72.14611872146118,27.85388127853881
05125,05,125,842,172,1,171,134,37,20.42755344418052,0.5813953488372093,99.4186046511628,77.90697674418605,21.511627906976745
05126,05,126,692,204,2,202,151,51,29.47976878612717,0.9803921568627451,99.01960784313727,74.01960784313727,25.0
05127,05,127,1454,248,0,248,189,59,17.05639614855571,0.0,100.0,76.20967741935483,23.790322580645164
05128,05,128,1310,306,3,303,235,68,23.358778625954198,0.9803921568627451,99.01960784313727,76.79738562091504,22.22222222222222
05129,05,129,902,149,0,149,107,42,16.518847006651885,0.0,100.0,71.81208053691275,28.187919463087248
05130,05,130,723,148,0,148,109,39,20.470262793914245,0.0,100.0,73.64864864864865,26.351351351351347
05131,05,131,884,232,0,232,170,62,26.244343891402718,0.0,100.0,73.27586206896551,26.72413793103448
05132,05,132,2060,530,3,527,365,162,25.728155339805824,0.5660377358490566,99.43396226415095,68.86792452830188,30.566037735849054
05133,05,133,1525,408,1,407,270,137,26.754098360655735,0.24509803921568626,99.75490196078431,66.17647058823529,33.57843137254902
05134,05,134,1630,499,0,499,302,197,30.61349693251534,0.0,100.0,60.52104208416834,39.478957915831664
05135,05,135,2564,890,2,888,602,286,34.71138845553822,0.22471910112359553,99.7752808988764,67.64044943820224,32.13483146067416
05136,05,136,3108,839,2,837,444,393,26.99485199485199,0.23837902264600713,99.761620977354,52.92014302741359,46.841477949940405
05137,05,137,1864,545,0,545,424,121,29.238197424892704,0.0,100.0,77.79816513761469,22.201834862385322
05138,05,138,2089,569,1,568,396,172,27.23791287697463,0.17574692442882248,99.82425307557118,69.59578207381371,30.228471001757466
05139,05,139,618,145,0,145,117,28,23.462783171521036,0.0,100.0,80.6896551724138,19.310344827586206
05140,05,140,3003,706,1,705,493,212,23.50982350982351,0.141643059490085,99.85835694050992,69.83002832861189,30.02832861189802
05141,05,141,2596,527,1,526,413,113,20.300462249614792,0.18975332068311196,99.81024667931689,78.36812144212524,21.44212523719165
05142,05,142,2302,436,2,434,340,94,18.94005212858384,0.45871559633027525,99.54128440366972,77.98165137614679,21.55963302752294
05143,05,143,1830,572,1,571,445,126,31.256830601092894,0.17482517482517482,99.82517482517483,77.7972027972028,22.02797202797203
05144,05,144,2572,573,3,570,434,136,22.278382581648522,0.5235602094240838,99.47643979057592,75.74171029668412,23.7347294938918
05145,05,145,1632,382,0,382,304,78,23.40686274509804,0.0,100.0,79.58115183246073,20.418848167539267
05146,05,146,1563,392,1,391,315,76,25.079974408189383,0.25510204081632654,99.74489795918367,80.35714285714286,19.387755102040817
05147,05,147,2155,527,0,527,343,184,24.45475638051044,0.0,100.0,65.08538899430741,34.9146110056926
05148,05,148,2481,475,2,473,384,89,19.145505844417574,0.42105263157894735,99.57894736842105,80.84210526315789,18.736842105263158
05149,05,149,2414,702,2,700,539,161,29.08036454018227,0.2849002849002849,99.71509971509973,76.78062678062678,22.934472934472936
05150,05,150,763,202,0,202,167,35,26.474442988204455,0.0,100.0,82.67326732673267,17.326732673267326
05151,05,151,2388,609,1,608,478,130,25.502512562814072,0.16420361247947454,99.83579638752053,78.48932676518884,21.34646962233169
05152,05,152,1136,264,1,263,192,71,23.239436619718308,0.3787878787878788,99.62121212121212,72.72727272727273,26.89393939393939
05153,05,153,953,310,1,309,249,60,32.52885624344176,0.3225806451612903,99.67741935483872,80.3225806451613,19.35483870967742
05154,05,154,1869,560,0,560,393,167,29.962546816479403,0.0,100.0,70.17857142857142,29.82142857142857
05155,05,155,1846,519,1,518,378,140,28.114842903575298,0.1926782273603083,99.8073217726397,72.83236994219652,26.97495183044316
05156,05,156,1536,415,4,411,324,87,27.018229166666668,0.9638554216867471,99.03614457831326,78.07228915662651,20.96385542168675
05157,05,157,1747,430,0,430,331,99,24.613623354321696,0.0,100.0,76.9767441860465,23.02325581395349
05158,05,158,1644,426,3,423,334,89,25.91240875912409,0.7042253521126761,99.29577464788733,78.40375586854461,20.89201877934272
05159,05,159,969,268,2,266,212,54,27.657378740970074,0.7462686567164178,99.25373134328358,79.1044776119403,20.149253731343283
05160,05,160,1876,445,0,445,327,118,23.720682302771856,0.0,100.0,73.48314606741573,26.516853932584272
05161,05,161,2684,711,0,711,582,129,26.4903129657228,0.0,100.0,81.85654008438819,18.143459915611814
05162,05,162,1626,399,0,399,314,85,24.538745387453876,0.0,100.0,78.69674185463658,21.303258145363408
05163,05,163,2425,513,1,512,403,109,21.15463917525773,0.1949317738791423,99.80506822612085,78.55750487329435,21.24756335282651
05164,05,164,2226,555,0,555,417,138,24.932614555256063,0.0,100.0,75.13513513513513,24.864864864864867
05165,05,165,1572,409,0,409,310,99,26.017811704834603,0.0,100.0,75.79462102689487,24.205378973105134
05166,05,166,1342,328,1,327,254,73,24.44113263785395,0.3048780487804878,99.6951219512195,77.4390243902439,22.25609756097561
05167,05,167,1622,389,0,389,286,103,23.982737361282368,0.0,100.0,73.52185089974293,26.47814910025707
05168,05,168,1977,588,5,583,450,133,29.74203338391502,0.8503401360544218,99.14965986394559,76.53061224489795,22.61904761904762
05169,05,169,2725,736,0,736,602,134,27.009174311926603,0.0,100.0,81.79347826086956,18.206521739130434
05170,05,170,1511,420,0,420,351,69,27.796161482461944,0.0,100.0,83.57142857142857,16.428571428571427
05171,05,171,2603,374,0,374,293,81,14.368036880522475,0.0,100.0,78.34224598930481,21.65775401069519
05172,05,172,2262,516,1,515,415,100,22.811671087533156,0.1937984496124031,99.8062015503876,80.42635658914729,19.379844961240313
05173,05,173,992,338,1,337,243,94,34.07258064516129,0.2958579881656805,99.70414201183432,71.89349112426035,27.810650887573964
05174,05,174,2474,744,0,744,565,179,30.072756669361354,0.0,100.0,75.94086021505376,24.059139784946236
05175,05,175,1674,444,1,443,371,72,26.523297491039425,0.22522522522522523,99.77477477477478,83.55855855855856,16.216216216216218
05176,05,176,1561,509,0,509,414,95,32.607303010890455,0.0,100.0,81.33595284872298,18.664047151277014
05177,05,177,1587,357,0,357,295,62,22.495274102079396,0.0,100.0,82.6330532212885,17.366946778711483
05178,05,178,1572,514,0,514,400,114,32.69720101781171,0.0,100.0,77.82101167315176,22.17898832684825
05179,05,179,721,200,0,200,174,26,27.739251040221912,0.0,100.0,87.0,13.0
05180,05,180,2034,458,0,458,316,142,22.517207472959686,0.0,100.0,68.99563318777294,31.004366812227076
05181,05,181,1135,320,0,320,220,100,28.193832599118945,0.0,100.0,68.75,31.25
05182,05,182,1049,351,0,351,278,73,33.4604385128694,0.0,100.0,79.2022792022792,20.7977207977208
05183,05,183,1862,443,0,443,386,57,23.791621911922665,0.0,100.0,87.13318284424379,12.866817155756207
05184,05,184,1407,372,2,370,311,59,26.439232409381663,0.5376344086021506,99.46236559139786,83.60215053763442,15.86021505376344
05185,05,185,1851,616,0,616,517,99,33.27930848190167,0.0,100.0,83.92857142857143,16.071428571428573
05186,05,186,2442,844,2,842,652,190,34.561834561834566,0.23696682464454977,99.76303317535546,77.25118483412322,22.511848341232227
05187,05,187,859,356,1,355,253,102,41.443538998835855,0.2808988764044944,99.71910112359551,71.06741573033707,28.651685393258425
05188,05,188,1834,676,0,676,517,159,36.85932388222465,0.0,100.0,76.4792899408284,23.5207100591716
05189,05,189,2345,813,1,812,648,164,34.66950959488273,0.12300123001230012,99.87699876998771,79.70479704797047,20.17220172201722
05190,05,190,1926,744,2,742,499,243,38.62928348909657,0.2688172043010753,99.73118279569893,67.06989247311827,32.66129032258064
05191,05,191,1137,422,1,421,313,108,37.115215479331574,0.23696682464454977,99.76303317535546,74.17061611374407,25.59241706161137
05192,05,192,836,281,0,281,216,65,33.61244019138756,0.0,100.0,76.86832740213522,23.131672597864767
05193,05,193,1049,392,0,392,286,106,37.36892278360343,0.0,100.0,72.95918367346938,27.040816326530614
05194,05,194,935,342,2,340,259,81,36.57754010695187,0.5847953216374269,99.41520467836257,75.73099415204678,23.684210526315788
05195,05,195,1090,430,1,429,307,122,39.44954128440367,0.23255813953488372,99.76744186046511,71.3953488372093,28.37209302325581
05196,05,196,1125,402,0,402,301,101,35.733333333333334,0.0,100.0,74.87562189054727,25.12437810945274
05197,05,197,1949,722,0,722,595,127,37.044638276038995,0.0,100.0,82.40997229916897,17.590027700831026
05198,05,198,1841,698,0,698,525,173,37.91417707767518,0.0,100.0,75.21489971346705,24.785100286532952
05199,05,199,1921,746,0,746,564,182,38.833940655908386,0.0,100.0,75.60321715817693,24.396782841823057
061A,06,1A,0,664,2,662,529,133,inf,0.30120481927710846,99.69879518072288,79.66867469879519,20.03012048192771
061B,06,1B,0,656,2,654,472,182,inf,0.3048780487804878,99.6951219512195,71.95121951219512,27.743902439024392
061C,06,1C,0,850,0,850,645,205,inf,0.0,100.0,75.88235294117646,24.11764705882353
061D,06,1D,0,840,3,837,660,177,inf,0.35714285714285715,99.64285714285714,78.57142857142857,21.071428571428573
061E,06,1E,0,850,0,850,667,183,inf,0.0,100.0,78.47058823529412,21.529411764705884
061F,06,1F,0,831,6,825,597,228,inf,0.7220216606498195,99.27797833935018,71.84115523465704,27.436823104693143
061G,06,1G,0,848,0,848,601,247,inf,0.0,100.0,70.87264150943396,29.127358490566035
061H,06,1H,0,845,0,845,663,182,inf,0.0,100.0,78.46153846153847,21.53846153846154
061J,06,1J,0,845,1,844,661,183,inf,0.1183431952662722,99.88165680473374,78.22485207100591,21.65680473372781
061K,06,1K,0,842,1,841,634,207,inf,0.11876484560570072,99.8812351543943,75.29691211401425,24.584323040380045
061L,06,1L,0,853,1,852,699,153,inf,0.11723329425556857,99.88276670574443,81.94607268464243,17.936694021101992
061M,06,1M,0,849,2,847,646,201,inf,0.23557126030624262,99.76442873969376,76.08951707891637,23.674911660777383
061N,06,1N,0,846,0,846,633,213,inf,0.0,100.0,74.822695035461,25.177304964539005
061O,06,1O,0,839,3,836,627,209,inf,0.3575685339690107,99.64243146603098,74.73182359952324,24.910607866507746
061P,06,1P,0,839,1,838,653,185,inf,0.11918951132300357,99.880810488677,77.83075089392133,22.050059594755663
061Q,06,1Q,0,782,1,781,588,193,inf,0.1278772378516624,99.87212276214834,75.1918158567775,24.680306905370845
061R,06,1R,0,853,1,852,697,155,inf,0.11723329425556857,99.88276670574443,81.7116060961313,18.17116060961313
061S,06,1S,0,837,2,835,638,197,inf,0.23894862604540024,99.7610513739546,76.22461170848268,23.536439665471924
061T,06,1T,0,840,0,840,658,182,inf,0.0,100.0,78.33333333333333,21.666666666666668
061U,06,1U,0,850,1,849,654,195,inf,0.1176470588235294,99.88235294117646,76.94117647058823,22.941176470588236
061V,06,1V,0,852,2,850,684,166,inf,0.2347417840375587,99.76525821596243,80.28169014084507,19.483568075117372
061W,06,1W,0,816,1,815,613,202,inf,0.12254901960784313,99.87745098039215,75.12254901960785,24.754901960784316
061X,06,1X,0,847,1,846,624,222,inf,0.11806375442739078,99.88193624557262,73.67178276269185,26.210153482880756
061Y,06,1Y,0,839,0,839,670,169,inf,0.0,100.0,79.8569725864124,20.143027413587607
061Z,06,1Z,0,831,2,829,691,138,inf,0.24067388688327318,99.75932611311673,83.15282791817089,16.60649819494585
062A,06,2A,0,846,1,845,651,194,inf,0.1182033096926714,99.88179669030734,76.95035460992908,22.93144208037825
062B,06,2B,0,877,2,875,661,214,inf,0.22805017103762829,99.77194982896236,75.37058152793614,24.401368301026224
062C,06,2C,0,851,0,851,651,200,inf,0.0,100.0,76.49823736780259,23.501762632197416
062D,06,2D,0,848,0,848,658,190,inf,0.0,100.0,77.59433962264151,22.40566037735849
062E,06,2E,0,872,1,871,680,191,inf,0.11467889908256881,99.88532110091744,77.98165137614679,21.90366972477064
062F,06,2F,0,849,1,848,655,193,inf,0.11778563015312131,99.88221436984688,77.14958775029447,22.732626619552416
062G,06,2G,0,837,0,837,705,132,inf,0.0,100.0,84.22939068100358,15.770609318996415
062H,06,2H,0,847,1,846,615,231,inf,0.11806375442739078,99.88193624557262,72.60920897284534,27.27272727272727
062J,06,2J,0,837,2,835,645,190,inf,0.23894862604540024,99.7610513739546,77.06093189964157,22.70011947431302
062K,06,2K,0,829,2,827,658,169,inf,0.24125452352231602,99.75874547647769,79.37273823884198,20.386007237635706
062L,06,2L,0,824,2,822,670,152,inf,0.24271844660194172,99.75728155339806,81.31067961165049,18.446601941747574
062M,06,2M,0,820,0,820,652,168,inf,0.0,100.0,79.51219512195122,20.48780487804878
062N,06,2N,0,805,0,805,652,153,inf,0.0,100.0,80.99378881987577,19.006211180124225
062O,06,2O,0,834,1,833,667,166,inf,0.1199040767386091,99.8800959232614,79.97601918465229,19.904076738609113
06001,06,001,1844,655,2,653,395,258,35.520607375271155,0.3053435114503817,99.69465648854961,60.30534351145038,39.38931297709924
06002,06,002,2341,759,1,758,456,302,32.42204186245195,0.13175230566534915,99.86824769433466,60.079051383399204,39.789196310935445
06003,06,003,2459,841,0,841,433,408,34.20089467263115,0.0,100.0,51.48632580261593,48.51367419738406
06004,06,004,1286,444,0,444,232,212,34.52566096423017,0.0,100.0,52.25225225225225,47.74774774774775
06005,06,005,2113,756,1,755,506,249,35.778513961192616,0.13227513227513227,99.86772486772487,66.93121693121694,32.93650793650794
06006,06,006,1326,501,1,500,327,173,37.782805429864254,0.19960079840319359,99.8003992015968,65.26946107784431,34.5309381237525
06007,06,007,2133,818,3,815,474,341,38.349742147210506,0.36674816625916873,99.63325183374083,57.94621026894865,41.687041564792175
06008,06,008,1279,404,1,403,275,128,31.58717748240813,0.24752475247524752,99.75247524752476,68.06930693069307,31.683168316831683
06009,06,009,2334,882,2,880,617,263,37.789203084832906,0.22675736961451248,99.77324263038548,69.95464852607711,29.81859410430839
06010,06,010,817,343,0,343,258,85,41.98286413708691,0.0,100.0,75.21865889212827,24.78134110787172
06011,06,011,823,258,0,258,201,57,31.34872417982989,0.0,100.0,77.90697674418605,22.093023255813954
06012,06,012,1083,401,0,401,220,181,37.02677746999077,0.0,100.0,54.862842892768086,45.137157107231914
06013,06,013,1889,593,1,592,366,226,31.392271042879834,0.16863406408094433,99.83136593591905,61.72006745362564,38.11129848229342
06014,06,014,882,263,1,262,184,78,29.81859410430839,0.38022813688212925,99.61977186311786,69.96197718631178,29.65779467680608
06015,06,015,988,352,0,352,225,127,35.62753036437247,0.0,100.0,63.92045454545454,36.07954545454545
06016,06,016,2075,645,2,643,453,190,31.08433734939759,0.31007751937984496,99.68992248062015,70.23255813953489,29.457364341085274
06017,06,017,1177,436,1,435,325,110,37.043330501274426,0.22935779816513763,99.77064220183486,74.54128440366972,25.229357798165136
06018,06,018,1186,402,1,401,263,138,33.895446880269816,0.24875621890547264,99.75124378109453,65.4228855721393,34.32835820895522
06019,06,019,1347,458,2,456,315,141,34.0014847809948,0.43668122270742354,99.56331877729258,68.77729257641921,30.786026200873362
06020,06,020,1275,530,1,529,368,161,41.568627450980394,0.18867924528301888,99.81132075471699,69.43396226415094,30.377358490566035
06021,06,021,2319,852,2,850,610,240,36.73997412677878,0.2347417840375587,99.76525821596243,71.59624413145539,28.169014084507044
06022,06,022,1113,377,0,377,230,147,33.872416891284814,0.0,100.0,61.0079575596817,38.9920424403183
06023,06,023,1027,351,1,350,249,101,34.177215189873415,0.2849002849002849,99.71509971509973,70.94017094017094,28.774928774928775
06024,06,024,1066,387,0,387,256,131,36.30393996247655,0.0,100.0,66.1498708010336,33.850129198966414
06025,06,025,1142,479,1,478,334,144,41.94395796847636,0.20876826722338201,99.79123173277662,69.72860125260961,30.062630480167012
06026,06,026,1897,706,4,702,550,152,37.216657880864524,0.56657223796034,99.43342776203966,77.90368271954674,21.529745042492916
06027,06,027,2223,733,1,732,533,199,32.973459289248765,0.1364256480218281,99.86357435197817,72.71487039563438,27.148703956343795
06028,06,028,1114,321,0,321,257,64,28.81508078994614,0.0,100.0,80.06230529595015,19.937694704049843
06029,06,029,1223,382,0,382,255,127,31.234668847097304,0.0,100.0,66.75392670157068,33.246073298429316
06030,06,030,1322,427,2,425,315,110,32.299546142208776,0.468384074941452,99.53161592505855,73.77049180327869,25.76112412177986
06031,06,031,2263,847,0,847,570,277,37.42819266460451,0.0,100.0,67.29634002361276,32.70365997638725
06032,06,032,1973,619,1,618,431,187,31.373542828180433,0.16155088852988692,99.83844911147011,69.62843295638126,30.210016155088855
06033,06,033,1832,533,1,532,364,168,29.093886462882097,0.18761726078799248,99.812382739212,68.29268292682927,31.51969981238274
06034,06,034,2213,808,0,808,609,199,36.51152281970177,0.0,100.0,75.37128712871286,24.628712871287128
06035,06,035,2348,766,4,762,536,226,32.62350936967632,0.5221932114882507,99.47780678851174,69.9738903394256,29.50391644908616
06036,06,036,2281,868,0,868,566,302,38.05348531345901,0.0,100.0,65.2073732718894,34.7926267281106
06037,06,037,2228,821,3,818,581,237,36.849192100538595,0.3654080389768575,99.63459196102315,70.7673568818514,28.867235079171742
06038,06,038,875,317,3,314,228,86,36.22857142857143,0.9463722397476341,99.05362776025235,71.92429022082018,27.129337539432175
06039,06,039,1131,324,0,324,250,74,28.647214854111407,0.0,100.0,77.1604938271605,22.839506172839506
06040,06,040,1084,312,0,312,172,140,28.782287822878228,0.0,100.0,55.12820512820513,44.871794871794876
06041,06,041,944,364,0,364,267,97,38.559322033898304,0.0,100.0,73.35164835164835,26.64835164835165
06042,06,042,2493,945,2,943,615,328,37.90613718411552,0.21164021164021166,99.7883597883598,65.07936507936508,34.70899470899471
06043,06,043,2245,922,2,920,639,281,41.069042316258354,0.21691973969631237,99.78308026030369,69.3058568329718,30.47722342733189
06044,06,044,978,363,0,363,248,115,37.11656441717792,0.0,100.0,68.31955922865014,31.68044077134986
06045,06,045,1023,395,3,392,270,122,38.6119257086999,0.7594936708860759,99.24050632911391,68.35443037974683,30.886075949367086
06046,06,046,1102,410,2,408,296,112,37.20508166969147,0.4878048780487805,99.51219512195122,72.1951219512195,27.31707317073171
06047,06,047,2357,967,3,964,686,278,41.02672889266017,0.3102378490175801,99.68976215098242,70.94105480868666,28.74870734229576
06048,06,048,1150,418,0,418,332,86,36.347826086956516,0.0,100.0,79.42583732057416,20.574162679425836
06049,06,049,2517,978,0,978,669,309,38.85578069129917,0.0,100.0,68.40490797546013,31.595092024539877
06050,06,050,1147,449,0,449,302,147,39.14559721011334,0.0,100.0,67.26057906458797,32.73942093541203
06051,06,051,1944,741,1,740,552,188,38.117283950617285,0.1349527665317139,99.86504723346829,74.49392712550608,25.371120107962213
06052,06,052,955,387,1,386,278,108,40.52356020942408,0.2583979328165375,99.74160206718346,71.83462532299741,27.906976744186046
06053,06,053,1304,441,1,440,323,117,33.81901840490797,0.22675736961451248,99.77324263038548,73.24263038548753,26.53061224489796
06054,06,054,2502,867,4,863,613,250,34.65227817745804,0.461361014994233,99.53863898500576,70.70357554786621,28.835063437139564
06055,06,055,1264,478,0,478,369,109,37.81645569620253,0.0,100.0,77.19665271966527,22.80334728033473
06056,06,056,1079,347,0,347,281,66,32.15940685820204,0.0,100.0,80.97982708933718,19.020172910662826
06057,06,057,2452,881,1,880,645,235,35.92985318107667,0.11350737797956867,99.88649262202043,73.2122587968218,26.67423382519864
06058,06,058,2343,738,0,738,551,187,31.498079385403326,0.0,100.0,74.66124661246613,25.338753387533874
06059,06,059,2206,868,1,867,650,217,39.34723481414324,0.1152073732718894,99.88479262672811,74.88479262672811,25.0
06060,06,060,2087,741,1,740,528,212,35.50551030186871,0.1349527665317139,99.86504723346829,71.25506072874494,28.609986504723345
06061,06,061,2201,790,2,788,605,183,35.892776010904136,0.25316455696202533,99.74683544303798,76.58227848101265,23.16455696202532
06062,06,062,1051,417,0,417,341,76,39.67649857278782,0.0,100.0,81.77458033573141,18.225419664268586
06063,06,063,2556,976,3,973,712,261,38.18466353677621,0.3073770491803279,99.69262295081968,72.95081967213115,26.741803278688526
06064,06,064,1166,405,1,404,332,72,34.734133790737566,0.24691358024691357,99.75308641975309,81.9753086419753,17.77777777777778
06065,06,065,2252,762,2,760,618,142,33.83658969804618,0.26246719160104987,99.73753280839895,81.10236220472441,18.635170603674542
06066,06,066,2226,751,0,751,602,149,33.737646001796946,0.0,100.0,80.15978695073235,19.840213049267643
06067,06,067,933,368,0,368,274,94,39.442658092175776,0.0,100.0,74.45652173913044,25.543478260869566
06068,06,068,2473,1081,4,1077,805,272,43.712090578245046,0.37002775208140615,99.6299722479186,74.46808510638297,25.161887141535615
06069,06,069,2101,893,0,893,696,197,42.50356972870062,0.0,100.0,77.93952967525196,22.060470324748042
06070,06,070,1210,502,1,501,407,94,41.48760330578513,0.199203187250996,99.800796812749,81.07569721115537,18.725099601593627
06071,06,071,1159,440,0,440,363,77,37.963761863675586,0.0,100.0,82.5,17.5
06072,06,072,2235,906,2,904,699,205,40.53691275167785,0.22075055187637968,99.77924944812362,77.15231788079471,22.626931567328917
06073,06,073,2766,937,1,936,770,166,33.875632682574114,0.10672358591248667,99.89327641408752,82.17716115261473,17.716115261472787
06074,06,074,1836,478,3,475,382,93,26.034858387799563,0.6276150627615062,99.3723849372385,79.9163179916318,19.456066945606697
06075,06,075,1718,602,2,600,482,118,35.0407450523865,0.33222591362126247,99.66777408637874,80.06644518272425,19.601328903654487
06076,06,076,1019,304,2,302,229,73,29.83316977428852,0.6578947368421052,99.3421052631579,75.32894736842105,24.013157894736842
06077,06,077,1188,427,1,426,338,88,35.94276094276094,0.234192037470726,99.76580796252928,79.15690866510539,20.60889929742389
06078,06,078,2239,775,4,771,571,200,34.61366681554266,0.5161290322580645,99.48387096774194,73.67741935483872,25.806451612903224
06079,06,079,2022,644,2,642,476,166,31.849653808110784,0.3105590062111801,99.68944099378882,73.91304347826086,25.77639751552795
06080,06,080,1195,484,0,484,375,109,40.50209205020921,0.0,100.0,77.47933884297521,22.520661157024794
06081,06,081,1202,420,1,419,326,93,34.94176372712147,0.2380952380952381,99.76190476190476,77.61904761904762,22.142857142857142
06082,06,082,2235,748,0,748,619,129,33.4675615212528,0.0,100.0,82.75401069518716,17.245989304812834
06083,06,083,1219,455,0,455,387,68,37.32567678424938,0.0,100.0,85.05494505494505,14.945054945054945
06084,06,084,1176,479,1,478,373,105,40.7312925170068,0.20876826722338201,99.79123173277662,77.8705636743215,21.920668058455114
06085,06,085,1145,441,0,441,325,116,38.51528384279476,0.0,100.0,73.69614512471655,26.303854875283445
06086,06,086,2514,741,1,740,589,151,29.47494033412888,0.1349527665317139,99.86504723346829,79.48717948717949,20.3778677462888
06087,06,087,983,358,2,356,292,64,36.41912512716175,0.5586592178770949,99.4413407821229,81.56424581005587,17.877094972067038
06088,06,088,1299,407,2,405,335,70,31.331793687451885,0.4914004914004914,99.5085995085995,82.30958230958231,17.1990171990172
06089,06,089,1022,355,1,354,308,46,34.73581213307241,0.28169014084507044,99.71830985915493,86.76056338028168,12.957746478873238
06090,06,090,2118,728,1,727,606,121,34.372049102927285,0.13736263736263737,99.86263736263736,83.24175824175825,16.62087912087912
06091,06,091,1073,397,0,397,321,76,36.99906803355079,0.0,100.0,80.85642317380352,19.143576826196472
06092,06,092,1049,431,0,431,331,100,41.08674928503336,0.0,100.0,76.79814385150812,23.201856148491878
06093,06,093,1048,361,0,361,278,83,34.44656488549619,0.0,100.0,77.00831024930747,22.99168975069252
06094,06,094,958,279,0,279,227,52,29.123173277661795,0.0,100.0,81.36200716845879,18.63799283154122
06095,06,095,1018,484,0,484,360,124,47.54420432220039,0.0,100.0,74.3801652892562,25.6198347107438
06096,06,096,1838,702,4,698,531,167,38.193688792165396,0.5698005698005698,99.43019943019942,75.64102564102564,23.78917378917379
06097,06,097,2616,969,2,967,693,274,37.04128440366973,0.20639834881320948,99.79360165118679,71.51702786377709,28.276573787409703
06098,06,098,1198,457,1,456,291,165,38.14691151919866,0.2188183807439825,99.78118161925602,63.67614879649891,36.10503282275711
06099,06,099,1430,513,1,512,386,126,35.87412587412587,0.1949317738791423,99.80506822612085,75.24366471734892,24.561403508771928
06100,06,100,1054,440,3,437,253,184,41.745730550284634,0.6818181818181818,99.31818181818181,57.49999999999999,41.81818181818181
06101,06,101,2221,793,0,793,509,284,35.704637550652855,0.0,100.0,64.18663303909206,35.81336696090794
06102,06,102,2523,901,0,901,642,259,35.711454617518825,0.0,100.0,71.25416204217537,28.745837957824637
06103,06,103,1133,375,0,375,260,115,33.097969991173876,0.0,100.0,69.33333333333334,30.666666666666664
06104,06,104,1156,417,1,416,294,122,36.07266435986159,0.2398081534772182,99.76019184652279,70.50359712230215,29.256594724220626
06105,06,105,2421,855,4,851,578,273,35.31598513011153,0.46783625730994155,99.53216374269006,67.60233918128655,31.929824561403507
06106,06,106,2168,789,1,788,578,210,36.3929889298893,0.12674271229404308,99.87325728770595,73.25728770595691,26.61596958174905
06107,06,107,1635,376,0,376,286,90,22.996941896024463,0.0,100.0,76.06382978723404,23.93617021276596
06108,06,108,2461,748,1,747,535,212,30.394148720032504,0.1336898395721925,99.8663101604278,71.52406417112299,28.342245989304814
06109,06,109,2223,824,3,821,601,220,37.06702654071075,0.3640776699029126,99.63592233009709,72.93689320388349,26.699029126213592
06110,06,110,2578,761,1,760,533,227,29.51900698215671,0.1314060446780552,99.86859395532196,70.03942181340341,29.82917214191853
06111,06,111,1922,676,2,674,500,174,35.17169614984391,0.2958579881656805,99.70414201183432,73.96449704142012,25.7396449704142
06112,06,112,2337,818,1,817,568,249,35.00213949507916,0.12224938875305623,99.87775061124694,69.43765281173594,30.440097799511
06113,06,113,2003,823,1,822,635,187,41.088367448826766,0.12150668286755771,99.87849331713244,77.15674362089915,22.721749696233292
06114,06,114,2080,730,0,730,564,166,35.09615384615385,0.0,100.0,77.26027397260275,22.73972602739726
06115,06,115,2232,856,3,853,642,211,38.35125448028674,0.35046728971962615,99.64953271028037,75.0,24.649532710280376
06116,06,116,2413,784,0,784,546,238,32.49067550766681,0.0,100.0,69.64285714285714,30.357142857142854
06117,06,117,2238,724,2,722,540,182,32.350312779267206,0.2762430939226519,99.72375690607734,74.58563535911603,25.13812154696133
06118,06,118,2239,769,2,767,568,199,34.345690040196516,0.26007802340702213,99.73992197659298,73.86215864759428,25.8777633289987
06119,06,119,2157,816,1,815,620,195,37.83031988873435,0.12254901960784313,99.87745098039215,75.98039215686273,23.897058823529413
06120,06,120,1010,415,0,415,252,163,41.089108910891085,0.0,100.0,60.722891566265055,39.277108433734945
06121,06,121,2011,791,1,790,574,216,39.33366484336151,0.12642225031605564,99.87357774968395,72.56637168141593,27.307206068268012
06122,06,122,2058,694,0,694,501,193,33.7220602526725,0.0,100.0,72.19020172910663,27.80979827089337
06123,06,123,1805,672,0,672,436,236,37.229916897506925,0.0,100.0,64.88095238095238,35.11904761904761
06124,06,124,2198,905,1,904,700,204,41.173794358507735,0.11049723756906078,99.88950276243094,77.34806629834254,22.5414364640884
06125,06,125,769,243,0,243,161,82,31.599479843953187,0.0,100.0,66.2551440329218,33.744855967078195
06126,06,126,971,400,1,399,294,105,41.1946446961895,0.25,99.75,73.5,26.25
06127,06,127,1152,386,1,385,284,101,33.50694444444444,0.2590673575129534,99.74093264248705,73.57512953367875,26.165803108808287
06128,06,128,1177,497,0,497,369,128,42.22599830076466,0.0,100.0,74.24547283702213,25.75452716297787
071A,07,1A,0,917,2,915,696,219,inf,0.21810250817884408,99.78189749182116,75.89967284623773,23.882224645583424
071B,07,1B,0,540,22,518,361,157,inf,4.074074074074074,95.92592592592592,66.85185185185185,29.074074074074076
071C,07,1C,0,921,3,918,676,242,inf,0.32573289902280134,99.6742671009772,73.39847991313789,26.275787187839306
071D,07,1D,0,900,2,898,655,243,inf,0.2222222222222222,99.77777777777777,72.77777777777777,27.0
071E,07,1E,0,900,1,899,672,227,inf,0.1111111111111111,99.8888888888889,74.66666666666667,25.222222222222225
071F,07,1F,0,878,0,878,635,243,inf,0.0,100.0,72.32346241457859,27.676537585421414
071G,07,1G,0,893,0,893,696,197,inf,0.0,100.0,77.93952967525196,22.060470324748042
071H,07,1H,0,904,1,903,629,274,inf,0.11061946902654868,99.88938053097345,69.57964601769912,30.30973451327434
071I,07,1I,0,958,0,958,642,316,inf,0.0,100.0,67.01461377870564,32.98538622129436
071K,07,1K,0,956,3,953,671,282,inf,0.3138075313807531,99.68619246861925,70.18828451882845,29.497907949790797
071L,07,1L,0,902,1,901,652,249,inf,0.11086474501108648,99.88913525498891,72.28381374722838,27.605321507760532
071M,07,1M,0,877,1,876,639,237,inf,0.11402508551881414,99.8859749144812,72.86202964652223,27.02394526795895
071N,07,1N,0,927,3,924,627,297,inf,0.3236245954692557,99.67637540453075,67.63754045307444,32.038834951456316
071O,07,1O,0,923,15,908,696,212,inf,1.6251354279523293,98.37486457204767,75.40628385698808,22.968580715059588
071P,07,1P,0,929,2,927,563,364,inf,0.2152852529601722,99.78471474703983,60.60279870828849,39.181916038751346
071Q,07,1Q,0,901,0,901,646,255,inf,0.0,100.0,71.69811320754717,28.30188679245283
071R,07,1R,0,900,0,900,677,223,inf,0.0,100.0,75.22222222222223,24.77777777777778
071S,07,1S,0,926,1,925,656,269,inf,0.10799136069114472,99.89200863930886,70.84233261339092,29.049676025917925
071T,07,1T,0,921,0,921,703,218,inf,0.0,100.0,76.33007600434311,23.669923995656895
071U,07,1U,0,916,2,914,659,255,inf,0.21834061135371177,99.78165938864629,71.94323144104804,27.838427947598255
071V,07,1V,0,917,0,917,709,208,inf,0.0,100.0,77.31733914940023,22.68266085059978
071W,07,1W,0,922,1,921,693,228,inf,0.10845986984815618,99.89154013015184,75.16268980477223,24.728850325379607
071X,07,1X,0,887,1,886,660,226,inf,0.11273957158962795,99.88726042841037,74.40811724915444,25.47914317925592
071Y,07,1Y,0,890,3,887,672,215,inf,0.33707865168539325,99.6629213483146,75.50561797752809,24.15730337078652
071Z,07,1Z,0,872,8,864,625,239,inf,0.9174311926605505,99.08256880733946,71.67431192660551,27.408256880733944
072A,07,2A,0,884,1,883,670,213,inf,0.11312217194570137,99.8868778280543,75.7918552036199,24.09502262443439
072B,07,2B,0,863,0,863,653,210,inf,0.0,100.0,75.66628041714948,24.33371958285052
072C,07,2C,0,872,0,872,691,181,inf,0.0,100.0,79.24311926605505,20.756880733944953
072D,07,2D,0,847,1,846,657,189,inf,0.11806375442739078,99.88193624557262,77.56788665879574,22.31404958677686
072E,07,2E,0,895,2,893,683,210,inf,0.22346368715083798,99.77653631284916,76.31284916201118,23.463687150837988
072F,07,2F,0,891,1,890,689,201,inf,0.11223344556677892,99.88776655443323,77.32884399551067,22.55892255892256
072G,07,2G,0,880,0,880,577,303,inf,0.0,100.0,65.56818181818181,34.43181818181818
072H,07,2H,0,871,1,870,630,240,inf,0.1148105625717566,99.88518943742825,72.33065442020667,27.554535017221582
072I,07,2I,0,849,5,844,613,231,inf,0.5889281507656066,99.41107184923439,72.20259128386337,27.208480565371023
072K,07,2K,0,443,2,441,328,113,inf,0.4514672686230248,99.54853273137697,74.04063205417607,25.5079006772009
072L,07,2L,0,850,4,846,615,231,inf,0.4705882352941176,99.52941176470588,72.35294117647058,27.176470588235297
072M,07,2M,0,879,3,876,658,218,inf,0.3412969283276451,99.65870307167235,74.85779294653014,24.800910125142206
072N,07,2N,0,882,1,881,602,279,inf,0.11337868480725624,99.88662131519274,68.25396825396825,31.63265306122449
072O,07,2O,0,862,0,862,620,242,inf,0.0,100.0,71.92575406032483,28.074245939675173
072P,07,2P,0,683,1,682,493,189,inf,0.14641288433382138,99.85358711566617,72.18155197657394,27.672035139092237
07899,07,899,1014,455,0,455,392,63,44.871794871794876,0.0,100.0,86.15384615384616,13.846153846153847
07900,07,900,2253,508,0,508,371,137,22.547714158899247,0.0,100.0,73.03149606299213,26.968503937007878
07901,07,901,3244,570,0,570,337,233,17.57090012330456,0.0,100.0,59.122807017543856,40.87719298245614
07902,07,902,3328,545,1,544,285,259,16.376201923076923,0.1834862385321101,99.81651376146789,52.293577981651374,47.522935779816514
07903,07,903,2396,584,1,583,323,260,24.37395659432387,0.17123287671232876,99.82876712328768,55.3082191780822,44.52054794520548
07904,07,904,1316,248,0,248,154,94,18.84498480243161,0.0,100.0,62.096774193548384,37.903225806451616
07905,07,905,2042,440,0,440,258,182,21.547502448579824,0.0,100.0,58.63636363636363,41.36363636363637
07906,07,906,3242,917,2,915,562,353,28.285009253547194,0.21810250817884408,99.78189749182116,61.286804798255176,38.49509269356597
07907,07,907,3183,984,2,982,661,321,30.914231856738926,0.20325203252032523,99.79674796747967,67.17479674796748,32.6219512195122
07908,07,908,3318,774,1,773,385,388,23.32730560578662,0.12919896640826875,99.87080103359173,49.74160206718346,50.129198966408275
07909,07,909,1085,252,1,251,136,115,23.225806451612904,0.3968253968253968,99.60317460317461,53.96825396825397,45.63492063492063
07910,07,910,822,223,1,222,113,109,27.128953771289538,0.4484304932735426,99.55156950672645,50.672645739910315,48.87892376681614
07911,07,911,1280,355,1,354,188,166,27.734375,0.28169014084507044,99.71830985915493,52.95774647887323,46.76056338028169
07912,07,912,1219,212,0,212,81,131,17.391304347826086,0.0,100.0,38.20754716981132,61.79245283018868
07913,07,913,3399,1063,4,1059,691,368,31.27390408943807,0.37629350893697083,99.62370649106302,65.00470366886171,34.61900282220132
07914,07,914,2454,679,2,677,348,329,27.669111654441732,0.29455081001472755,99.70544918998527,51.25184094256259,48.45360824742268
07915,07,915,2373,621,0,621,289,332,26.169405815423513,0.0,100.0,46.53784219001611,53.4621578099839
07916,07,916,2404,629,0,629,292,337,26.164725457570714,0.0,100.0,46.42289348171701,53.57710651828299
07917,07,917,2274,667,0,667,287,380,29.331574318381705,0.0,100.0,43.02848575712144,56.97151424287856
07918,07,918,2308,494,1,493,257,236,21.403812824956674,0.20242914979757085,99.79757085020243,52.0242914979757,47.77327935222672
07919,07,919,2330,329,2,327,181,146,14.120171673819742,0.60790273556231,99.3920972644377,55.01519756838906,44.37689969604863
07920,07,920,2452,489,2,487,260,227,19.94290375203915,0.408997955010225,99.59100204498978,53.16973415132924,46.421267893660534
07921,07,921,2337,611,2,609,317,292,26.144629867351306,0.32733224222585927,99.67266775777414,51.882160392798696,47.79050736497545
07922,07,922,2076,520,1,519,333,186,25.048169556840076,0.19230769230769232,99.8076923076923,64.03846153846153,35.76923076923077
07923,07,923,877,203,1,202,97,105,23.14709236031927,0.49261083743842365,99.50738916256158,47.783251231527096,51.724137931034484
07924,07,924,1067,292,1,291,109,182,27.366447985004687,0.3424657534246575,99.65753424657534,37.32876712328767,62.328767123287676
07925,07,925,1120,242,0,242,104,138,21.607142857142858,0.0,100.0,42.97520661157025,57.02479338842975
07926,07,926,2234,645,1,644,279,365,28.871978513876456,0.15503875968992248,99.84496124031008,43.25581395348837,56.58914728682171
07927,07,927,3541,1189,6,1183,496,687,33.57808528664219,0.5046257359125316,99.49537426408746,41.71572750210261,57.77964676198486
07928,07,928,3708,705,1,704,385,319,19.01294498381877,0.14184397163120568,99.8581560283688,54.60992907801418,45.248226950354606
07929,07,929,3707,1231,2,1229,464,765,33.207445373617475,0.16246953696181965,99.83753046303818,37.692932575142166,62.144597887896026
07930,07,930,1299,361,0,361,175,186,27.79060816012317,0.0,100.0,48.476454293628805,51.52354570637119
07931,07,931,2343,759,0,759,295,464,32.3943661971831,0.0,100.0,38.866930171278,61.133069828722
07932,07,932,2216,752,2,750,316,434,33.935018050541515,0.26595744680851063,99.7340425531915,42.02127659574468,57.71276595744681
07933,07,933,2438,790,1,789,315,474,32.40360951599672,0.12658227848101267,99.87341772151899,39.87341772151899,60.0
07934,07,934,3505,1418,2,1416,560,856,40.4564907275321,0.14104372355430184,99.8589562764457,39.492242595204516,60.36671368124118
07935,07,935,3395,1141,0,1141,502,639,33.608247422680414,0.0,100.0,43.99649430324277,56.00350569675723
07936,07,936,3272,1315,4,1311,487,824,40.18948655256724,0.3041825095057034,99.69581749049429,37.03422053231939,62.661596958174904
07937,07,937,1987,715,1,714,534,180,35.98389531957725,0.13986013986013987,99.86013986013987,74.68531468531468,25.174825174825177
07938,07,938,2212,974,2,972,650,322,44.032549728752265,0.20533880903490762,99.7946611909651,66.73511293634496,33.059548254620125
07939,07,939,2213,902,2,900,668,232,40.759150474469045,0.22172949002217296,99.77827050997783,74.05764966740577,25.72062084257206
07940,07,940,2063,999,1,998,530,468,48.42462433349491,0.10010010010010009,99.8998998998999,53.053053053053056,46.846846846846844
07941,07,941,2609,1042,0,1042,605,437,39.9386738213875,0.0,100.0,58.061420345489445,41.938579654510555
07942,07,942,1107,364,0,364,209,155,32.881662149954835,0.0,100.0,57.417582417582416,42.582417582417584
07943,07,943,2296,493,2,491,330,161,21.47212543554007,0.4056795131845842,99.59432048681542,66.93711967545639,32.657200811359026
07944,07,944,2640,671,1,670,484,186,25.416666666666664,0.14903129657228018,99.85096870342772,72.1311475409836,27.719821162444113
07945,07,945,2366,751,1,750,541,209,31.741335587489434,0.13315579227696406,99.86684420772303,72.03728362183755,27.82956058588549
07946,07,946,3562,1169,0,1169,759,410,32.81864121280179,0.0,100.0,64.92728828058169,35.0727117194183
07947,07,947,1102,341,0,341,247,94,30.943738656987296,0.0,100.0,72.43401759530792,27.56598240469208
07948,07,948,2470,750,1,749,512,237,30.364372469635626,0.13333333333333333,99.86666666666667,68.26666666666667,31.6
07949,07,949,1272,281,1,280,223,57,22.09119496855346,0.3558718861209964,99.644128113879,79.35943060498221,20.284697508896798
07950,07,950,1018,225,0,225,182,43,22.10216110019646,0.0,100.0,80.88888888888889,19.11111111111111
07951,07,951,3661,1377,7,1370,1101,269,37.61267413275061,0.5083514887436456,99.49164851125636,79.95642701525054,19.535221496005807
07952,07,952,2354,449,1,448,316,132,19.07391673746814,0.22271714922048996,99.77728285077951,70.37861915367483,29.398663697104677
07953,07,953,3308,1209,3,1206,815,391,36.54776299879081,0.24813895781637718,99.75186104218362,67.4110835401158,32.34077750206782
07954,07,954,1156,479,4,475,320,155,41.43598615916955,0.8350730688935281,99.16492693110646,66.80584551148226,32.35908141962422
07955,07,955,2436,812,3,809,571,238,33.33333333333333,0.3694581280788177,99.63054187192118,70.32019704433498,29.310344827586203
07956,07,956,2357,792,4,788,608,180,33.60203648705982,0.5050505050505051,99.4949494949495,76.76767676767676,22.727272727272727
07957,07,957,3317,1148,3,1145,947,198,34.6095869761833,0.2613240418118467,99.73867595818815,82.49128919860628,17.247386759581882
07958,07,958,2114,788,0,788,639,149,37.27530747398297,0.0,100.0,81.09137055837563,18.908629441624367
07959,07,959,2321,753,0,753,597,156,32.44291253769927,0.0,100.0,79.2828685258964,20.717131474103585
07960,07,960,2234,720,1,719,530,189,32.22918531781558,0.1388888888888889,99.86111111111111,73.61111111111111,26.25
07961,07,961,2136,801,0,801,662,139,37.5,0.0,100.0,82.64669163545568,17.353308364544322
07962,07,962,2025,704,2,702,551,151,34.76543209876543,0.2840909090909091,99.7159090909091,78.26704545454545,21.448863636363637
07963,07,963,2371,764,1,763,627,136,32.22269084774357,0.13089005235602094,99.86910994764398,82.06806282722513,17.801047120418847
07964,07,964,2592,883,2,881,746,135,34.066358024691354,0.22650056625141565,99.77349943374858,84.48471121177803,15.288788221970556
07965,07,965,2574,928,1,927,739,188,36.05283605283605,0.10775862068965517,99.89224137931035,79.63362068965517,20.25862068965517
07966,07,966,2320,877,0,877,709,168,37.80172413793104,0.0,100.0,80.84378563283923,19.156214367160775
07967,07,967,2293,655,2,653,563,90,28.56519843000436,0.3053435114503817,99.69465648854961,85.95419847328245,13.740458015267176
07968,07,968,2307,720,3,717,604,113,31.209362808842656,0.4166666666666667,99.58333333333333,83.88888888888889,15.694444444444445
07969,07,969,1287,279,0,279,232,47,21.678321678321677,0.0,100.0,83.15412186379928,16.845878136200717
07970,07,970,2394,952,1,951,743,208,39.76608187134503,0.10504201680672269,99.89495798319328,78.04621848739495,21.84873949579832
07971,07,971,2478,1025,1,1024,831,193,41.364003228410006,0.0975609756097561,99.90243902439025,81.07317073170732,18.829268292682926
07972,07,972,2248,1016,1,1015,822,193,45.195729537366546,0.09842519685039369,99.9015748031496,80.90551181102363,18.996062992125985
07973,07,973,3373,1225,0,1225,961,264,36.31781796620219,0.0,100.0,78.44897959183673,21.551020408163264
07974,07,974,2405,829,1,828,677,151,34.469854469854475,0.12062726176115801,99.87937273823884,81.66465621230398,18.21471652593486
07975,07,975,2020,710,1,709,601,108,35.148514851485146,0.14084507042253522,99.85915492957747,84.64788732394366,15.211267605633802
07976,07,976,2090,521,0,521,451,70,24.928229665071772,0.0,100.0,86.56429942418427,13.43570057581574
07977,07,977,2894,968,1,967,808,159,33.44851416724257,0.10330578512396695,99.89669421487604,83.47107438016529,16.425619834710744
07978,07,978,1946,660,1,659,549,110,33.91572456320658,0.15151515151515152,99.84848484848486,83.18181818181817,16.666666666666664
07979,07,979,2043,565,1,564,477,87,27.65540871267744,0.17699115044247787,99.82300884955752,84.42477876106194,15.398230088495577
07980,07,980,2496,937,1,936,802,134,37.5400641025641,0.10672358591248667,99.89327641408752,85.5923159018143,14.300960512273212
07981,07,981,2621,1126,1,1125,934,191,42.96070202212896,0.08880994671403197,99.91119005328596,82.94849023090586,16.962699822380106
07982,07,982,1091,400,0,400,344,56,36.663611365719525,0.0,100.0,86.0,14.000000000000002
07983,07,983,2470,1063,3,1060,895,165,43.03643724696356,0.28222013170272814,99.71777986829727,84.19567262464722,15.522107243650046
07984,07,984,1992,916,1,915,736,179,45.98393574297189,0.10917030567685589,99.89082969432314,80.34934497816593,19.541484716157207
07985,07,985,2107,868,0,868,714,154,41.19601328903654,0.0,100.0,82.25806451612904,17.741935483870968
07986,07,986,2276,883,0,883,724,159,38.796133567662565,0.0,100.0,81.99320498301246,18.006795016987542
07987,07,987,2022,608,0,608,515,93,30.06923837784372,0.0,100.0,84.70394736842105,15.296052631578947
07988,07,988,2343,1032,0,1032,778,254,44.0460947503201,0.0,100.0,75.3875968992248,24.612403100775193
07989,07,989,2358,858,0,858,702,156,36.38676844783715,0.0,100.0,81.81818181818183,18.181818181818183
07990,07,990,2297,820,1,819,678,141,35.69873748367436,0.12195121951219512,99.8780487804878,82.68292682926828,17.195121951219512
07991,07,991,2175,887,1,886,761,125,40.7816091954023,0.11273957158962795,99.88726042841037,85.79481397970687,14.092446448703495
07992,07,992,2156,532,1,531,467,64,24.675324675324674,0.18796992481203006,99.81203007518798,87.78195488721805,12.030075187969924
07993,07,993,3578,1263,0,1263,1043,220,35.29904974846283,0.0,100.0,82.58115597783056,17.418844022169438
07994,07,994,2212,546,0,546,481,65,24.68354430379747,0.0,100.0,88.09523809523809,11.904761904761903
07995,07,995,2440,944,0,944,759,185,38.68852459016394,0.0,100.0,80.40254237288136,19.597457627118644
07996,07,996,3364,1273,1,1272,1003,269,37.84185493460166,0.07855459544383347,99.92144540455617,78.79025923016496,21.1311861743912
07997,07,997,1141,403,0,403,327,76,35.31989482909728,0.0,100.0,81.14143920595534,18.858560794044664
07998,07,998,1150,462,0,462,378,84,40.17391304347826,0.0,100.0,81.81818181818183,18.181818181818183
07999,07,999,1059,291,0,291,247,44,27.47875354107649,0.0,100.0,84.87972508591065,15.120274914089347
081A,08,1A,0,1292,2,1290,977,313,inf,0.15479876160990713,99.84520123839009,75.61919504643963,24.226006191950464
081B,08,1B,0,1070,3,1067,828,239,inf,0.2803738317757009,99.7196261682243,77.38317757009345,22.336448598130843
081C,08,1C,0,1083,1,1082,857,225,inf,0.09233610341643582,99.90766389658357,79.1320406278855,20.77562326869806
081D,08,1D,0,1104,14,1090,832,258,inf,1.2681159420289856,98.73188405797102,75.36231884057972,23.369565217391305
081E,08,1E,0,1081,2,1079,855,224,inf,0.18501387604070307,99.81498612395929,79.09343200740055,20.721554116558742
081F,08,1F,0,1081,0,1081,812,269,inf,0.0,100.0,75.11563367252543,24.88436632747456
081G,08,1G,0,1078,0,1078,834,244,inf,0.0,100.0,77.36549165120594,22.634508348794064
081H,08,1H,0,1081,2,1079,868,211,inf,0.18501387604070307,99.81498612395929,80.29602220166512,19.518963922294173
081I,08,1I,0,1074,3,1071,849,222,inf,0.27932960893854747,99.72067039106145,79.05027932960894,20.670391061452513
081K,08,1K,0,1081,2,1079,803,276,inf,0.18501387604070307,99.81498612395929,74.28307123034227,25.53191489361702
081L,08,1L,0,1053,4,1049,794,255,inf,0.3798670465337132,99.6201329534663,75.40360873694208,24.216524216524217
081M,08,1M,0,1125,22,1103,799,304,inf,1.9555555555555555,98.04444444444445,71.02222222222223,27.02222222222222
081N,08,1N,0,1084,0,1084,831,253,inf,0.0,100.0,76.66051660516605,23.339483394833948
081O,08,1O,0,1071,2,1069,844,225,inf,0.18674136321195145,99.81325863678805,78.80485527544351,21.008403361344538
081P,08,1P,0,1071,3,1068,822,246,inf,0.2801120448179272,99.71988795518207,76.75070028011206,22.969187675070028
081Q,08,1Q,0,1069,1,1068,804,264,inf,0.09354536950420954,99.90645463049579,75.21047708138447,24.69597754911132
081R,08,1R,0,1074,4,1070,851,219,inf,0.37243947858473,99.62756052141528,79.2364990689013,20.391061452513966
081S,08,1S,0,1172,0,1172,901,271,inf,0.0,100.0,76.87713310580205,23.12286689419795
08101,08,101,3723,919,7,912,372,540,24.684394305667475,0.7616974972796519,99.23830250272034,40.47878128400435,58.759521218715996
08104,08,104,3987,944,3,941,406,535,23.676950087785304,0.31779661016949157,99.6822033898305,43.00847457627119,56.67372881355932
08105,08,105,2602,692,1,691,309,382,26.594926979246736,0.1445086705202312,99.85549132947978,44.653179190751445,55.202312138728324
08108,08,108,2620,661,6,655,319,336,25.229007633587784,0.9077155824508321,99.09228441754917,48.26021180030257,50.832072617246595
08110,08,110,2984,754,2,752,414,338,25.26809651474531,0.2652519893899204,99.73474801061008,54.907161803713535,44.827586206896555
08114,08,114,1072,255,0,255,139,116,23.787313432835823,0.0,100.0,54.509803921568626,45.490196078431374
08115,08,115,3467,885,2,883,554,329,25.526391693106433,0.22598870056497175,99.77401129943503,62.59887005649718,37.175141242937855
08118,08,118,2100,582,2,580,393,187,27.714285714285715,0.3436426116838488,99.65635738831615,67.5257731958763,32.13058419243986
08119,08,119,4030,1021,1,1020,627,393,25.334987593052112,0.0979431929480901,99.9020568070519,61.4103819784525,38.491674828599415
08122,08,122,1710,453,2,451,340,111,26.49122807017544,0.44150110375275936,99.55849889624724,75.05518763796908,24.503311258278146
08125,08,125,1233,340,1,339,209,130,27.5750202757502,0.29411764705882354,99.70588235294117,61.47058823529412,38.23529411764706
08126,08,126,3668,994,1,993,480,513,27.099236641221374,0.1006036217303823,99.89939637826963,48.2897384305835,51.60965794768612
08129,08,129,971,237,2,235,116,119,24.407826982492274,0.8438818565400843,99.15611814345992,48.9451476793249,50.210970464135016
08201,08,201,3828,1106,1,1105,527,578,28.89237199582027,0.09041591320072333,99.90958408679927,47.64918625678119,52.26039783001808
08202,08,202,2910,722,1,721,368,353,24.810996563573884,0.13850415512465375,99.86149584487535,50.96952908587258,48.89196675900277
08207,08,207,3207,1079,3,1076,525,551,33.6451512316807,0.27803521779425394,99.72196478220575,48.65616311399444,51.06580166821131
08208,08,208,3105,817,0,817,417,400,26.31239935587762,0.0,100.0,51.040391676866584,48.959608323133416
08211,08,211,1384,282,1,281,144,137,20.3757225433526,0.3546099290780142,99.64539007092199,51.06382978723404,48.58156028368794
08213,08,213,3509,886,3,883,566,317,25.24935879167854,0.33860045146726864,99.66139954853274,63.88261851015802,35.77878103837472
08216,08,216,1162,341,1,340,181,159,29.345955249569705,0.2932551319648094,99.70674486803519,53.0791788856305,46.62756598240469
08218,08,218,888,185,0,185,99,86,20.833333333333336,0.0,100.0,53.51351351351351,46.48648648648649
08219,08,219,3250,988,4,984,577,407,30.4,0.4048582995951417,99.59514170040485,58.40080971659919,41.19433198380567
08221,08,221,3620,991,3,988,512,476,27.375690607734803,0.30272452068617556,99.69727547931383,51.66498486377397,48.03229061553986
08223,08,223,3125,794,6,788,378,410,25.407999999999998,0.7556675062972292,99.24433249370277,47.607052896725435,51.63727959697732
08227,08,227,831,199,0,199,130,69,23.94705174488568,0.0,100.0,65.32663316582915,34.67336683417086
08229,08,229,924,203,0,203,119,84,21.96969696969697,0.0,100.0,58.620689655172406,41.37931034482759
08301,08,301,2556,804,1,803,555,248,31.455399061032864,0.12437810945273632,99.87562189054727,69.02985074626866,30.845771144278604
08304,08,304,2388,463,1,462,329,133,19.38860971524288,0.21598272138228944,99.78401727861771,71.05831533477321,28.725701943844495
08305,08,305,2212,542,2,540,371,169,24.50271247739602,0.36900369003690037,99.63099630996311,68.45018450184503,31.18081180811808
08308,08,308,3586,870,1,869,668,201,24.26101505856107,0.11494252873563218,99.88505747126437,76.7816091954023,23.103448275862068
08309,08,309,1337,259,0,259,211,48,19.3717277486911,0.0,100.0,81.46718146718148,18.53281853281853
08310,08,310,2763,721,0,721,544,177,26.09482446615997,0.0,100.0,75.4507628294036,24.549237170596395
08313,08,313,3625,955,1,954,786,168,26.344827586206897,0.10471204188481677,99.89528795811519,82.30366492146597,17.591623036649214
08318,08,318,3378,1151,3,1148,932,216,34.073416222616935,0.26064291920069504,99.73935708079931,80.97306689834926,18.766290182450042
08321,08,321,1599,494,1,493,429,64,30.89430894308943,0.20242914979757085,99.79757085020243,86.8421052631579,12.955465587044534
08322,08,322,1571,449,1,448,359,89,28.580521960534693,0.22271714922048996,99.77728285077951,79.9554565701559,19.821826280623608
08323,08,323,1197,354,0,354,271,83,29.57393483709273,0.0,100.0,76.55367231638418,23.44632768361582
08325,08,325,3487,1295,1,1294,924,370,37.13794092342989,0.07722007722007722,99.92277992277992,71.35135135135135,28.57142857142857
08401,08,401,2598,1112,0,1112,819,293,42.80215550423402,0.0,100.0,73.65107913669064,26.348920863309356
08403,08,403,2905,818,1,817,668,149,28.158347676419965,0.12224938875305623,99.87775061124694,81.66259168704157,18.21515892420538
08406,08,406,3649,1098,3,1095,872,223,30.090435735818033,0.273224043715847,99.72677595628416,79.41712204007287,20.309653916211293
08410,08,410,1557,674,2,672,568,104,43.28837508028259,0.2967359050445104,99.70326409495549,84.27299703264094,15.43026706231454
08411,08,411,2444,875,0,875,763,112,35.801963993453356,0.0,100.0,87.2,12.8
08412,08,412,3243,1258,1,1257,1038,219,38.79124267653407,0.0794912559618442,99.92050874403816,82.51192368839428,17.40858505564388
08413,08,413,2995,1288,3,1285,1065,220,43.00500834724541,0.2329192546583851,99.76708074534162,82.6863354037267,17.080745341614907
08417,08,417,1420,553,0,553,438,115,38.943661971830984,0.0,100.0,79.20433996383363,20.795660036166367
08422,08,422,3726,1358,3,1355,1181,174,36.44659151905529,0.22091310751104565,99.77908689248895,86.9661266568483,12.812960235640647
08425,08,425,2972,1021,1,1020,866,154,34.353970390309556,0.0979431929480901,99.9020568070519,84.81880509304604,15.083251714005877
08426,08,426,2015,772,1,771,668,103,38.312655086848636,0.1295336787564767,99.87046632124353,86.52849740932642,13.341968911917098
08428,08,428,2740,1090,0,1090,888,202,39.78102189781022,0.0,100.0,81.46788990825688,18.53211009174312
08501,08,501,2887,1048,1,1047,872,175,36.300658122618636,0.09541984732824427,99.90458015267176,83.20610687022901,16.698473282442748
08504,08,504,2970,1148,0,1148,876,272,38.65319865319865,0.0,100.0,76.30662020905923,23.693379790940767
08505,08,505,3787,1222,3,1219,1016,203,32.26828624240824,0.24549918166939444,99.7545008183306,83.14238952536824,16.612111292962357
08510,08,510,1356,471,2,469,408,61,34.73451327433628,0.42462845010615713,99.57537154989384,86.62420382165605,12.951167728237792
08511,08,511,3261,1099,0,1099,945,154,33.70131861392211,0.0,100.0,85.98726114649682,14.012738853503185
08512,08,512,3610,1456,1,1455,1229,226,40.332409972299175,0.06868131868131869,99.93131868131869,84.40934065934066,15.521978021978022
08517,08,517,3343,931,2,929,797,132,27.849237212084955,0.21482277121374865,99.78517722878625,85.60687432867884,14.178302900107411
08519,08,519,2489,825,6,819,708,111,33.145841703495385,0.7272727272727273,99.27272727272727,85.81818181818181,13.454545454545455
08521,08,521,2410,608,0,608,512,96,25.228215767634854,0.0,100.0,84.21052631578947,15.789473684210526
08526,08,526,3245,1004,2,1002,870,132,30.939907550077038,0.199203187250996,99.800796812749,86.65338645418326,13.147410358565736
08528,08,528,1491,557,1,556,470,86,37.35747820254863,0.17953321364452424,99.82046678635548,84.38061041292639,15.439856373429084
08530,08,530,2266,567,0,567,475,92,25.022065313327452,0.0,100.0,83.77425044091711,16.225749559082892
08534,08,534,829,307,0,307,242,65,37.03256936067551,0.0,100.0,78.82736156351791,21.172638436482085
08601,08,601,3150,795,1,794,671,123,25.238095238095237,0.12578616352201258,99.87421383647799,84.40251572327044,15.471698113207546
08603,08,603,2384,970,2,968,805,163,40.68791946308725,0.2061855670103093,99.79381443298969,82.9896907216495,16.804123711340207
08605,08,605,3077,1280,3,1277,1023,254,41.59896002599935,0.234375,99.765625,79.921875,19.84375
08608,08,608,1125,321,0,321,260,61,28.53333333333333,0.0,100.0,80.99688473520249,19.003115264797508
08610,08,610,3210,1226,3,1223,970,253,38.19314641744548,0.24469820554649263,99.75530179445352,79.11908646003263,20.636215334420882
08614,08,614,1089,378,0,378,305,73,34.710743801652896,0.0,100.0,80.68783068783068,19.31216931216931
08616,08,616,1063,406,1,405,344,61,38.19379115710254,0.24630541871921183,99.75369458128078,84.72906403940887,15.024630541871922
08617,08,617,3371,1344,1,1343,1021,322,39.86947493325423,0.0744047619047619,99.92559523809523,75.96726190476191,23.958333333333336
08619,08,619,3096,1458,3,1455,1154,301,47.093023255813954,0.205761316872428,99.79423868312757,79.14951989026063,20.644718792866943
08622,08,622,2297,1046,0,1046,872,174,45.53765781454071,0.0,100.0,83.36520076481835,16.634799235181642
08623,08,623,3392,1313,1,1312,1061,251,38.70872641509434,0.07616146230007616,99.92383853769992,80.8073115003808,19.116527037319116
08628,08,628,3400,1243,1,1242,986,256,36.55882352941177,0.08045052292839903,99.9195494770716,79.32421560740146,20.595333869670153
08632,08,632,1001,357,0,357,294,63,35.66433566433567,0.0,100.0,82.35294117647058,17.647058823529413
091A,09,1A,0,1272,1,1271,543,728,inf,0.07861635220125787,99.92138364779875,42.68867924528302,57.23270440251572
091B,09,1B,0,1245,1,1244,546,698,inf,0.08032128514056225,99.91967871485944,43.855421686746986,56.06425702811245
091C,09,1C,0,1252,0,1252,547,705,inf,0.0,100.0,43.69009584664536,56.30990415335463
091D,09,1D,0,1228,4,1224,509,715,inf,0.32573289902280134,99.6742671009772,41.44951140065147,58.22475570032574
091E,09,1E,0,1213,0,1213,703,510,inf,0.0,100.0,57.95548227535037,42.04451772464963
091F,09,1F,0,1230,1,1229,509,720,inf,0.08130081300813008,99.91869918699187,41.38211382113821,58.536585365853654
091G,09,1G,0,1201,0,1201,572,629,inf,0.0,100.0,47.626977518734385,52.37302248126561
091H,09,1H,0,1231,4,1227,508,719,inf,0.3249390739236393,99.67506092607637,41.26726238830219,58.40779853777417
091J,09,1J,0,1257,3,1254,541,713,inf,0.23866348448687352,99.76133651551312,43.03898170246619,56.72235481304694
091K,09,1K,0,1245,2,1243,549,694,inf,0.1606425702811245,99.83935742971887,44.096385542168676,55.7429718875502
091L,09,1L,0,1243,4,1239,551,688,inf,0.32180209171359614,99.6781979082864,44.32823813354787,55.34995977473854
091M,09,1M,0,1257,1,1256,579,677,inf,0.07955449482895784,99.92044550517105,46.06205250596659,53.858392999204455
09101,09,101,1922,484,3,481,177,304,25.18210197710718,0.6198347107438017,99.3801652892562,36.570247933884296,62.8099173553719
09103,09,103,2438,615,0,615,226,389,25.225594749794915,0.0,100.0,36.7479674796748,63.25203252032521
09104,09,104,3322,867,6,861,274,587,26.098735701384708,0.6920415224913495,99.30795847750865,31.603229527104958,67.70472895040369
09108,09,108,3360,793,0,793,236,557,23.601190476190474,0.0,100.0,29.760403530895335,70.23959646910467
09111,09,111,2437,605,0,605,193,412,24.82560525235946,0.0,100.0,31.900826446280995,68.09917355371901
09113,09,113,2503,701,0,701,173,528,28.006392329204953,0.0,100.0,24.679029957203994,75.320970042796
09116,09,116,2368,498,1,497,167,330,21.030405405405407,0.2008032128514056,99.79919678714859,33.53413654618474,66.26506024096386
09120,09,120,2529,761,1,760,191,569,30.090945037564254,0.1314060446780552,99.86859395532196,25.098554533508544,74.77003942181341
09122,09,122,2416,714,6,708,208,500,29.55298013245033,0.8403361344537815,99.15966386554622,29.13165266106443,70.02801120448179
09126,09,126,965,257,0,257,87,170,26.632124352331605,0.0,100.0,33.85214007782101,66.14785992217898
09127,09,127,917,250,0,250,93,157,27.262813522355504,0.0,100.0,37.2,62.8
09128,09,128,988,283,0,283,91,192,28.643724696356276,0.0,100.0,32.15547703180212,67.84452296819788
09130,09,130,2761,782,3,779,254,525,28.3230713509598,0.3836317135549872,99.61636828644501,32.48081841432225,67.13554987212275
09133,09,133,1944,548,0,548,243,305,28.189300411522634,0.0,100.0,44.34306569343065,55.65693430656934
09135,09,135,2720,621,0,621,240,381,22.830882352941178,0.0,100.0,38.64734299516908,61.35265700483091
09201,09,201,1718,419,1,418,127,291,24.38882421420256,0.23866348448687352,99.76133651551312,30.310262529832936,69.4510739856802
09204,09,204,3146,783,2,781,275,506,24.888747616020343,0.2554278416347382,99.74457215836526,35.1213282247765,64.62324393358875
09207,09,207,3357,785,0,785,298,487,23.38397378611856,0.0,100.0,37.961783439490446,62.038216560509554
09208,09,208,2083,606,2,604,256,348,29.092654824771962,0.33003300330033003,99.66996699669967,42.244224422442244,57.42574257425742
09211,09,211,3123,878,1,877,345,532,28.11399295549151,0.11389521640091116,99.88610478359908,39.29384965831435,60.59225512528473
09212,09,212,834,263,2,261,70,191,31.534772182254194,0.7604562737642585,99.23954372623575,26.61596958174905,72.6235741444867
09214,09,214,1102,340,0,340,108,232,30.852994555353902,0.0,100.0,31.76470588235294,68.23529411764706
09216,09,216,3489,928,1,927,328,599,26.59787904843795,0.10775862068965517,99.89224137931035,35.3448275862069,64.54741379310344
09221,09,221,1922,412,0,412,132,280,21.436004162330903,0.0,100.0,32.038834951456316,67.96116504854369
09222,09,222,1377,287,1,286,111,175,20.84241103848947,0.34843205574912894,99.65156794425087,38.67595818815331,60.97560975609756
09224,09,224,2365,381,1,380,139,241,16.109936575052856,0.26246719160104987,99.73753280839895,36.48293963254593,63.25459317585301
09227,09,227,530,124,0,124,60,64,23.39622641509434,0.0,100.0,48.38709677419355,51.61290322580645
09228,09,228,2415,558,2,556,208,348,23.1055900621118,0.35842293906810035,99.6415770609319,37.27598566308244,62.365591397849464
09230,09,230,3498,731,2,729,263,466,20.89765580331618,0.27359781121751026,99.72640218878249,35.9781121751026,63.748290013679885
09231,09,231,856,147,0,147,49,98,17.172897196261683,0.0,100.0,33.33333333333333,66.66666666666666
09236,09,236,2527,470,1,469,196,273,18.599129402453503,0.2127659574468085,99.7872340425532,41.702127659574465,58.08510638297872
09301,09,301,704,236,0,236,95,141,33.52272727272727,0.0,100.0,40.25423728813559,59.7457627118644
09302,09,302,2326,556,4,552,193,359,23.903697334479794,0.7194244604316548,99.28057553956835,34.71223021582734,64.568345323741
09304,09,304,3209,868,0,868,301,567,27.048924898722344,0.0,100.0,34.67741935483871,65.32258064516128
09308,09,308,3215,606,1,605,238,367,18.84914463452566,0.16501650165016502,99.83498349834984,39.273927392739274,60.561056105610554
09309,09,309,3452,693,3,690,279,411,20.075318655851678,0.4329004329004329,99.56709956709958,40.25974025974026,59.307359307359306
09314,09,314,3805,1076,3,1073,548,525,28.278580814717476,0.2788104089219331,99.72118959107806,50.92936802973978,48.79182156133829
09317,09,317,2973,869,1,868,391,477,29.229734275142956,0.11507479861910241,99.88492520138091,44.99424626006904,54.890678941311855
09319,09,319,2025,467,1,466,234,232,23.061728395061728,0.21413276231263384,99.78586723768737,50.107066381156315,49.67880085653105
09320,09,320,943,213,2,211,104,107,22.58748674443266,0.9389671361502347,99.06103286384976,48.82629107981221,50.23474178403756
09321,09,321,593,141,1,140,73,67,23.77740303541315,0.7092198581560284,99.29078014184397,51.77304964539007,47.5177304964539
09322,09,322,2391,662,1,661,349,312,27.687160184023423,0.1510574018126888,99.8489425981873,52.7190332326284,47.129909365558916
09324,09,324,2047,576,0,576,225,351,28.138739618954567,0.0,100.0,39.0625,60.9375
09326,09,326,1442,190,0,190,105,85,13.176144244105409,0.0,100.0,55.26315789473685,44.73684210526316
09328,09,328,1810,493,0,493,215,278,27.23756906077348,0.0,100.0,43.6105476673428,56.3894523326572
09330,09,330,1468,268,2,266,137,129,18.256130790190735,0.7462686567164178,99.25373134328358,51.11940298507462,48.134328358208954
09333,09,333,867,253,1,252,112,140,29.18108419838524,0.3952569169960474,99.60474308300395,44.26877470355731,55.33596837944664
09401,09,401,2907,896,4,892,553,339,30.82215342277262,0.4464285714285714,99.55357142857143,61.71875,37.83482142857143
09403,09,403,795,112,0,112,51,61,14.08805031446541,0.0,100.0,45.535714285714285,54.46428571428571
09404,09,404,1889,630,1,629,479,150,33.35097935415563,0.15873015873015872,99.84126984126985,76.03174603174602,23.809523809523807
09405,09,405,3561,1208,1,1207,914,293,33.92305532153889,0.08278145695364239,99.91721854304636,75.66225165562915,24.25496688741722
09409,09,409,3223,699,1,698,276,422,21.687868445547625,0.14306151645207438,99.85693848354794,39.48497854077253,60.37195994277539
09413,09,413,3816,656,1,655,266,389,17.19077568134172,0.1524390243902439,99.84756097560977,40.54878048780488,59.29878048780488
09418,09,418,734,110,0,110,52,58,14.986376021798364,0.0,100.0,47.27272727272727,52.72727272727272
09419,09,419,640,200,2,198,77,121,31.25,1.0,99.0,38.5,60.5
09420,09,420,1926,527,0,527,250,277,27.36240913811007,0.0,100.0,47.43833017077799,52.56166982922201
09422,09,422,911,236,0,236,88,148,25.905598243688253,0.0,100.0,37.28813559322034,62.71186440677966
09423,09,423,1263,417,2,415,216,199,33.0166270783848,0.4796163069544364,99.52038369304557,51.798561151079134,47.721822541966425
09424,09,424,760,348,0,348,285,63,45.78947368421053,0.0,100.0,81.89655172413794,18.103448275862068
09425,09,425,741,353,0,353,333,20,47.638326585695005,0.0,100.0,94.3342776203966,5.6657223796034
09426,09,426,845,385,2,383,347,36,45.562130177514796,0.5194805194805194,99.48051948051948,90.12987012987013,9.35064935064935
09427,09,427,744,245,0,245,186,59,32.93010752688172,0.0,100.0,75.91836734693878,24.081632653061224
09428,09,428,347,136,0,136,109,27,39.19308357348703,0.0,100.0,80.14705882352942,19.852941176470587
09429,09,429,2721,558,0,558,187,371,20.507166482910694,0.0,100.0,33.51254480286738,66.48745519713262
09432,09,432,3180,635,1,634,247,387,19.968553459119498,0.15748031496062992,99.84251968503936,38.89763779527559,60.94488188976378
09436,09,436,1697,409,1,408,127,281,24.101355332940482,0.24449877750611246,99.75550122249389,31.05134474327628,68.7041564792176
09501,09,501,779,178,0,178,83,95,22.849807445442877,0.0,100.0,46.62921348314607,53.37078651685393
09502,09,502,746,138,0,138,44,94,18.498659517426276,0.0,100.0,31.88405797101449,68.11594202898551
09503,09,503,1145,272,1,271,78,193,23.75545851528384,0.3676470588235294,99.63235294117648,28.676470588235293,70.95588235294117
09504,09,504,697,191,0,191,64,127,27.403156384505024,0.0,100.0,33.50785340314136,66.49214659685863
09505,09,505,706,146,1,145,49,96,20.679886685552407,0.684931506849315,99.31506849315068,33.56164383561644,65.75342465753424
09506,09,506,1992,477,3,474,134,340,23.94578313253012,0.628930817610063,99.37106918238993,28.09224318658281,71.27882599580713
09508,09,508,1343,319,0,319,100,219,23.752792256142964,0.0,100.0,31.347962382445143,68.65203761755487
09510,09,510,1411,280,2,278,109,169,19.844082211197733,0.7142857142857143,99.28571428571429,38.92857142857143,60.357142857142854
09512,09,512,751,120,0,120,41,79,15.978695073235686,0.0,100.0,34.166666666666664,65.83333333333333
09513,09,513,930,182,1,181,57,124,19.56989247311828,0.5494505494505495,99.45054945054946,31.318681318681318,68.13186813186813
09514,09,514,718,169,0,169,61,108,23.53760445682451,0.0,100.0,36.09467455621302,63.905325443786985
09515,09,515,2113,409,0,409,194,215,19.356365357311876,0.0,100.0,47.43276283618582,52.567237163814184
09518,09,518,1130,203,1,202,99,103,17.964601769911503,0.49261083743842365,99.50738916256158,48.76847290640394,50.73891625615764
09519,09,519,3280,770,0,770,336,434,23.47560975609756,0.0,100.0,43.63636363636363,56.36363636363636
09522,09,522,3098,728,1,727,294,433,23.499031633311816,0.13736263736263737,99.86263736263736,40.38461538461539,59.47802197802198
09525,09,525,2151,419,0,419,153,266,19.479311947931194,0.0,100.0,36.51551312649165,63.48448687350835
09527,09,527,1446,403,0,403,189,214,27.869986168741356,0.0,100.0,46.898263027295286,53.101736972704714
09528,09,528,2383,1008,0,1008,862,146,42.29962232480067,0.0,100.0,85.51587301587301,14.484126984126986
09530,09,530,3135,1247,2,1245,1086,159,39.77671451355662,0.16038492381716118,99.83961507618284,87.08901363271852,12.750601443464316
09601,09,601,2839,774,1,773,296,477,27.26312081718915,0.12919896640826875,99.87080103359173,38.24289405684754,61.627906976744185
09603,09,603,890,166,1,165,58,107,18.651685393258425,0.6024096385542169,99.3975903614458,34.93975903614458,64.45783132530121
09604,09,604,1001,306,1,305,127,178,30.569430569430565,0.32679738562091504,99.67320261437908,41.50326797385621,58.16993464052288
09605,09,605,1966,496,1,495,186,309,25.228891149542214,0.20161290322580644,99.79838709677419,37.5,62.298387096774185
09608,09,608,1430,370,1,369,127,242,25.874125874125873,0.2702702702702703,99.72972972972973,34.32432432432432,65.4054054054054
09609,09,609,1608,428,2,426,136,290,26.616915422885572,0.46728971962616817,99.53271028037383,31.775700934579437,67.7570093457944
09611,09,611,2428,657,2,655,235,420,27.059308072487642,0.30441400304414,99.69558599695586,35.76864535768645,63.926940639269404
09614,09,614,2664,697,3,694,233,461,26.163663663663662,0.430416068866571,99.56958393113344,33.428981348637016,66.14060258249641
09617,09,617,2347,553,0,553,180,373,23.56199403493822,0.0,100.0,32.5497287522604,67.45027124773961
09619,09,619,787,252,0,252,84,168,32.02033036848793,0.0,100.0,33.33333333333333,66.66666666666666
09620,09,620,3502,955,3,952,302,650,27.270131353512276,0.31413612565445026,99.68586387434554,31.623036649214658,68.06282722513089
09624,09,624,3545,914,4,910,264,646,25.782792665726372,0.437636761487965,99.56236323851203,28.88402625820569,70.67833698030634
09628,09,628,630,181,0,181,57,124,28.730158730158728,0.0,100.0,31.491712707182316,68.50828729281768
09629,09,629,1377,381,0,381,288,93,27.66884531590414,0.0,100.0,75.59055118110236,24.409448818897637
09630,09,630,1605,471,0,471,271,200,29.345794392523366,0.0,100.0,57.537154989384284,42.462845010615716
09631,09,631,1867,549,3,546,353,193,29.405463310123192,0.546448087431694,99.4535519125683,64.29872495446266,35.154826958105645
09633,09,633,1324,400,2,398,268,130,30.211480362537763,0.5,99.5,67.0,32.5
09634,09,634,1264,455,0,455,308,147,35.99683544303797,0.0,100.0,67.6923076923077,32.30769230769231
101A,10,1A,0,1034,3,1031,329,702,inf,0.2901353965183753,99.70986460348162,31.818181818181817,67.8916827852998
101B,10,1B,0,1026,1,1025,347,678,inf,0.09746588693957114,99.90253411306043,33.82066276803119,66.08187134502924
101C,10,1C,0,1020,1,1019,386,633,inf,0.09803921568627451,99.90196078431373,37.84313725490196,62.05882352941177
101D,10,1D,0,1023,0,1023,346,677,inf,0.0,100.0,33.822091886608014,66.17790811339198
101E,10,1E,0,1051,41,1010,343,667,inf,3.9010466222645097,96.09895337773548,32.63558515699334,63.463368220742154
101F,10,1F,0,1017,2,1015,369,646,inf,0.19665683382497542,99.80334316617503,36.283185840707965,63.52015732546706
101G,10,1G,0,1055,3,1052,343,709,inf,0.2843601895734597,99.71563981042654,32.51184834123223,67.20379146919431
101H,10,1H,0,1113,5,1108,372,736,inf,0.44923629829290207,99.5507637017071,33.42318059299191,66.12758310871519
101J,10,1J,0,1013,4,1009,348,661,inf,0.3948667324777887,99.60513326752222,34.35340572556762,65.25172754195458
101K,10,1K,0,1113,2,1111,366,745,inf,0.17969451931716085,99.82030548068283,32.88409703504043,66.93620844564241
10101,10,101,4318,518,2,516,191,325,11.996294580824456,0.3861003861003861,99.61389961389962,36.87258687258687,62.74131274131274
10102,10,102,4098,503,1,502,194,308,12.274280136652026,0.19880715705765406,99.80119284294234,38.56858846918489,61.23260437375746
10103,10,103,5406,722,2,720,239,481,13.355530891601925,0.2770083102493075,99.7229916897507,33.10249307479224,66.62049861495845
10104,10,104,3297,327,0,327,101,226,9.918107370336669,0.0,100.0,30.886850152905197,69.1131498470948
10105,10,105,3680,517,1,516,152,364,14.048913043478262,0.19342359767891684,99.80657640232108,29.40038684719536,70.40618955512572
10106,10,106,2719,454,2,452,165,287,16.69731518940787,0.4405286343612335,99.55947136563876,36.34361233480176,63.21585903083701
10107,10,107,3718,496,2,494,169,325,13.340505648197956,0.4032258064516129,99.59677419354838,34.07258064516129,65.5241935483871
10201,10,201,4202,551,2,549,221,328,13.112803426939553,0.3629764065335753,99.63702359346642,40.10889292196007,59.528130671506354
10202,10,202,3506,406,1,405,129,276,11.580148317170565,0.24630541871921183,99.75369458128078,31.773399014778324,67.98029556650246
10203,10,203,3489,455,0,455,184,271,13.040985955861279,0.0,100.0,40.43956043956044,59.56043956043956
10204,10,204,3732,466,0,466,160,306,12.486602357984996,0.0,100.0,34.33476394849785,65.66523605150213
10205,10,205,2386,429,0,429,152,277,17.979882648784574,0.0,100.0,35.43123543123543,64.56876456876456
10206,10,206,3120,560,2,558,170,388,17.94871794871795,0.35714285714285715,99.64285714285714,30.357142857142854,69.28571428571428
10207,10,207,4098,513,3,510,156,354,12.518301610541727,0.5847953216374269,99.41520467836257,30.409356725146196,69.00584795321637
10208,10,208,3522,675,1,674,200,474,19.165247018739354,0.14814814814814814,99.85185185185185,29.629629629629626,70.22222222222221
10301,10,301,3929,661,0,661,217,444,16.823619241537287,0.0,100.0,32.829046898638424,67.17095310136158
10302,10,302,2487,495,0,495,144,351,19.903498190591073,0.0,100.0,29.09090909090909,70.9090909090909
10303,10,303,3936,778,1,777,234,543,19.766260162601625,0.12853470437017994,99.87146529562982,30.077120822622106,69.79434447300771
10304,10,304,4355,869,1,868,252,616,19.954075774971297,0.11507479861910241,99.88492520138091,28.99884925201381,70.88607594936708
10305,10,305,4145,612,0,612,210,402,14.76477683956574,0.0,100.0,34.31372549019608,65.68627450980392
10306,10,306,1633,333,0,333,105,228,20.39191671769749,0.0,100.0,31.53153153153153,68.46846846846847
10307,10,307,4009,432,0,432,158,274,10.77575455225742,0.0,100.0,36.574074074074076,63.42592592592593
10308,10,308,3739,483,3,480,151,329,12.917892484621557,0.6211180124223602,99.37888198757764,31.262939958592135,68.11594202898551
10309,10,309,3889,387,2,385,139,246,9.951144253021342,0.516795865633075,99.48320413436691,35.917312661498705,63.565891472868216
10401,10,401,4245,710,1,709,197,512,16.725559481743225,0.14084507042253522,99.85915492957747,27.74647887323944,72.11267605633803
10402,10,402,3765,792,4,788,231,557,21.035856573705182,0.5050505050505051,99.4949494949495,29.166666666666668,70.32828282828282
10403,10,403,4319,944,2,942,331,611,21.856911322065294,0.211864406779661,99.78813559322035,35.063559322033896,64.72457627118644
10404,10,404,3738,851,0,851,375,476,22.76618512573569,0.0,100.0,44.06580493537015,55.93419506462985
10405,10,405,3062,425,2,423,141,282,13.879817112998042,0.4705882352941176,99.52941176470588,33.1764705882353,66.3529411764706
10406,10,406,1143,232,0,232,63,169,20.297462817147856,0.0,100.0,27.155172413793103,72.84482758620689
10407,10,407,1165,341,0,341,125,216,29.270386266094423,0.0,100.0,36.65689149560117,63.34310850439883
10408,10,408,2394,660,0,660,215,445,27.56892230576441,0.0,100.0,32.57575757575758,67.42424242424242
10409,10,409,2094,599,1,598,220,378,28.605539637058264,0.1669449081803005,99.8330550918197,36.727879799666105,63.10517529215359
10410,10,410,1255,379,4,375,101,274,30.199203187250994,1.0554089709762533,98.94459102902374,26.649076517150394,72.29551451187335
10411,10,411,1384,366,1,365,128,237,26.445086705202314,0.273224043715847,99.72677595628416,34.97267759562842,64.75409836065575
10501,10,501,3438,1027,6,1021,270,751,29.87201861547411,0.5842259006815969,99.4157740993184,26.29016553067186,73.12560856864654
10502,10,502,1258,319,1,318,122,196,25.357710651828295,0.3134796238244514,99.68652037617555,38.24451410658307,61.442006269592476
10503,10,503,2549,673,0,673,222,451,26.402510788544525,0.0,100.0,32.986627043090635,67.01337295690935
10504,10,504,2561,604,1,603,250,353,23.584537290121048,0.16556291390728478,99.83443708609272,41.390728476821195,58.443708609271525
10505,10,505,2469,726,2,724,219,505,29.404617253948967,0.27548209366391185,99.72451790633609,30.165289256198346,69.55922865013774
10506,10,506,2485,731,0,731,238,493,29.41649899396378,0.0,100.0,32.55813953488372,67.44186046511628
10507,10,507,2527,668,0,668,205,463,26.434507320933914,0.0,100.0,30.688622754491018,69.311377245509
10508,10,508,1261,380,1,379,120,259,30.13481363996828,0.2631578947368421,99.73684210526315,31.57894736842105,68.15789473684211
10509,10,509,2646,708,0,708,248,460,26.75736961451247,0.0,100.0,35.02824858757062,64.97175141242938
10510,10,510,2486,596,1,595,197,398,23.974255832662912,0.16778523489932887,99.83221476510067,33.053691275167786,66.77852348993288
10511,10,511,1120,244,0,244,76,168,21.785714285714285,0.0,100.0,31.147540983606557,68.85245901639344
10512,10,512,2176,617,4,613,214,399,28.354779411764707,0.6482982171799028,99.3517017828201,34.6839546191248,64.6677471636953
10513,10,513,1054,265,1,264,95,169,25.142314990512332,0.37735849056603776,99.62264150943396,35.84905660377358,63.77358490566037
10514,10,514,3701,976,4,972,308,664,26.371251013239664,0.4098360655737705,99.59016393442623,31.557377049180328,68.0327868852459
10601,10,601,2291,352,0,352,130,222,15.364469663902225,0.0,100.0,36.93181818181818,63.06818181818182
10602,10,602,2292,285,1,284,95,189,12.43455497382199,0.3508771929824561,99.64912280701755,33.33333333333333,66.3157894736842
10603,10,603,2649,498,1,497,146,351,18.7995469988675,0.2008032128514056,99.79919678714859,29.31726907630522,70.48192771084338
10604,10,604,2815,457,0,457,155,302,16.234458259325045,0.0,100.0,33.91684901531728,66.08315098468272
10605,10,605,2606,335,4,331,111,220,12.854950115118957,1.1940298507462688,98.80597014925372,33.134328358208954,65.67164179104478
10606,10,606,2350,337,2,335,131,204,14.340425531914894,0.5934718100890208,99.40652818991099,38.87240356083086,60.534124629080125
10607,10,607,1952,361,0,361,97,264,18.493852459016395,0.0,100.0,26.869806094182824,73.13019390581718
10608,10,608,2828,625,1,624,199,425,22.1004243281471,0.16,99.83999999999999,31.840000000000003,68.0
10609,10,609,725,194,2,192,67,125,26.75862068965517,1.0309278350515463,98.96907216494846,34.5360824742268,64.43298969072166
10610,10,610,1044,293,1,292,117,175,28.065134099616856,0.3412969283276451,99.65870307167235,39.93174061433447,59.72696245733788
10611,10,611,1891,435,0,435,135,300,23.00370174510841,0.0,100.0,31.03448275862069,68.96551724137932
10612,10,612,2242,573,2,571,198,373,25.557537912578056,0.34904013961605584,99.65095986038395,34.55497382198953,65.09598603839441
10613,10,613,2789,518,3,515,173,342,18.572965220509143,0.5791505791505791,99.42084942084942,33.397683397683394,66.02316602316603
10701,10,701,1722,234,0,234,83,151,13.588850174216027,0.0,100.0,35.47008547008547,64.52991452991454
10702,10,702,3615,436,1,435,155,280,12.060857538035961,0.22935779816513763,99.77064220183486,35.55045871559633,64.22018348623854
10703,10,703,3366,332,0,332,121,211,9.863339275103982,0.0,100.0,36.44578313253012,63.55421686746988
10704,10,704,2460,312,0,312,92,220,12.682926829268293,0.0,100.0,29.48717948717949,70.51282051282051
10705,10,705,1624,207,0,207,76,131,12.746305418719212,0.0,100.0,36.71497584541063,63.28502415458937
10706,10,706,2096,371,2,369,121,248,17.700381679389313,0.5390835579514826,99.46091644204851,32.61455525606469,66.84636118598382
10707,10,707,3415,582,4,578,180,398,17.04245973645681,0.6872852233676976,99.3127147766323,30.927835051546392,68.38487972508591
10708,10,708,2603,382,1,381,116,265,14.675374567806376,0.2617801047120419,99.73821989528795,30.36649214659686,69.3717277486911
10709,10,709,3482,429,1,428,166,262,12.320505456634118,0.2331002331002331,99.76689976689977,38.6946386946387,61.07226107226107
10710,10,710,2080,274,0,274,85,189,13.173076923076923,0.0,100.0,31.02189781021898,68.97810218978103
111A,11,1A,0,1099,2,1097,370,727,inf,0.18198362147406735,99.81801637852593,33.666969972702454,66.15104640582348
111B,11,1B,0,1221,2,1219,368,851,inf,0.16380016380016382,99.83619983619984,30.13923013923014,69.6969696969697
111C,11,1C,0,1174,1,1173,325,848,inf,0.08517887563884156,99.91482112436117,27.68313458262351,72.23168654173764
111D,11,1D,0,1221,3,1218,349,869,inf,0.2457002457002457,99.75429975429975,28.58312858312858,71.17117117117117
111E,11,1E,0,1042,2,1040,297,743,inf,0.19193857965451055,99.80806142034548,28.502879078694814,71.30518234165068
111F,11,1F,0,991,5,986,242,744,inf,0.5045408678102926,99.49545913218971,24.419778002018163,75.07568113017155
111G,11,1G,0,1155,0,1155,338,817,inf,0.0,100.0,29.264069264069263,70.73593073593074
111H,11,1H,0,1200,1,1199,381,818,inf,0.08333333333333334,99.91666666666667,31.75,68.16666666666666
111J,11,1J,0,1188,2,1186,405,781,inf,0.16835016835016833,99.83164983164983,34.090909090909086,65.74074074074075
111K,11,1K,0,1905,5,1900,637,1263,inf,0.26246719160104987,99.73753280839895,33.43832020997375,66.2992125984252
11101,11,101,1498,249,1,248,69,179,16.622162883845128,0.4016064257028112,99.59839357429718,27.710843373493976,71.8875502008032
11102,11,102,1155,245,0,245,57,188,21.21212121212121,0.0,100.0,23.26530612244898,76.73469387755102
11103,11,103,3338,608,1,607,168,439,18.214499700419413,0.1644736842105263,99.83552631578947,27.631578947368425,72.20394736842105
11104,11,104,3250,353,0,353,145,208,10.861538461538462,0.0,100.0,41.07648725212464,58.92351274787535
11109,11,109,3398,538,2,536,177,359,15.832842848734549,0.37174721189591076,99.62825278810409,32.899628252788105,66.72862453531599
11112,11,112,2976,457,1,456,120,336,15.356182795698924,0.2188183807439825,99.78118161925602,26.258205689277897,73.52297592997812
11115,11,115,3320,421,0,421,153,268,12.680722891566266,0.0,100.0,36.342042755344416,63.657957244655584
11116,11,116,3224,586,0,586,170,416,18.176178660049626,0.0,100.0,29.01023890784983,70.98976109215018
11121,11,121,3651,506,0,506,162,344,13.85921665297179,0.0,100.0,32.015810276679844,67.98418972332016
11124,11,124,3445,409,1,408,145,263,11.872278664731494,0.24449877750611246,99.75550122249389,35.45232273838631,64.30317848410758
11127,11,127,2652,363,2,361,126,235,13.687782805429865,0.5509641873278237,99.44903581267218,34.710743801652896,64.73829201101928
11201,11,201,1150,207,1,206,51,155,18.0,0.4830917874396135,99.51690821256038,24.637681159420293,74.8792270531401
11202,11,202,2316,420,1,419,139,280,18.134715025906736,0.2380952380952381,99.76190476190476,33.095238095238095,66.66666666666666
11204,11,204,2966,427,2,425,120,305,14.396493594066081,0.468384074941452,99.53161592505855,28.10304449648712,71.42857142857143
11207,11,207,2373,327,0,327,100,227,13.780025284450062,0.0,100.0,30.58103975535168,69.41896024464832
11209,11,209,2153,358,0,358,102,256,16.627960984672548,0.0,100.0,28.49162011173184,71.50837988826815
11211,11,211,3344,754,2,752,230,522,22.547846889952154,0.2652519893899204,99.73474801061008,30.50397877984085,69.23076923076923
11212,11,212,3446,716,0,716,226,490,20.77771329077191,0.0,100.0,31.564245810055862,68.43575418994413
11215,11,215,1859,323,0,323,108,215,17.374932759548145,0.0,100.0,33.43653250773993,66.56346749226006
11217,11,217,3053,587,0,587,175,412,19.226989846053062,0.0,100.0,29.81260647359455,70.18739352640544
11221,11,221,3401,837,3,834,213,621,24.610408703322552,0.35842293906810035,99.6415770609319,25.448028673835125,74.19354838709677
11222,11,222,2890,608,1,607,191,416,21.038062283737023,0.1644736842105263,99.83552631578947,31.414473684210524,68.42105263157895
11225,11,225,2111,442,1,441,115,326,20.937944102321175,0.22624434389140274,99.77375565610859,26.018099547511316,73.7556561085973
11228,11,228,2335,422,0,422,115,307,18.072805139186297,0.0,100.0,27.251184834123222,72.74881516587678
11301,11,301,2360,466,1,465,148,317,19.745762711864405,0.2145922746781116,99.78540772532189,31.759656652360512,68.02575107296137
11303,11,303,2346,344,1,343,140,203,14.663256606990622,0.29069767441860467,99.70930232558139,40.69767441860465,59.01162790697675
11305,11,305,2236,341,0,341,95,246,15.250447227191414,0.0,100.0,27.859237536656888,72.14076246334311
11306,11,306,2141,367,1,366,118,248,17.141522652965904,0.2724795640326975,99.72752043596729,32.15258855585831,67.57493188010899
11308,11,308,3244,566,1,565,214,351,17.447595561035758,0.17667844522968199,99.82332155477032,37.80918727915194,62.014134275618375
11311,11,311,3111,381,0,381,128,253,12.246865959498553,0.0,100.0,33.59580052493438,66.40419947506561
11315,11,315,2904,412,0,412,165,247,14.18732782369146,0.0,100.0,40.04854368932039,59.95145631067961
11318,11,318,2453,485,2,483,150,333,19.771708112515288,0.4123711340206186,99.58762886597938,30.927835051546392,68.65979381443299
11320,11,320,2536,557,1,556,192,364,21.96372239747634,0.17953321364452424,99.82046678635548,34.47037701974865,65.35008976660683
11322,11,322,2154,304,2,302,102,200,14.113277623026926,0.6578947368421052,99.3421052631579,33.55263157894737,65.78947368421053
11323,11,323,3157,607,1,606,198,408,19.22711434906557,0.16474464579901155,99.835255354201,32.61943986820428,67.21581548599671
11327,11,327,1006,73,1,72,29,43,7.256461232604374,1.36986301369863,98.63013698630137,39.726027397260275,58.9041095890411
11328,11,328,2023,342,0,342,103,239,16.90558576371725,0.0,100.0,30.116959064327485,69.88304093567251
11330,11,330,1975,372,0,372,96,276,18.835443037974684,0.0,100.0,25.806451612903224,74.19354838709677
11401,11,401,3753,702,2,700,228,472,18.705035971223023,0.2849002849002849,99.71509971509973,32.47863247863248,67.23646723646723
11405,11,405,3938,801,1,800,236,564,20.340274250888775,0.12484394506866417,99.87515605493134,29.463171036204745,70.4119850187266
11409,11,409,3767,715,0,715,258,457,18.980621183966022,0.0,100.0,36.08391608391609,63.91608391608392
11412,11,412,2924,461,2,459,140,319,15.766073871409029,0.43383947939262474,99.56616052060737,30.36876355748373,69.19739696312365
11415,11,415,3554,670,2,668,231,437,18.851997749015194,0.2985074626865672,99.70149253731343,34.47761194029851,65.22388059701493
11416,11,416,3785,645,0,645,163,482,17.040951122853368,0.0,100.0,25.271317829457363,74.72868217054264
11420,11,420,2841,503,1,502,144,358,17.705033438929956,0.19880715705765406,99.80119284294234,28.628230616302186,71.17296222664015
11424,11,424,3988,660,4,656,217,439,16.549648946840524,0.6060606060606061,99.39393939393939,32.87878787878788,66.51515151515152
11428,11,428,3378,774,0,774,250,524,22.912966252220247,0.0,100.0,32.299741602067186,67.70025839793283
11431,11,431,3921,742,0,742,172,570,18.923743942871717,0.0,100.0,23.180592991913745,76.81940700808624
11501,11,501,2645,485,1,484,141,343,18.336483931947072,0.2061855670103093,99.79381443298969,29.07216494845361,70.72164948453609
11503,11,503,1935,313,0,313,116,197,16.175710594315245,0.0,100.0,37.06070287539936,62.939297124600635
11505,11,505,3254,448,1,447,170,277,13.767670559311618,0.2232142857142857,99.77678571428571,37.94642857142857,61.83035714285714
11506,11,506,2566,411,1,410,169,241,16.01714731098987,0.24330900243309003,99.7566909975669,41.119221411192214,58.63746958637469
11508,11,508,2655,464,2,462,164,298,17.476459510357813,0.43103448275862066,99.56896551724138,35.3448275862069,64.22413793103449
11509,11,509,3495,640,1,639,215,424,18.31187410586552,0.15625,99.84375,33.59375,66.25
11510,11,510,3631,744,2,742,242,500,20.490223079041588,0.2688172043010753,99.73118279569893,32.526881720430104,67.20430107526882
11513,11,513,2418,346,2,344,113,231,14.309346567411083,0.5780346820809248,99.42196531791907,32.65895953757225,66.76300578034682
11514,11,514,2267,332,1,331,114,217,14.644905161005733,0.30120481927710846,99.69879518072288,34.33734939759036,65.36144578313254
11516,11,516,2088,296,2,294,117,177,14.17624521072797,0.6756756756756757,99.32432432432432,39.52702702702703,59.797297297297305
11521,11,521,3063,605,2,603,162,441,19.751877244531503,0.3305785123966942,99.6694214876033,26.776859504132233,72.89256198347107
11524,11,524,3326,650,1,649,175,474,19.542994588093805,0.15384615384615385,99.84615384615385,26.923076923076923,72.92307692307692
11601,11,601,3786,908,1,907,203,704,23.983095615425253,0.11013215859030838,99.8898678414097,22.356828193832598,77.5330396475771
11604,11,604,3444,681,1,680,219,461,19.77351916376307,0.14684287812041116,99.85315712187959,32.158590308370044,67.69456681350955
11605,11,605,3392,749,1,748,157,591,22.0813679245283,0.13351134846461948,99.86648865153538,20.961281708945258,78.90520694259013
11608,11,608,2144,455,3,452,108,344,21.222014925373134,0.6593406593406593,99.34065934065934,23.736263736263734,75.6043956043956
11610,11,610,2589,551,4,547,164,383,21.282348397064503,0.7259528130671506,99.27404718693285,29.764065335753177,69.50998185117967
11614,11,614,3002,634,1,633,199,434,21.11925383077948,0.15772870662460567,99.84227129337539,31.38801261829653,68.45425867507886
11617,11,617,2867,770,0,770,244,526,26.857342169515174,0.0,100.0,31.68831168831169,68.31168831168831
11620,11,620,2342,744,1,743,215,528,31.767719897523484,0.13440860215053765,99.86559139784946,28.897849462365592,70.96774193548387
11622,11,622,1921,558,0,558,141,417,29.047371160853725,0.0,100.0,25.268817204301076,74.73118279569893
11624,11,624,2924,848,4,844,216,628,29.00136798905609,0.4716981132075472,99.52830188679245,25.471698113207548,74.05660377358491
11627,11,627,1455,485,0,485,96,389,33.33333333333333,0.0,100.0,19.79381443298969,80.20618556701031
11628,11,628,2476,813,2,811,208,603,32.83521809369952,0.24600246002460024,99.7539975399754,25.584255842558424,74.16974169741697
11630,11,630,1719,606,0,606,206,400,35.25305410122164,0.0,100.0,33.993399339933994,66.006600660066
121A,12,1A,0,807,1,806,645,161,inf,0.12391573729863693,99.87608426270135,79.92565055762083,19.950433705080545
121B,12,1B,0,784,21,763,607,156,inf,2.6785714285714284,97.32142857142857,77.4234693877551,19.897959183673468
121C,12,1C,0,788,0,788,629,159,inf,0.0,100.0,79.82233502538071,20.17766497461929
121D,12,1D,0,707,1,706,551,155,inf,0.14144271570014144,99.85855728429985,77.93493635077795,21.923620933521924
121E,12,1E,0,766,0,766,634,132,inf,0.0,100.0,82.76762402088774,17.232375979112273
121F,12,1F,0,777,3,774,597,177,inf,0.3861003861003861,99.61389961389962,76.83397683397683,22.779922779922778
121G,12,1G,0,775,0,775,621,154,inf,0.0,100.0,80.12903225806451,19.870967741935484
121H,12,1H,0,769,0,769,617,152,inf,0.0,100.0,80.23407022106632,19.765929778933682
121I,12,1I,0,768,3,765,597,168,inf,0.390625,99.609375,77.734375,21.875
121K,12,1K,0,808,1,807,643,164,inf,0.12376237623762376,99.87623762376238,79.57920792079209,20.2970297029703
121L,12,1L,0,763,0,763,601,162,inf,0.0,100.0,78.76802096985584,21.231979030144167
121M,12,1M,0,761,0,761,595,166,inf,0.0,100.0,78.18659658344284,21.81340341655716
121N,12,1N,0,721,0,721,607,114,inf,0.0,100.0,84.1886269070735,15.811373092926493
121O,12,1O,0,761,0,761,582,179,inf,0.0,100.0,76.47831800262811,23.52168199737188
121P,12,1P,0,775,1,774,616,158,inf,0.12903225806451613,99.87096774193547,79.48387096774194,20.387096774193548
121Q,12,1Q,0,781,2,779,654,125,inf,0.2560819462227913,99.74391805377721,83.73879641485276,16.005121638924454
121R,12,1R,0,764,1,763,605,158,inf,0.13089005235602094,99.86910994764398,79.18848167539268,20.680628272251308
121S,12,1S,0,768,2,766,592,174,inf,0.26041666666666663,99.73958333333334,77.08333333333334,22.65625
121T,12,1T,0,759,1,758,576,182,inf,0.13175230566534915,99.86824769433466,75.8893280632411,23.978919631093547
121U,12,1U,0,835,5,830,663,167,inf,0.5988023952095809,99.40119760479041,79.40119760479043,20.0
121V,12,1V,0,768,2,766,595,171,inf,0.26041666666666663,99.73958333333334,77.47395833333334,22.265625
121W,12,1W,0,774,0,774,601,173,inf,0.0,100.0,77.6485788113695,22.35142118863049
121X,12,1X,0,765,0,765,597,168,inf,0.0,100.0,78.03921568627452,21.96078431372549
121Y,12,1Y,0,778,0,778,629,149,inf,0.0,100.0,80.8483290488432,19.151670951156813
12101,12,101,2306,691,0,691,522,169,29.96530789245447,0.0,100.0,75.54269175108539,24.457308248914618
12102,12,102,1552,430,0,430,333,97,27.706185567010312,0.0,100.0,77.44186046511628,22.55813953488372
12106,12,106,1991,456,1,455,333,122,22.903063787041688,0.21929824561403508,99.78070175438597,73.02631578947368,26.75438596491228
12107,12,107,1221,429,0,429,296,133,35.13513513513514,0.0,100.0,68.997668997669,31.002331002331
12108,12,108,2211,583,1,582,446,136,26.368159203980102,0.17152658662092624,99.82847341337907,76.5008576329331,23.32761578044597
12109,12,109,608,143,1,142,110,32,23.519736842105264,0.6993006993006993,99.3006993006993,76.92307692307693,22.377622377622377
12110,12,110,509,132,0,132,108,24,25.93320235756385,0.0,100.0,81.81818181818183,18.181818181818183
12111,12,111,1751,448,0,448,336,112,25.585379782981153,0.0,100.0,75.0,25.0
12114,12,114,3107,918,1,917,705,212,29.546186031541684,0.10893246187363835,99.89106753812636,76.79738562091504,23.093681917211327
12117,12,117,936,300,0,300,229,71,32.05128205128205,0.0,100.0,76.33333333333333,23.666666666666668
12119,12,119,1523,358,1,357,258,99,23.50623768877216,0.27932960893854747,99.72067039106145,72.06703910614524,27.6536312849162
12120,12,120,1516,414,2,412,314,98,27.308707124010557,0.4830917874396135,99.51690821256038,75.84541062801932,23.67149758454106
12122,12,122,1254,353,1,352,261,91,28.149920255183414,0.28328611898017,99.71671388101983,73.93767705382436,25.77903682719547
12124,12,124,2532,615,2,613,450,163,24.28909952606635,0.3252032520325203,99.67479674796748,73.17073170731707,26.504065040650403
12129,12,129,2438,555,1,554,434,120,22.76456111566858,0.18018018018018017,99.81981981981983,78.1981981981982,21.62162162162162
12133,12,133,2080,508,1,507,395,112,24.423076923076923,0.19685039370078738,99.80314960629921,77.75590551181102,22.04724409448819
12135,12,135,2395,555,1,554,428,126,23.173277661795407,0.18018018018018017,99.81981981981983,77.11711711711712,22.702702702702705
12201,12,201,1706,557,0,557,443,114,32.64947245017585,0.0,100.0,79.53321364452424,20.46678635547576
12203,12,203,1911,564,2,562,424,138,29.513343799058084,0.3546099290780142,99.64539007092199,75.177304964539,24.46808510638298
12205,12,205,2974,1089,1,1088,770,318,36.61735036987223,0.09182736455463728,99.90817263544535,70.70707070707071,29.201101928374655
12209,12,209,830,221,0,221,155,66,26.626506024096386,0.0,100.0,70.13574660633483,29.86425339366516
12210,12,210,2841,728,1,727,562,165,25.624780007039778,0.13736263736263737,99.86263736263736,77.1978021978022,22.664835164835164
12212,12,212,1609,459,2,457,361,96,28.52703542573027,0.4357298474945534,99.56427015250546,78.64923747276688,20.915032679738562
12213,12,213,1706,536,2,534,420,114,31.41852286049238,0.3731343283582089,99.6268656716418,78.35820895522389,21.26865671641791
12214,12,214,2550,747,0,747,584,163,29.294117647058826,0.0,100.0,78.17938420348058,21.82061579651941
12215,12,215,2302,730,1,729,551,178,31.7115551694179,0.136986301369863,99.86301369863013,75.47945205479452,24.383561643835616
12222,12,222,1783,509,2,507,411,96,28.54739203589456,0.3929273084479371,99.60707269155206,80.74656188605108,18.860510805500983
12224,12,224,2813,768,2,766,594,172,27.301813011020265,0.26041666666666663,99.73958333333334,77.34375,22.395833333333336
12227,12,227,1687,474,0,474,367,107,28.09721398933017,0.0,100.0,77.42616033755274,22.573839662447256
12228,12,228,1549,360,0,360,260,100,23.240800516462233,0.0,100.0,72.22222222222221,27.77777777777778
12229,12,229,760,150,0,150,119,31,19.736842105263158,0.0,100.0,79.33333333333333,20.666666666666668
12233,12,233,1212,281,0,281,206,75,23.184818481848186,0.0,100.0,73.30960854092527,26.690391459074732
12234,12,234,607,174,0,174,128,46,28.665568369028005,0.0,100.0,73.5632183908046,26.436781609195403
12236,12,236,584,263,1,262,179,83,45.034246575342465,0.38022813688212925,99.61977186311786,68.06083650190115,31.55893536121673
12237,12,237,413,107,1,106,91,15,25.907990314769975,0.9345794392523363,99.06542056074767,85.04672897196261,14.018691588785046
12239,12,239,320,111,0,111,77,34,34.6875,0.0,100.0,69.36936936936937,30.630630630630627
12301,12,301,2165,918,1,917,705,212,42.40184757505774,0.10893246187363835,99.89106753812636,76.79738562091504,23.093681917211327
12303,12,303,2073,824,2,822,629,193,39.749155812831646,0.24271844660194172,99.75728155339806,76.33495145631069,23.42233009708738
12305,12,305,679,285,0,285,216,69,41.973490427098675,0.0,100.0,75.78947368421053,24.210526315789473
12306,12,306,2918,1225,1,1224,882,342,41.98080877313228,0.0816326530612245,99.91836734693878,72.0,27.918367346938776
12310,12,310,1825,691,2,689,493,196,37.86301369863014,0.2894356005788712,99.71056439942113,71.34587554269174,28.364688856729376
12311,12,311,1336,565,0,565,427,138,42.290419161676645,0.0,100.0,75.57522123893806,24.424778761061948
12313,12,313,1068,431,3,428,327,101,40.355805243445694,0.6960556844547563,99.30394431554525,75.87006960556845,23.4338747099768
12314,12,314,1922,805,2,803,602,201,41.8834547346514,0.2484472049689441,99.75155279503105,74.78260869565217,24.96894409937888
12316,12,316,843,357,0,357,283,74,42.34875444839858,0.0,100.0,79.27170868347339,20.72829131652661
12318,12,318,2137,903,0,903,672,231,42.25549836218999,0.0,100.0,74.4186046511628,25.581395348837212
12320,12,320,1876,693,3,690,479,211,36.940298507462686,0.4329004329004329,99.56709956709958,69.11976911976912,30.447330447330444
12322,12,322,2701,1109,2,1107,805,302,41.05886708626434,0.18034265103697023,99.81965734896303,72.58791704238052,27.23174030658251
12324,12,324,2342,790,2,788,571,217,33.73185311699402,0.25316455696202533,99.74683544303798,72.27848101265822,27.468354430379748
12328,12,328,928,295,1,294,225,69,31.788793103448278,0.3389830508474576,99.66101694915255,76.27118644067797,23.389830508474578
12329,12,329,2869,842,2,840,644,196,29.348204949459745,0.23752969121140144,99.7624703087886,76.48456057007125,23.27790973871734
12330,12,330,1653,466,0,466,394,72,28.191167574107684,0.0,100.0,84.54935622317596,15.450643776824036
12332,12,332,1024,330,0,330,266,64,32.2265625,0.0,100.0,80.60606060606061,19.393939393939394
12337,12,337,243,95,0,95,45,50,39.09465020576132,0.0,100.0,47.368421052631575,52.63157894736842
12401,12,401,2272,782,0,782,574,208,34.41901408450704,0.0,100.0,73.40153452685422,26.598465473145783
12402,12,402,2561,753,4,749,619,130,29.40257711831316,0.5312084993359893,99.46879150066401,82.20451527224436,17.264276228419657
12406,12,406,1821,555,1,554,428,126,30.477759472817134,0.18018018018018017,99.81981981981983,77.11711711711712,22.702702702702705
12408,12,408,942,325,0,325,222,103,34.50106157112526,0.0,100.0,68.3076923076923,31.692307692307693
12409,12,409,970,360,0,360,237,123,37.11340206185567,0.0,100.0,65.83333333333333,34.166666666666664
12410,12,410,695,231,0,231,191,40,33.23741007194245,0.0,100.0,82.68398268398268,17.316017316017316
12411,12,411,1975,790,2,788,654,134,40.0,0.25316455696202533,99.74683544303798,82.78481012658227,16.962025316455694
12413,12,413,1202,510,0,510,369,141,42.42928452579035,0.0,100.0,72.35294117647058,27.647058823529413
12414,12,414,1731,702,1,701,493,208,40.55459272097054,0.14245014245014245,99.85754985754986,70.22792022792022,29.629629629629626
12415,12,415,1423,397,0,397,310,87,27.898805340829234,0.0,100.0,78.08564231738035,21.91435768261965
12416,12,416,2698,872,2,870,678,192,32.320237212750186,0.22935779816513763,99.77064220183486,77.75229357798165,22.018348623853214
12417,12,417,1814,601,2,599,434,165,33.13120176405733,0.33277870216306155,99.66722129783693,72.21297836938436,27.454242928452576
12420,12,420,1041,346,0,346,254,92,33.23727185398655,0.0,100.0,73.41040462427746,26.589595375722542
12424,12,424,2320,726,0,726,533,193,31.29310344827586,0.0,100.0,73.4159779614325,26.584022038567497
12425,12,425,2390,744,2,742,581,161,31.12970711297071,0.2688172043010753,99.73118279569893,78.09139784946237,21.63978494623656
12428,12,428,2938,952,3,949,739,210,32.40299523485364,0.31512605042016806,99.68487394957984,77.62605042016807,22.058823529411764
12433,12,433,791,318,0,318,237,81,40.202275600505686,0.0,100.0,74.52830188679245,25.471698113207548
12434,12,434,1821,664,0,664,494,170,36.46348160351455,0.0,100.0,74.3975903614458,25.602409638554217
12438,12,438,2276,724,0,724,547,177,31.810193321616868,0.0,100.0,75.5524861878453,24.447513812154696
12440,12,440,733,249,0,249,193,56,33.969986357435204,0.0,100.0,77.51004016064257,22.48995983935743
12501,12,501,1800,797,0,797,585,212,44.27777777777778,0.0,100.0,73.40025094102886,26.59974905897114
12502,12,502,1262,519,0,519,425,94,41.12519809825674,0.0,100.0,81.88824662813103,18.11175337186898
12503,12,503,919,315,0,315,269,46,34.276387377584335,0.0,100.0,85.39682539682539,14.603174603174605
12505,12,505,2515,712,0,712,611,101,28.31013916500994,0.0,100.0,85.81460674157303,14.185393258426968
12506,12,506,1859,583,0,583,476,107,31.360946745562128,0.0,100.0,81.6466552315609,18.353344768439108
12507,12,507,2198,644,0,644,547,97,29.29936305732484,0.0,100.0,84.93788819875776,15.062111801242237
12509,12,509,1680,446,0,446,380,66,26.547619047619047,0.0,100.0,85.20179372197309,14.798206278026907
12514,12,514,1649,490,1,489,406,83,29.71497877501516,0.20408163265306123,99.79591836734694,82.85714285714286,16.93877551020408
12517,12,517,2414,639,2,637,537,100,26.47058823529412,0.3129890453834116,99.68701095461658,84.03755868544602,15.64945226917058
12518,12,518,2227,524,2,522,430,92,23.52941176470588,0.38167938931297707,99.61832061068702,82.06106870229007,17.557251908396946
12521,12,521,1788,457,2,455,401,54,25.559284116331092,0.437636761487965,99.56236323851203,87.74617067833698,11.816192560175056
12525,12,525,795,224,0,224,187,37,28.17610062893082,0.0,100.0,83.48214285714286,16.517857142857142
12526,12,526,1758,486,0,486,411,75,27.64505119453925,0.0,100.0,84.5679012345679,15.432098765432098
12527,12,527,1407,392,0,392,314,78,27.860696517412936,0.0,100.0,80.10204081632652,19.897959183673468
12529,12,529,3227,1096,0,1096,902,194,33.96343352959405,0.0,100.0,82.2992700729927,17.7007299270073
12533,12,533,880,237,1,236,198,38,26.931818181818183,0.42194092827004215,99.57805907172997,83.54430379746836,16.033755274261605
12601,12,601,291,119,1,118,87,31,40.893470790378004,0.8403361344537815,99.15966386554622,73.10924369747899,26.05042016806723
12602,12,602,2132,958,1,957,693,264,44.9343339587242,0.10438413361169101,99.89561586638831,72.33820459290187,27.55741127348643
12603,12,603,1648,681,1,680,528,152,41.32281553398058,0.14684287812041116,99.85315712187959,77.5330396475771,22.3201174743025
12604,12,604,2038,919,1,918,708,210,45.09322865554466,0.1088139281828074,99.8911860718172,77.04026115342764,22.850924918389552
12608,12,608,2696,1054,0,1054,834,220,39.09495548961424,0.0,100.0,79.12713472485768,20.872865275142317
12609,12,609,1572,655,1,654,511,143,41.66666666666667,0.15267175572519084,99.84732824427482,78.01526717557252,21.83206106870229
12611,12,611,2226,972,0,972,730,242,43.66576819407008,0.0,100.0,75.1028806584362,24.897119341563787
12614,12,614,2524,803,0,803,590,213,31.814580031695723,0.0,100.0,73.47447073474471,26.525529265255294
12617,12,617,2643,1082,1,1081,811,270,40.938327657964436,0.09242144177449169,99.90757855822551,74.95378927911275,24.953789279112755
12619,12,619,1443,597,0,597,456,141,41.37214137214137,0.0,100.0,76.38190954773869,23.618090452261306
12621,12,621,667,268,4,264,204,60,40.17991004497751,1.4925373134328357,98.50746268656717,76.11940298507463,22.388059701492537
12623,12,623,2652,1092,2,1090,822,268,41.17647058823529,0.18315018315018314,99.81684981684981,75.27472527472527,24.54212454212454
12625,12,625,2250,925,1,924,674,250,41.11111111111111,0.10810810810810811,99.89189189189189,72.86486486486487,27.027027027027028
12628,12,628,1913,833,3,830,585,245,43.544171458442236,0.36014405762304924,99.63985594237695,70.22809123649459,29.411764705882355
12632,12,632,1421,653,4,649,496,153,45.953553835327234,0.6125574272588056,99.3874425727412,75.95712098009189,23.43032159264931
12633,12,633,970,422,1,421,308,113,43.50515463917526,0.23696682464454977,99.76303317535546,72.98578199052133,26.77725118483412
