vote_type,address,district_id,district_name,electoral_district_id,electoral_district_type,postal_voting_district_id,electoral_district_berlin_election_id,electoral_district_federal_election_id,berlin_east_west,eligible_voters,eligible_voters_a1,eligible_voters_a2,eligible_voters_a3,voters,voters_b1,invalid_votes,valid_votes,vote_yes,vote_no,aufn
Stimme,01W100,1,Mitte,100,W,011A,1,75,W,1651,1257,394,0,231,8,0,231,150,81,nan
Stimme,01W101,1,Mitte,101,W,011B,1,75,O,1966,1429,537,0,334,10,1,333,225,108,nan
Stimme,01W102,1,Mitte,102,W,011B,1,75,O,1242,952,290,0,199,3,2,197,128,69,nan
Stimme,01W103,1,Mitte,103,W,011C,1,75,O,0,0,0,0,0,0,0,0,0,0,01W101
Stimme,01W104,1,Mitte,104,W,011D,1,75,O,1246,937,309,0,279,9,1,278,191,87,nan
Stimme,01W105,1,Mitte,105,W,011D,1,75,O,2022,1520,502,0,436,12,0,436,329,107,nan
Stimme,01W106,1,Mitte,106,W,011E,1,75,O,1437,1051,386,0,288,12,0,288,185,103,nan
Stimme,01W107,1,Mitte,107,W,011F,1,75,O,2151,1630,521,0,373,11,4,369,255,114,nan
Stimme,01W108,1,Mitte,108,W,011E,1,75,O,0,0,0,0,0,0,0,0,0,0,01W107
Stimme,01W109,1,Mitte,109,W,011G,1,75,W,1079,887,192,0,142,2,1,141,73,68,nan
Stimme,01W110,1,Mitte,110,W,011G,1,75,W,1243,911,332,0,324,15,3,321,241,80,nan
Stimme,01W111,1,Mitte,111,W,011H,1,75,O,0,0,0,0,0,0,0,0,0,0,01W105
Stimme,01W112,1,Mitte,112,W,011F,1,75,O,1159,903,256,0,287,10,0,287,214,73,nan
Stimme,01W113,1,Mitte,113,W,011I,1,75,O,1443,1128,315,0,400,21,0,400,293,107,nan
Stimme,01W114,1,Mitte,114,W,011H,1,75,O,1425,1138,287,0,339,5,1,338,271,67,nan
Stimme,01W115,1,Mitte,115,W,011J,1,75,O,1560,1261,299,0,342,8,1,341,218,123,nan
Stimme,01W116,1,Mitte,116,W,011J,1,75,O,0,0,0,0,0,0,0,0,0,0,01W115
Stimme,01W117,1,Mitte,117,W,011I,1,75,O,1324,1011,313,0,362,14,2,360,293,67,nan
Stimme,01W118,1,Mitte,118,W,011K,1,75,O,1353,998,355,0,337,15,2,335,263,72,nan
Stimme,01W119,1,Mitte,119,W,011L,1,75,O,1913,1464,449,0,454,7,1,453,334,119,nan
Stimme,01W120,1,Mitte,120,W,011K,1,75,O,1011,796,215,0,250,8,0,250,187,63,nan
Stimme,01W121,1,Mitte,121,W,011L,1,75,O,0,0,0,0,0,0,0,0,0,0,01W119
Stimme,01W122,1,Mitte,122,W,011M,1,75,O,2027,1578,449,0,466,11,0,466,344,122,nan
Stimme,01W123,1,Mitte,123,W,011M,1,75,O,0,0,0,0,0,0,0,0,0,0,01W122
Stimme,01W124,1,Mitte,124,W,011A,1,75,W,1267,1043,224,0,194,2,0,194,118,76,nan
Stimme,01W125,1,Mitte,125,W,011C,1,75,O,1463,1113,350,0,257,9,2,255,181,74,nan
Stimme,01W200,1,Mitte,200,W,012A,2,75,O,2052,1635,417,0,359,7,2,357,143,214,nan
Stimme,01W201,1,Mitte,201,W,012A,2,75,O,0,0,0,0,0,0,0,0,0,0,01W200
Stimme,01W202,1,Mitte,202,W,012B,2,75,O,1129,892,237,0,192,5,1,191,85,106,nan
Stimme,01W203,1,Mitte,203,W,012B,2,75,O,1543,1223,320,0,195,2,2,193,92,101,nan
Stimme,01W204,1,Mitte,204,W,012C,2,75,O,1546,1150,396,0,224,3,0,224,109,115,nan
Stimme,01W205,1,Mitte,205,W,012C,2,75,O,2010,1659,351,0,356,5,2,354,202,152,nan
Stimme,01W206,1,Mitte,206,W,012D,2,75,O,1294,1074,220,0,203,1,1,202,108,94,nan
Stimme,01W207,1,Mitte,207,W,012D,2,75,O,1967,1570,397,0,368,11,1,367,249,118,nan
Stimme,01W208,1,Mitte,208,W,012E,2,75,O,0,0,0,0,0,0,0,0,0,0,01W207
Stimme,01W209,1,Mitte,209,W,012E,2,75,O,1152,914,238,0,275,15,0,275,212,63,nan
Stimme,01W210,1,Mitte,210,W,012F,2,75,O,1982,1581,401,0,410,10,5,405,312,93,nan
Stimme,01W211,1,Mitte,211,W,012F,2,75,O,0,0,0,0,0,0,0,0,0,0,01W210
Stimme,01W212,1,Mitte,212,W,012G,2,75,O,1457,1173,284,0,298,9,0,298,202,96,nan
Stimme,01W213,1,Mitte,213,W,012G,2,75,O,0,0,0,0,0,0,0,0,0,0,01W212
Stimme,01W214,1,Mitte,214,W,012G,2,75,O,815,682,133,0,96,3,0,96,55,41,nan
Stimme,01W215,1,Mitte,215,W,012H,2,75,O,1843,1468,375,0,382,2,0,382,169,213,nan
Stimme,01W216,1,Mitte,216,W,012H,2,75,O,0,0,0,0,0,0,0,0,0,0,01W215
Stimme,01W217,1,Mitte,217,W,012I,2,75,O,1750,1503,247,0,266,3,0,266,130,136,nan
Stimme,01W218,1,Mitte,218,W,012I,2,75,O,936,790,146,0,173,8,0,173,75,98,nan
Stimme,01W219,1,Mitte,219,W,012I,2,75,O,0,0,0,0,0,0,0,0,0,0,01W217
Stimme,01W220,1,Mitte,220,W,012J,2,75,O,1798,1422,376,0,260,4,0,260,145,115,nan
Stimme,01W221,1,Mitte,221,W,012K,2,75,O,1432,1107,325,0,265,5,1,264,152,112,nan
Stimme,01W222,1,Mitte,222,W,012K,2,75,O,0,0,0,0,0,0,0,0,0,0,01W205
Stimme,01W223,1,Mitte,223,W,012L,2,75,O,1542,1147,395,0,313,5,1,312,200,112,nan
Stimme,01W224,1,Mitte,224,W,012M,2,75,O,1280,1036,244,0,213,3,0,213,110,103,nan
Stimme,01W225,1,Mitte,225,W,012M,2,75,O,1323,1013,310,0,226,5,0,226,119,107,nan
Stimme,01W226,1,Mitte,226,W,012J,2,75,O,0,0,0,0,0,0,0,0,0,0,01W220
Stimme,01W227,1,Mitte,227,W,012N,2,75,O,1487,1119,368,0,329,8,1,328,227,101,nan
Stimme,01W228,1,Mitte,228,W,012L,2,75,O,1194,914,280,0,211,2,0,211,112,99,nan
Stimme,01W229,1,Mitte,229,W,012N,2,75,O,1053,775,278,0,222,6,0,222,150,72,nan
Stimme,01W300,1,Mitte,300,W,013A,3,75,W,2144,1747,397,0,385,9,4,381,289,92,nan
Stimme,01W301,1,Mitte,301,W,013A,3,75,W,0,0,0,0,0,0,0,0,0,0,01W300
Stimme,01W302,1,Mitte,302,W,013B,3,75,W,2005,1691,314,0,343,3,2,341,218,123,nan
Stimme,01W303,1,Mitte,303,W,013B,3,75,W,0,0,0,0,0,0,0,0,0,0,01W302
Stimme,01W304,1,Mitte,304,W,013B,3,75,W,873,729,144,0,241,5,1,240,158,82,nan
Stimme,01W305,1,Mitte,305,W,013C,3,75,W,2172,1655,517,0,447,11,2,445,279,166,nan
Stimme,01W306,1,Mitte,306,W,013D,3,75,W,1322,1005,317,0,334,2,1,333,255,78,nan
Stimme,01W307,1,Mitte,307,W,013C,3,75,W,0,0,0,0,0,0,0,0,0,0,01W305
Stimme,01W308,1,Mitte,308,W,013D,3,75,W,1116,865,251,0,276,5,0,276,204,72,nan
Stimme,01W309,1,Mitte,309,W,013E,3,75,W,2183,1686,497,0,554,13,0,554,385,169,nan
Stimme,01W310,1,Mitte,310,W,013E,3,75,W,0,0,0,0,0,0,0,0,0,0,01W309
Stimme,01W311,1,Mitte,311,W,013F,3,75,W,1772,1355,417,0,380,7,6,374,279,95,nan
Stimme,01W312,1,Mitte,312,W,013F,3,75,W,0,0,0,0,0,0,0,0,0,0,01W311
Stimme,01W313,1,Mitte,313,W,013F,3,75,W,825,638,187,0,160,2,1,159,105,54,nan
Stimme,01W314,1,Mitte,314,W,013G,3,75,W,1853,1533,320,0,381,7,3,378,238,140,nan
Stimme,01W315,1,Mitte,315,W,013G,3,75,W,0,0,0,0,0,0,0,0,0,0,01W314
Stimme,01W316,1,Mitte,316,W,013H,3,75,W,1310,1140,170,0,178,1,0,178,71,107,nan
Stimme,01W317,1,Mitte,317,W,013I,3,75,W,1973,1564,409,0,429,18,3,426,274,152,nan
Stimme,01W318,1,Mitte,318,W,013I,3,75,W,0,0,0,0,0,0,0,0,0,0,01W317
Stimme,01W319,1,Mitte,319,W,013I,3,75,W,1535,1225,310,0,431,6,2,429,282,147,nan
Stimme,01W320,1,Mitte,320,W,013J,3,75,W,0,0,0,0,0,0,0,0,0,0,01W319
Stimme,01W321,1,Mitte,321,W,013J,3,75,W,2148,1752,396,0,308,6,0,308,146,162,nan
Stimme,01W322,1,Mitte,322,W,013J,3,75,W,0,0,0,0,0,0,0,0,0,0,01W321
Stimme,01W323,1,Mitte,323,W,013H,3,75,W,1136,906,230,0,257,3,1,256,120,136,nan
Stimme,01W324,1,Mitte,324,W,013K,3,75,W,1494,1172,322,0,180,3,2,178,84,94,nan
Stimme,01W325,1,Mitte,325,W,013L,3,75,W,1022,877,145,0,180,3,2,178,110,68,nan
Stimme,01W326,1,Mitte,326,W,013L,3,75,W,1501,1232,269,0,303,3,3,300,205,95,nan
Stimme,01W327,1,Mitte,327,W,013K,3,75,W,1517,1226,291,0,306,6,0,306,221,85,nan
Stimme,01W400,1,Mitte,400,W,014A,4,75,W,2110,1735,375,0,404,4,0,404,311,93,nan
Stimme,01W401,1,Mitte,401,W,014A,4,75,W,0,0,0,0,0,0,0,0,0,0,01W400
Stimme,01W402,1,Mitte,402,W,014B,4,75,W,2200,1879,321,0,412,11,0,412,316,96,nan
Stimme,01W403,1,Mitte,403,W,014C,4,75,W,1642,1323,319,0,323,9,0,323,244,79,nan
Stimme,01W404,1,Mitte,404,W,014C,4,75,W,0,0,0,0,0,0,0,0,0,0,01W403
Stimme,01W405,1,Mitte,405,W,014B,4,75,W,0,0,0,0,0,0,0,0,0,0,01W402
Stimme,01W406,1,Mitte,406,W,014D,4,75,W,1952,1571,381,0,379,7,0,379,291,88,nan
Stimme,01W407,1,Mitte,407,W,014D,4,75,W,0,0,0,0,0,0,0,0,0,0,01W406
Stimme,01W408,1,Mitte,408,W,014E,4,75,W,963,782,181,0,254,2,1,253,200,53,nan
Stimme,01W409,1,Mitte,409,W,014C,4,75,W,951,775,176,0,224,4,1,223,157,66,nan
Stimme,01W410,1,Mitte,410,W,014E,4,75,W,1265,984,281,0,286,4,0,286,230,56,nan
Stimme,01W411,1,Mitte,411,W,014F,4,75,W,1094,894,200,0,205,4,0,205,149,56,nan
Stimme,01W412,1,Mitte,412,W,014F,4,75,W,1654,1361,293,0,375,8,1,374,267,107,nan
Stimme,01W413,1,Mitte,413,W,014F,4,75,W,0,0,0,0,0,0,0,0,0,0,01W412
Stimme,01W414,1,Mitte,414,W,014G,4,75,W,1801,1468,333,0,414,8,3,411,324,87,nan
Stimme,01W415,1,Mitte,415,W,014H,4,75,W,1820,1538,282,0,409,8,1,408,304,104,nan
Stimme,01W416,1,Mitte,416,W,014I,4,75,W,0,0,0,0,0,0,0,0,0,0,01W415
Stimme,01W417,1,Mitte,417,W,014I,4,75,W,1115,905,210,0,195,2,0,195,140,55,nan
Stimme,01W418,1,Mitte,418,W,014J,4,75,W,1137,947,190,0,195,6,1,194,136,58,nan
Stimme,01W419,1,Mitte,419,W,014H,4,75,W,1237,987,250,0,295,4,4,291,233,58,nan
Stimme,01W420,1,Mitte,420,W,014K,4,75,W,1667,1367,300,0,334,2,1,333,220,113,nan
Stimme,01W421,1,Mitte,421,W,014K,4,75,W,0,0,0,0,0,0,0,0,0,0,01W420
Stimme,01W422,1,Mitte,422,W,014G,4,75,W,0,0,0,0,0,0,0,0,0,0,01W414
Stimme,01W423,1,Mitte,423,W,014J,4,75,W,928,820,108,0,173,7,1,172,97,75,nan
Stimme,01W424,1,Mitte,424,W,014L,4,75,W,1207,978,229,0,243,3,2,241,170,71,nan
Stimme,01W425,1,Mitte,425,W,014M,4,75,W,1268,1027,241,0,299,8,1,298,225,73,nan
Stimme,01W426,1,Mitte,426,W,014M,4,75,W,1205,930,275,0,234,2,0,234,190,44,nan
Stimme,01W427,1,Mitte,427,W,014L,4,75,W,1694,1377,317,0,360,3,3,357,290,67,nan
Stimme,01W428,1,Mitte,428,W,014L,4,75,W,0,0,0,0,0,0,0,0,0,0,01W427
Stimme,01W500,1,Mitte,500,W,015A,5,75,W,1721,1395,326,0,262,5,1,261,109,152,nan
Stimme,01W501,1,Mitte,501,W,015A,5,75,W,0,0,0,0,0,0,0,0,0,0,01W500
Stimme,01W502,1,Mitte,502,W,015A,5,75,W,1341,1165,176,0,227,4,1,226,119,107,nan
Stimme,01W503,1,Mitte,503,W,015B,5,75,W,1607,1404,203,0,220,2,0,220,75,145,nan
Stimme,01W504,1,Mitte,504,W,015B,5,75,W,0,0,0,0,0,0,0,0,0,0,01W503
Stimme,01W505,1,Mitte,505,W,015B,5,75,W,0,0,0,0,0,0,0,0,0,0,01W502
Stimme,01W506,1,Mitte,506,W,015C,5,75,W,951,824,127,0,180,1,1,179,62,117,nan
Stimme,01W507,1,Mitte,507,W,015C,5,75,W,1341,1070,271,0,211,1,1,210,104,106,nan
Stimme,01W508,1,Mitte,508,W,015D,5,75,W,1127,920,207,0,261,7,2,259,122,137,nan
Stimme,01W509,1,Mitte,509,W,015D,5,75,W,1099,966,133,0,173,3,0,173,81,92,nan
Stimme,01W510,1,Mitte,510,W,015E,5,75,W,989,881,108,0,121,4,0,121,50,71,nan
Stimme,01W511,1,Mitte,511,W,015F,5,75,W,1050,928,122,0,138,2,0,138,44,94,nan
Stimme,01W512,1,Mitte,512,W,015G,5,75,W,2073,1835,238,0,194,3,1,193,110,83,nan
Stimme,01W513,1,Mitte,513,W,015H,5,75,W,1285,1089,196,0,277,6,2,275,204,71,nan
Stimme,01W514,1,Mitte,514,W,015H,5,75,W,1882,1565,317,0,318,5,0,318,206,112,nan
Stimme,01W515,1,Mitte,515,W,015I,5,75,W,1228,1058,170,0,212,2,2,210,129,81,nan
Stimme,01W516,1,Mitte,516,W,015I,5,75,W,0,0,0,0,0,0,0,0,0,0,01W514
Stimme,01W517,1,Mitte,517,W,015E,5,75,W,1271,1052,219,0,222,2,0,222,144,78,nan
Stimme,01W518,1,Mitte,518,W,015J,5,75,W,1256,1073,183,0,175,5,2,173,146,27,nan
Stimme,01W519,1,Mitte,519,W,015J,5,75,W,1364,1113,251,0,290,7,2,288,225,63,nan
Stimme,01W520,1,Mitte,520,W,015F,5,75,W,1322,1023,299,0,263,6,0,263,220,43,nan
Stimme,01W521,1,Mitte,521,W,015G,5,75,W,0,0,0,0,0,0,0,0,0,0,01W512
Stimme,01W522,1,Mitte,522,W,015K,5,75,W,1492,1171,321,0,267,4,1,266,144,122,nan
Stimme,01W523,1,Mitte,523,W,015K,5,75,W,0,0,0,0,0,0,0,0,0,0,01W522
Stimme,01W524,1,Mitte,524,W,015K,5,75,W,1627,1296,331,0,301,7,1,300,227,73,nan
Stimme,01W525,1,Mitte,525,W,015L,5,75,W,0,0,0,0,0,0,0,0,0,0,01W524
Stimme,01W526,1,Mitte,526,W,015L,5,75,W,1410,1038,372,0,262,1,0,262,214,48,nan
Stimme,01W600,1,Mitte,600,W,016A,6,75,W,1323,1101,222,0,204,6,0,204,157,47,nan
Stimme,01W601,1,Mitte,601,W,016B,6,75,W,1911,1599,312,0,417,6,1,416,269,147,nan
Stimme,01W602,1,Mitte,602,W,016B,6,75,W,0,0,0,0,0,0,0,0,0,0,01W601
Stimme,01W603,1,Mitte,603,W,016A,6,75,W,1681,1467,214,0,247,9,0,247,193,54,nan
Stimme,01W604,1,Mitte,604,W,016C,6,75,W,0,0,0,0,0,0,0,0,0,0,01W603
Stimme,01W605,1,Mitte,605,W,016D,6,75,W,1770,1520,250,0,266,10,3,263,180,83,nan
Stimme,01W606,1,Mitte,606,W,016D,6,75,W,0,0,0,0,0,0,0,0,0,0,01W605
Stimme,01W607,1,Mitte,607,W,016E,6,75,W,1780,1503,277,0,228,0,0,228,195,33,nan
Stimme,01W608,1,Mitte,608,W,016C,6,75,W,999,861,138,0,158,1,1,157,133,24,nan
Stimme,01W609,1,Mitte,609,W,016F,6,75,W,1120,932,188,0,170,6,1,169,135,34,nan
Stimme,01W610,1,Mitte,610,W,016F,6,75,W,1149,959,190,0,153,4,0,153,115,38,nan
Stimme,01W611,1,Mitte,611,W,016G,6,75,W,1295,1088,207,0,199,4,0,199,150,49,nan
Stimme,01W612,1,Mitte,612,W,016E,6,75,W,0,0,0,0,0,0,0,0,0,0,01W607
Stimme,01W613,1,Mitte,613,W,016H,6,75,W,1352,1110,242,0,239,9,1,238,193,45,nan
Stimme,01W614,1,Mitte,614,W,016H,6,75,W,1145,937,208,0,252,11,2,250,142,108,nan
Stimme,01W615,1,Mitte,615,W,016G,6,75,W,881,755,126,0,100,2,0,100,82,18,nan
Stimme,01W616,1,Mitte,616,W,016I,6,75,W,1953,1594,359,0,352,5,1,351,296,55,nan
Stimme,01W617,1,Mitte,617,W,016I,6,75,W,0,0,0,0,0,0,0,0,0,0,01W616
Stimme,01W618,1,Mitte,618,W,016J,6,75,W,1438,1254,184,0,295,0,1,294,225,69,nan
Stimme,01W619,1,Mitte,619,W,016J,6,75,W,1127,939,188,0,218,3,2,216,150,66,nan
Stimme,01W620,1,Mitte,620,W,016K,6,75,W,1022,834,188,0,145,1,0,145,114,31,nan
Stimme,01W621,1,Mitte,621,W,016K,6,75,W,972,841,131,0,111,0,0,111,100,11,nan
Stimme,01W622,1,Mitte,622,W,016L,6,75,W,1543,1260,283,0,217,8,0,217,168,49,nan
Stimme,01W623,1,Mitte,623,W,016L,6,75,W,0,0,0,0,0,0,0,0,0,0,01W622
Stimme,01W624,1,Mitte,624,W,016M,6,75,W,1233,1060,173,0,152,3,3,149,108,41,nan
Stimme,01W625,1,Mitte,625,W,016M,6,75,W,972,841,131,0,140,3,0,140,103,37,nan
Stimme,01W700,1,Mitte,700,W,017A,7,75,W,2068,1683,385,0,371,8,0,371,293,78,nan
Stimme,01W701,1,Mitte,701,W,017A,7,75,W,0,0,0,0,0,0,0,0,0,0,01W700
Stimme,01W702,1,Mitte,702,W,017B,7,75,W,1029,859,170,0,178,2,0,178,133,45,nan
Stimme,01W703,1,Mitte,703,W,017B,7,75,W,1056,875,181,0,195,6,0,195,131,64,nan
Stimme,01W704,1,Mitte,704,W,017C,7,75,W,1717,1345,372,0,355,15,3,352,294,58,nan
Stimme,01W705,1,Mitte,705,W,017C,7,75,W,0,0,0,0,0,0,0,0,0,0,01W704
Stimme,01W706,1,Mitte,706,W,017D,7,75,W,1168,908,260,0,268,8,1,267,219,48,nan
Stimme,01W707,1,Mitte,707,W,017D,7,75,W,1160,930,230,0,266,6,0,266,205,61,nan
Stimme,01W708,1,Mitte,708,W,017E,7,75,W,1053,894,159,0,202,5,1,201,155,46,nan
Stimme,01W709,1,Mitte,709,W,017E,7,75,W,1148,956,192,0,229,6,2,227,181,46,nan
Stimme,01W710,1,Mitte,710,W,017F,7,75,W,1292,1095,197,0,220,5,1,219,158,61,nan
Stimme,01W711,1,Mitte,711,W,017F,7,75,W,1170,936,234,0,192,10,1,191,156,35,nan
Stimme,01W712,1,Mitte,712,W,017G,7,75,W,1389,1162,227,0,216,6,0,216,158,58,nan
Stimme,01W713,1,Mitte,713,W,017G,7,75,W,1948,1657,291,0,287,6,1,286,189,97,nan
Stimme,01W714,1,Mitte,714,W,017H,7,75,W,0,0,0,0,0,0,0,0,0,0,01W713
Stimme,01W715,1,Mitte,715,W,017H,7,75,W,1151,1006,145,0,163,5,0,163,96,67,nan
Stimme,01W716,1,Mitte,716,W,017I,7,75,W,948,821,127,0,150,5,0,150,60,90,nan
Stimme,01W717,1,Mitte,717,W,017I,7,75,W,1129,992,137,0,180,3,0,180,84,96,nan
Stimme,01W718,1,Mitte,718,W,017J,7,75,W,850,801,49,0,102,2,0,102,60,42,nan
Stimme,01W719,1,Mitte,719,W,017K,7,75,W,944,882,62,0,94,1,1,93,35,58,nan
Stimme,01W720,1,Mitte,720,W,017L,7,75,W,1329,1150,179,0,265,1,3,262,160,102,nan
Stimme,01W721,1,Mitte,721,W,017J,7,75,W,1498,1294,204,0,239,4,1,238,161,77,nan
Stimme,01W722,1,Mitte,722,W,017K,7,75,W,987,885,102,0,155,2,0,155,108,47,nan
Stimme,01W723,1,Mitte,723,W,017M,7,75,W,1303,1121,182,0,231,4,1,230,142,88,nan
Stimme,01W724,1,Mitte,724,W,017M,7,75,W,1932,1724,208,0,253,5,0,253,142,111,nan
Stimme,01W725,1,Mitte,725,W,017L,7,75,W,0,0,0,0,0,0,0,0,0,0,01W724
Stimme,01B1A,1,Mitte,1A,B,011A,1,75,W,0,0,0,0,514,514,0,514,326,188,nan
Stimme,01B1B,1,Mitte,1B,B,011B,1,75,O,0,0,0,0,954,954,1,953,602,351,nan
Stimme,01B1C,1,Mitte,1C,B,011C,1,75,O,0,0,0,0,0,0,0,0,0,0,01B1B
Stimme,01B1D,1,Mitte,1D,B,011D,1,75,O,0,0,0,0,940,940,21,919,622,297,nan
Stimme,01B1E,1,Mitte,1E,B,011E,1,75,O,0,0,0,0,940,940,3,937,556,381,nan
Stimme,01B1F,1,Mitte,1F,B,011F,1,75,O,0,0,0,0,0,0,0,0,0,0,01B1E
Stimme,01B1G,1,Mitte,1G,B,011G,1,75,W,0,0,0,0,425,425,0,425,247,178,nan
Stimme,01B1H,1,Mitte,1H,B,011H,1,75,O,0,0,0,0,0,0,0,0,0,0,01B1D
Stimme,01B1I,1,Mitte,1I,B,011I,1,75,O,0,0,0,0,966,966,0,966,703,263,nan
Stimme,01B1J,1,Mitte,1J,B,011J,1,75,O,0,0,0,0,229,229,0,229,129,100,nan
Stimme,01B1K,1,Mitte,1K,B,011K,1,75,O,0,0,0,0,0,0,0,0,0,0,01B1I
Stimme,01B1L,1,Mitte,1L,B,011L,1,75,O,0,0,0,0,721,721,0,721,525,196,nan
Stimme,01B1M,1,Mitte,1M,B,011M,1,75,O,0,0,0,0,0,0,0,0,0,0,01B1L
Stimme,01B2A,1,Mitte,2A,B,012A,2,75,O,0,0,0,0,835,835,2,833,347,486,nan
Stimme,01B2B,1,Mitte,2B,B,012B,2,75,O,0,0,0,0,0,0,0,0,0,0,01B2A
Stimme,01B2C,1,Mitte,2C,B,012C,2,75,O,0,0,0,0,884,884,0,884,432,452,nan
Stimme,01B2D,1,Mitte,2D,B,012D,2,75,O,0,0,0,0,705,705,0,705,459,246,nan
Stimme,01B2E,1,Mitte,2E,B,012E,2,75,O,0,0,0,0,0,0,0,0,0,0,01B2D
Stimme,01B2F,1,Mitte,2F,B,012F,2,75,O,0,0,0,0,679,679,1,678,443,235,nan
Stimme,01B2G,1,Mitte,2G,B,012G,2,75,O,0,0,0,0,0,0,0,0,0,0,01B2F
Stimme,01B2H,1,Mitte,2H,B,012H,2,75,O,0,0,0,0,673,673,1,672,309,363,nan
Stimme,01B2I,1,Mitte,2I,B,012I,2,75,O,0,0,0,0,0,0,0,0,0,0,01B2H
Stimme,01B2J,1,Mitte,2J,B,012J,2,75,O,0,0,0,0,846,846,1,845,533,312,nan
Stimme,01B2K,1,Mitte,2K,B,012K,2,75,O,0,0,0,0,0,0,0,0,0,0,01B2C
Stimme,01B2L,1,Mitte,2L,B,012L,2,75,O,0,0,0,0,588,588,0,588,349,239,nan
Stimme,01B2M,1,Mitte,2M,B,012M,2,75,O,0,0,0,0,492,492,1,491,229,262,nan
Stimme,01B2N,1,Mitte,2N,B,012N,2,75,O,0,0,0,0,0,0,0,0,0,0,01B2J
Stimme,01B3A,1,Mitte,3A,B,013A,3,75,W,0,0,0,0,727,727,1,726,533,193,nan
Stimme,01B3B,1,Mitte,3B,B,013B,3,75,W,0,0,0,0,0,0,0,0,0,0,01B3A
Stimme,01B3C,1,Mitte,3C,B,013C,3,75,W,0,0,0,0,940,940,3,937,631,306,nan
Stimme,01B3D,1,Mitte,3D,B,013D,3,75,W,0,0,0,0,0,0,0,0,0,0,01B3C
Stimme,01B3E,1,Mitte,3E,B,013E,3,75,W,0,0,0,0,935,935,1,934,634,300,nan
Stimme,01B3F,1,Mitte,3F,B,013F,3,75,W,0,0,0,0,0,0,0,0,0,0,01B3E
Stimme,01B3G,1,Mitte,3G,B,013G,3,75,W,0,0,0,0,616,616,1,615,328,287,nan
Stimme,01B3H,1,Mitte,3H,B,013H,3,75,W,0,0,0,0,0,0,0,0,0,0,01B3G
Stimme,01B3I,1,Mitte,3I,B,013I,3,75,W,0,0,0,0,961,961,2,959,560,399,nan
Stimme,01B3J,1,Mitte,3J,B,013J,3,75,W,0,0,0,0,0,0,0,0,0,0,01B3I
Stimme,01B3K,1,Mitte,3K,B,013K,3,75,W,0,0,0,0,541,541,11,530,315,215,nan
Stimme,01B3L,1,Mitte,3L,B,013L,3,75,W,0,0,0,0,351,351,0,351,221,130,nan
Stimme,01B4A,1,Mitte,4A,B,014A,4,75,W,0,0,0,0,588,588,1,587,454,133,nan
Stimme,01B4B,1,Mitte,4B,B,014B,4,75,W,0,0,0,0,0,0,0,0,0,0,01B4A
Stimme,01B4C,1,Mitte,4C,B,014C,4,75,W,0,0,0,0,761,761,5,756,574,182,nan
Stimme,01B4D,1,Mitte,4D,B,014D,4,75,W,0,0,0,0,0,0,0,0,0,0,01B4C
Stimme,01B4E,1,Mitte,4E,B,014E,4,75,W,0,0,0,0,830,830,2,828,664,164,nan
Stimme,01B4F,1,Mitte,4F,B,014F,4,75,W,0,0,0,0,0,0,0,0,0,0,01B4E
Stimme,01B4G,1,Mitte,4G,B,014G,4,75,W,0,0,0,0,534,534,1,533,415,118,nan
Stimme,01B4H,1,Mitte,4H,B,014H,4,75,W,0,0,0,0,652,652,0,652,488,164,nan
Stimme,01B4I,1,Mitte,4I,B,014I,4,75,W,0,0,0,0,0,0,0,0,0,0,01B4H
Stimme,01B4J,1,Mitte,4J,B,014J,4,75,W,0,0,0,0,0,0,0,0,0,0,01B4G
Stimme,01B4K,1,Mitte,4K,B,014K,4,75,W,0,0,0,0,257,257,1,256,185,71,nan
Stimme,01B4L,1,Mitte,4L,B,014L,4,75,W,0,0,0,0,946,946,2,944,747,197,nan
Stimme,01B4M,1,Mitte,4M,B,014M,4,75,W,0,0,0,0,0,0,0,0,0,0,01B4L
Stimme,01B5A,1,Mitte,5A,B,015A,5,75,W,0,0,0,0,604,604,3,601,289,312,nan
Stimme,01B5B,1,Mitte,5B,B,015B,5,75,W,0,0,0,0,0,0,0,0,0,0,01B5A
Stimme,01B5C,1,Mitte,5C,B,015C,5,75,W,0,0,0,0,641,641,3,638,307,331,nan
Stimme,01B5D,1,Mitte,5D,B,015D,5,75,W,0,0,0,0,0,0,0,0,0,0,01B5C
Stimme,01B5E,1,Mitte,5E,B,015E,5,75,W,0,0,0,0,643,643,2,641,457,184,nan
Stimme,01B5F,1,Mitte,5F,B,015F,5,75,W,0,0,0,0,540,540,1,539,374,165,nan
Stimme,01B5G,1,Mitte,5G,B,015G,5,75,W,0,0,0,0,0,0,0,0,0,0,01B5F
Stimme,01B5H,1,Mitte,5H,B,015H,5,75,W,0,0,0,0,576,576,1,575,392,183,nan
Stimme,01B5I,1,Mitte,5I,B,015I,5,75,W,0,0,0,0,0,0,0,0,0,0,01B5H
Stimme,01B5J,1,Mitte,5J,B,015J,5,75,W,0,0,0,0,0,0,0,0,0,0,01B5E
Stimme,01B5K,1,Mitte,5K,B,015K,5,75,W,0,0,0,0,883,883,6,877,625,252,nan
Stimme,01B5L,1,Mitte,5L,B,015L,5,75,W,0,0,0,0,0,0,0,0,0,0,01B5K
Stimme,01B6A,1,Mitte,6A,B,016A,6,75,W,0,0,0,0,473,473,0,473,365,108,nan
Stimme,01B6B,1,Mitte,6B,B,016B,6,75,W,0,0,0,0,460,460,0,460,345,115,nan
Stimme,01B6C,1,Mitte,6C,B,016C,6,75,W,0,0,0,0,0,0,0,0,0,0,01B6A
Stimme,01B6D,1,Mitte,6D,B,016D,6,75,W,0,0,0,0,0,0,0,0,0,0,01B6B
Stimme,01B6E,1,Mitte,6E,B,016E,6,75,W,0,0,0,0,490,490,0,490,389,101,nan
Stimme,01B6F,1,Mitte,6F,B,016F,6,75,W,0,0,0,0,670,670,0,670,537,133,nan
Stimme,01B6G,1,Mitte,6G,B,016G,6,75,W,0,0,0,0,0,0,0,0,0,0,01B6E
Stimme,01B6H,1,Mitte,6H,B,016H,6,75,W,0,0,0,0,0,0,0,0,0,0,01B6F
Stimme,01B6I,1,Mitte,6I,B,016I,6,75,W,0,0,0,0,584,584,1,583,451,132,nan
Stimme,01B6J,1,Mitte,6J,B,016J,6,75,W,0,0,0,0,0,0,0,0,0,0,01B6I
Stimme,01B6K,1,Mitte,6K,B,016K,6,75,W,0,0,0,0,274,274,1,273,224,49,nan
Stimme,01B6L,1,Mitte,6L,B,016L,6,75,W,0,0,0,0,481,481,2,479,370,109,nan
Stimme,01B6M,1,Mitte,6M,B,016M,6,75,W,0,0,0,0,0,0,0,0,0,0,01B6L
Stimme,01B7A,1,Mitte,7A,B,017A,7,75,W,0,0,0,0,629,629,1,628,488,140,nan
Stimme,01B7B,1,Mitte,7B,B,017B,7,75,W,0,0,0,0,0,0,0,0,0,0,01B7A
Stimme,01B7C,1,Mitte,7C,B,017C,7,75,W,0,0,0,0,713,713,1,712,566,146,nan
Stimme,01B7D,1,Mitte,7D,B,017D,7,75,W,0,0,0,0,0,0,0,0,0,0,01B7C
Stimme,01B7E,1,Mitte,7E,B,017E,7,75,W,0,0,0,0,667,667,1,666,529,137,nan
Stimme,01B7F,1,Mitte,7F,B,017F,7,75,W,0,0,0,0,0,0,0,0,0,0,01B7E
Stimme,01B7G,1,Mitte,7G,B,017G,7,75,W,0,0,0,0,575,575,5,570,415,155,nan
Stimme,01B7H,1,Mitte,7H,B,017H,7,75,W,0,0,0,0,0,0,0,0,0,0,01B7G
Stimme,01B7I,1,Mitte,7I,B,017I,7,75,W,0,0,0,0,415,415,1,414,272,142,nan
Stimme,01B7J,1,Mitte,7J,B,017J,7,75,W,0,0,0,0,0,0,0,0,0,0,01B7I
Stimme,01B7K,1,Mitte,7K,B,017K,7,75,W,0,0,0,0,143,143,0,143,94,49,nan
Stimme,01B7L,1,Mitte,7L,B,017L,7,75,W,0,0,0,0,470,470,0,470,321,149,nan
Stimme,01B7M,1,Mitte,7M,B,017M,7,75,W,0,0,0,0,0,0,0,0,0,0,01B7L
Stimme,02W101,2,Friedrichshain-Kreuzberg,101,W,021A,1,83,W,1059,915,144,0,173,3,0,173,110,63,nan
Stimme,02W102,2,Friedrichshain-Kreuzberg,102,W,021B,1,83,W,1208,1071,137,0,148,1,3,145,93,52,nan
Stimme,02W103,2,Friedrichshain-Kreuzberg,103,W,021C,1,83,W,1029,939,90,0,95,1,0,95,52,43,nan
Stimme,02W104,2,Friedrichshain-Kreuzberg,104,W,021D,1,83,W,704,609,95,0,96,3,1,95,59,36,nan
Stimme,02W105,2,Friedrichshain-Kreuzberg,105,W,021E,1,83,W,1015,903,112,0,145,8,0,145,85,60,nan
Stimme,02W106,2,Friedrichshain-Kreuzberg,106,W,021F,1,83,W,1472,1272,200,0,175,3,1,174,121,53,nan
Stimme,02W107,2,Friedrichshain-Kreuzberg,107,W,021G,1,83,W,610,499,111,0,138,3,1,137,106,31,nan
Stimme,02W108,2,Friedrichshain-Kreuzberg,108,W,021G,1,83,W,762,512,250,0,115,6,3,112,80,32,nan
Stimme,02W109,2,Friedrichshain-Kreuzberg,109,W,021H,1,83,W,1182,916,266,0,274,3,1,273,220,53,nan
Stimme,02W110,2,Friedrichshain-Kreuzberg,110,W,021J,1,83,W,1088,814,274,0,219,4,0,219,181,38,nan
Stimme,02W111,2,Friedrichshain-Kreuzberg,111,W,021K,1,83,W,1121,882,239,0,245,3,0,245,211,34,nan
Stimme,02W112,2,Friedrichshain-Kreuzberg,112,W,021L,1,83,W,1302,1022,280,0,281,8,0,281,218,63,nan
Stimme,02W113,2,Friedrichshain-Kreuzberg,113,W,021M,1,83,W,942,713,229,0,281,8,4,277,222,55,nan
Stimme,02W114,2,Friedrichshain-Kreuzberg,114,W,021N,1,83,W,805,617,188,0,247,7,5,242,200,42,nan
Stimme,02W115,2,Friedrichshain-Kreuzberg,115,W,021N,1,83,W,816,627,189,0,240,6,1,239,195,44,nan
Stimme,02W116,2,Friedrichshain-Kreuzberg,116,W,021P,1,83,W,1015,771,244,0,282,11,1,281,222,59,nan
Stimme,02W117,2,Friedrichshain-Kreuzberg,117,W,021Q,1,83,W,1047,806,241,0,272,9,1,271,222,49,nan
Stimme,02W118,2,Friedrichshain-Kreuzberg,118,W,021R,1,83,W,662,534,128,0,149,2,0,149,110,39,nan
Stimme,02W119,2,Friedrichshain-Kreuzberg,119,W,021S,1,83,W,831,613,218,0,202,9,3,199,146,53,nan
Stimme,02W120,2,Friedrichshain-Kreuzberg,120,W,021T,1,83,W,797,642,155,0,202,4,1,201,159,42,nan
Stimme,02W121,2,Friedrichshain-Kreuzberg,121,W,021U,1,83,W,847,694,153,0,257,16,3,254,199,55,nan
Stimme,02W122,2,Friedrichshain-Kreuzberg,122,W,021V,1,83,W,1019,810,209,0,284,10,0,284,233,51,nan
Stimme,02W123,2,Friedrichshain-Kreuzberg,123,W,021R,1,83,W,719,574,145,0,194,6,1,193,153,40,nan
Stimme,02W124,2,Friedrichshain-Kreuzberg,124,W,021W,1,83,W,1290,965,325,0,354,16,3,351,287,64,nan
Stimme,02W125,2,Friedrichshain-Kreuzberg,125,W,021X,1,83,W,1325,955,370,0,451,5,5,446,377,69,nan
Stimme,02W126,2,Friedrichshain-Kreuzberg,126,W,021Y,1,83,W,904,690,214,0,287,20,1,286,237,49,nan
Stimme,02W127,2,Friedrichshain-Kreuzberg,127,W,021Z,1,83,W,852,668,184,0,206,11,2,204,178,26,nan
Stimme,02W128,2,Friedrichshain-Kreuzberg,128,W,021AA,1,83,W,1219,870,349,0,287,11,4,283,233,50,nan
Stimme,02W129,2,Friedrichshain-Kreuzberg,129,W,021AB,1,83,W,1222,864,358,0,302,4,1,301,217,84,nan
Stimme,02W201,2,Friedrichshain-Kreuzberg,201,W,022A,2,83,W,851,689,162,0,236,1,1,235,187,48,nan
Stimme,02W202,2,Friedrichshain-Kreuzberg,202,W,022B,2,83,W,1054,825,229,0,310,9,0,310,261,49,nan
Stimme,02W203,2,Friedrichshain-Kreuzberg,203,W,022C,2,83,W,890,704,186,0,252,5,2,250,213,37,nan
Stimme,02W204,2,Friedrichshain-Kreuzberg,204,W,022D,2,83,W,1030,835,195,0,252,6,1,251,222,29,nan
Stimme,02W205,2,Friedrichshain-Kreuzberg,205,W,022E,2,83,W,993,803,190,0,225,4,1,224,192,32,nan
Stimme,02W206,2,Friedrichshain-Kreuzberg,206,W,022F,2,83,W,949,773,176,0,266,8,1,265,223,42,nan
Stimme,02W207,2,Friedrichshain-Kreuzberg,207,W,022G,2,83,W,1332,1098,234,0,366,11,3,363,295,68,nan
Stimme,02W208,2,Friedrichshain-Kreuzberg,208,W,022H,2,83,W,1115,887,228,0,320,8,0,320,256,64,nan
Stimme,02W209,2,Friedrichshain-Kreuzberg,209,W,022J,2,83,W,1115,890,225,0,274,10,2,272,218,54,nan
Stimme,02W210,2,Friedrichshain-Kreuzberg,210,W,022K,2,83,W,1111,872,239,0,276,1,2,274,240,34,nan
Stimme,02W211,2,Friedrichshain-Kreuzberg,211,W,022L,2,83,W,1110,885,225,0,287,10,0,287,239,48,nan
Stimme,02W212,2,Friedrichshain-Kreuzberg,212,W,022M,2,83,W,903,705,198,0,276,3,3,273,232,41,nan
Stimme,02W213,2,Friedrichshain-Kreuzberg,213,W,022N,2,83,W,1092,879,213,0,283,13,1,282,244,38,nan
Stimme,02W214,2,Friedrichshain-Kreuzberg,214,W,022P,2,83,W,920,778,142,0,170,4,0,170,129,41,nan
Stimme,02W215,2,Friedrichshain-Kreuzberg,215,W,022Q,2,83,W,896,826,70,0,160,2,0,160,88,72,nan
Stimme,02W216,2,Friedrichshain-Kreuzberg,216,W,022Q,2,83,W,840,640,200,0,294,3,1,293,245,48,nan
Stimme,02W217,2,Friedrichshain-Kreuzberg,217,W,022R,2,83,W,1045,794,251,0,269,5,2,267,239,28,nan
Stimme,02W218,2,Friedrichshain-Kreuzberg,218,W,022S,2,83,W,1145,887,258,0,350,12,3,347,307,40,nan
Stimme,02W219,2,Friedrichshain-Kreuzberg,219,W,022T,2,83,W,935,750,185,0,241,7,2,239,210,29,nan
Stimme,02W220,2,Friedrichshain-Kreuzberg,220,W,022U,2,83,W,1120,872,248,0,306,10,3,303,257,46,nan
Stimme,02W221,2,Friedrichshain-Kreuzberg,221,W,022V,2,83,W,894,716,178,0,207,6,1,206,180,26,nan
Stimme,02W222,2,Friedrichshain-Kreuzberg,222,W,022W,2,83,W,1095,888,207,0,285,13,4,281,216,65,nan
Stimme,02W223,2,Friedrichshain-Kreuzberg,223,W,022X,2,83,W,840,752,88,0,123,5,0,123,86,37,nan
Stimme,02W224,2,Friedrichshain-Kreuzberg,224,W,022Y,2,83,W,917,688,229,0,214,9,0,214,177,37,nan
Stimme,02W225,2,Friedrichshain-Kreuzberg,225,W,022Y,2,83,W,700,490,210,0,177,12,0,177,134,43,nan
Stimme,02W226,2,Friedrichshain-Kreuzberg,226,W,022Z,2,83,W,1293,953,340,0,375,9,0,375,284,91,nan
Stimme,02W301,2,Friedrichshain-Kreuzberg,301,W,023A,3,83,W,1083,843,240,0,358,13,1,357,315,42,nan
Stimme,02W302,2,Friedrichshain-Kreuzberg,302,W,023B,3,83,W,1203,873,330,0,369,13,0,369,288,81,nan
Stimme,02W303,2,Friedrichshain-Kreuzberg,303,W,023C,3,83,W,1179,912,267,0,300,10,1,299,237,62,nan
Stimme,02W304,2,Friedrichshain-Kreuzberg,304,W,023D,3,83,W,1091,825,266,0,290,8,1,289,243,46,nan
Stimme,02W305,2,Friedrichshain-Kreuzberg,305,W,023E,3,83,W,1100,863,237,0,340,6,0,340,285,55,nan
Stimme,02W306,2,Friedrichshain-Kreuzberg,306,W,023F,3,83,W,1032,835,197,0,263,4,1,262,211,51,nan
Stimme,02W307,2,Friedrichshain-Kreuzberg,307,W,023G,3,83,W,809,733,76,0,117,2,0,117,78,39,nan
Stimme,02W308,2,Friedrichshain-Kreuzberg,308,W,023H,3,83,W,1192,1023,169,0,200,3,1,199,134,65,nan
Stimme,02W309,2,Friedrichshain-Kreuzberg,309,W,023J,3,83,W,810,688,122,0,144,1,1,143,101,42,nan
Stimme,02W310,2,Friedrichshain-Kreuzberg,310,W,023K,3,83,W,1236,1052,184,0,216,8,0,216,132,84,nan
Stimme,02W311,2,Friedrichshain-Kreuzberg,311,W,023L,3,83,W,1168,1001,167,0,184,4,1,183,115,68,nan
Stimme,02W312,2,Friedrichshain-Kreuzberg,312,W,023M,3,83,W,766,668,98,0,116,2,0,116,70,46,nan
Stimme,02W313,2,Friedrichshain-Kreuzberg,313,W,023M,3,83,W,829,735,94,0,95,1,0,95,56,39,nan
Stimme,02W314,2,Friedrichshain-Kreuzberg,314,W,023N,3,83,W,1178,1048,130,0,120,1,0,120,48,72,nan
Stimme,02W315,2,Friedrichshain-Kreuzberg,315,W,023P,3,83,W,947,820,127,0,115,2,0,115,76,39,nan
Stimme,02W316,2,Friedrichshain-Kreuzberg,316,W,023Q,3,83,W,1206,1102,104,0,139,2,0,139,77,62,nan
Stimme,02W317,2,Friedrichshain-Kreuzberg,317,W,023R,3,83,W,1260,1045,215,0,246,7,1,245,213,32,nan
Stimme,02W318,2,Friedrichshain-Kreuzberg,318,W,023S,3,83,W,914,759,155,0,172,1,1,171,140,31,nan
Stimme,02W319,2,Friedrichshain-Kreuzberg,319,W,023T,3,83,W,943,743,200,0,264,3,1,263,225,38,nan
Stimme,02W320,2,Friedrichshain-Kreuzberg,320,W,023U,3,83,W,1028,842,186,0,190,4,0,190,161,29,nan
Stimme,02W321,2,Friedrichshain-Kreuzberg,321,W,023V,3,83,W,908,774,134,0,208,6,1,207,176,31,nan
Stimme,02W322,2,Friedrichshain-Kreuzberg,322,W,023W,3,83,W,983,856,127,0,166,2,3,163,126,37,nan
Stimme,02W323,2,Friedrichshain-Kreuzberg,323,W,023X,3,83,W,1111,922,189,0,307,9,0,307,231,76,nan
Stimme,02W324,2,Friedrichshain-Kreuzberg,324,W,023Y,3,83,W,1137,907,230,0,321,7,2,319,271,48,nan
Stimme,02W325,2,Friedrichshain-Kreuzberg,325,W,023Z,3,83,W,1109,959,150,0,206,5,0,206,145,61,nan
Stimme,02W326,2,Friedrichshain-Kreuzberg,326,W,023AA,3,83,W,1071,844,227,0,316,8,1,315,268,47,nan
Stimme,02W327,2,Friedrichshain-Kreuzberg,327,W,023AB,3,83,W,880,700,180,0,244,0,3,241,197,44,nan
Stimme,02W401,2,Friedrichshain-Kreuzberg,401,W,024A,4,83,O,1107,946,161,0,164,4,0,164,76,88,nan
Stimme,02W402,2,Friedrichshain-Kreuzberg,402,W,024B,4,83,O,1099,926,173,0,209,1,0,209,89,120,nan
Stimme,02W403,2,Friedrichshain-Kreuzberg,403,W,024C,4,83,O,1248,1068,180,0,144,3,2,142,83,59,nan
Stimme,02W404,2,Friedrichshain-Kreuzberg,404,W,024D,4,83,O,1072,888,184,0,172,2,0,172,89,83,nan
Stimme,02W405,2,Friedrichshain-Kreuzberg,405,W,024E,4,83,O,861,646,215,0,189,3,0,189,115,74,nan
Stimme,02W406,2,Friedrichshain-Kreuzberg,406,W,024F,4,83,O,978,775,203,0,216,7,0,216,146,70,nan
Stimme,02W407,2,Friedrichshain-Kreuzberg,407,W,024G,4,83,O,784,632,152,0,181,4,0,181,121,60,nan
Stimme,02W408,2,Friedrichshain-Kreuzberg,408,W,024H,4,83,O,874,644,230,0,178,6,1,177,134,43,nan
Stimme,02W409,2,Friedrichshain-Kreuzberg,409,W,024J,4,83,O,1060,838,222,0,174,6,0,174,108,66,nan
Stimme,02W410,2,Friedrichshain-Kreuzberg,410,W,024K,4,83,O,1022,726,296,0,287,6,2,285,193,92,nan
Stimme,02W411,2,Friedrichshain-Kreuzberg,411,W,024L,4,83,O,1132,938,194,0,234,2,1,233,150,83,nan
Stimme,02W412,2,Friedrichshain-Kreuzberg,412,W,024M,4,83,O,1062,825,237,0,252,5,2,250,181,69,nan
Stimme,02W413,2,Friedrichshain-Kreuzberg,413,W,024N,4,83,O,911,691,220,0,194,3,2,192,136,56,nan
Stimme,02W414,2,Friedrichshain-Kreuzberg,414,W,024P,4,83,O,947,712,235,0,206,5,1,205,164,41,nan
Stimme,02W415,2,Friedrichshain-Kreuzberg,415,W,024Q,4,83,O,1160,906,254,0,282,9,0,282,193,89,nan
Stimme,02W416,2,Friedrichshain-Kreuzberg,416,W,024R,4,83,O,1300,1036,264,0,301,1,2,299,185,114,nan
Stimme,02W417,2,Friedrichshain-Kreuzberg,417,W,024S,4,83,O,1045,848,197,0,251,1,2,249,169,80,nan
Stimme,02W418,2,Friedrichshain-Kreuzberg,418,W,024T,4,83,O,1154,982,172,0,139,1,0,139,64,75,nan
Stimme,02W419,2,Friedrichshain-Kreuzberg,419,W,024U,4,83,O,1281,1073,208,0,228,3,0,228,129,99,nan
Stimme,02W420,2,Friedrichshain-Kreuzberg,420,W,024V,4,83,O,779,658,121,0,139,1,0,139,73,66,nan
Stimme,02W421,2,Friedrichshain-Kreuzberg,421,W,024W,4,83,O,926,785,141,0,144,5,0,144,76,68,nan
Stimme,02W422,2,Friedrichshain-Kreuzberg,422,W,024X,4,83,O,827,666,161,0,169,3,0,169,93,76,nan
Stimme,02W423,2,Friedrichshain-Kreuzberg,423,W,024Y,4,83,O,1095,934,161,0,135,0,0,135,82,53,nan
Stimme,02W424,2,Friedrichshain-Kreuzberg,424,W,024Z,4,83,O,852,679,173,0,172,1,1,171,109,62,nan
Stimme,02W425,2,Friedrichshain-Kreuzberg,425,W,024AA,4,83,O,1160,865,295,0,309,11,0,309,248,61,nan
Stimme,02W426,2,Friedrichshain-Kreuzberg,426,W,024AB,4,83,O,1131,820,311,0,318,12,2,316,250,66,nan
Stimme,02W427,2,Friedrichshain-Kreuzberg,427,W,024AC,4,83,O,1058,842,216,0,177,2,0,177,114,63,nan
Stimme,02W501,2,Friedrichshain-Kreuzberg,501,W,025A,5,83,O,911,693,218,0,224,15,2,222,168,54,nan
Stimme,02W502,2,Friedrichshain-Kreuzberg,502,W,025B,5,83,O,1269,955,314,0,258,2,0,258,197,61,nan
Stimme,02W503,2,Friedrichshain-Kreuzberg,503,W,025C,5,83,O,1217,942,275,0,232,8,0,232,186,46,nan
Stimme,02W504,2,Friedrichshain-Kreuzberg,504,W,025D,5,83,O,1057,816,241,0,261,2,0,261,191,70,nan
Stimme,02W505,2,Friedrichshain-Kreuzberg,505,W,025E,5,83,O,1237,919,318,0,312,5,2,310,244,66,nan
Stimme,02W506,2,Friedrichshain-Kreuzberg,506,W,025F,5,83,O,1115,852,263,0,229,3,1,228,176,52,nan
Stimme,02W507,2,Friedrichshain-Kreuzberg,507,W,025G,5,83,O,1202,864,338,0,259,7,1,258,203,55,nan
Stimme,02W508,2,Friedrichshain-Kreuzberg,508,W,025H,5,83,O,1278,1039,239,0,280,7,2,278,201,77,nan
Stimme,02W509,2,Friedrichshain-Kreuzberg,509,W,025J,5,83,O,1004,802,202,0,279,7,2,277,200,77,nan
Stimme,02W510,2,Friedrichshain-Kreuzberg,510,W,025K,5,83,O,935,733,202,0,190,7,1,189,140,49,nan
Stimme,02W511,2,Friedrichshain-Kreuzberg,511,W,025L,5,83,O,788,573,215,0,169,6,0,169,145,24,nan
Stimme,02W512,2,Friedrichshain-Kreuzberg,512,W,025L,5,83,O,934,729,205,0,271,4,1,270,216,54,nan
Stimme,02W513,2,Friedrichshain-Kreuzberg,513,W,025M,5,83,O,1205,910,295,0,321,9,1,320,269,51,nan
Stimme,02W514,2,Friedrichshain-Kreuzberg,514,W,025N,5,83,O,969,754,215,0,248,2,1,247,207,40,nan
Stimme,02W515,2,Friedrichshain-Kreuzberg,515,W,025P,5,83,O,1031,778,253,0,232,3,0,232,204,28,nan
Stimme,02W516,2,Friedrichshain-Kreuzberg,516,W,025Q,5,83,O,979,736,243,0,185,5,0,185,158,27,nan
Stimme,02W517,2,Friedrichshain-Kreuzberg,517,W,025R,5,83,O,1229,943,286,0,311,7,1,310,257,53,nan
Stimme,02W518,2,Friedrichshain-Kreuzberg,518,W,025S,5,83,O,1196,878,318,0,247,7,2,245,191,54,nan
Stimme,02W519,2,Friedrichshain-Kreuzberg,519,W,025T,5,83,O,1020,745,275,0,255,5,1,254,199,55,nan
Stimme,02W520,2,Friedrichshain-Kreuzberg,520,W,025U,5,83,O,1202,928,274,0,308,2,1,307,230,77,nan
Stimme,02W521,2,Friedrichshain-Kreuzberg,521,W,025V,5,83,O,1022,790,232,0,267,8,1,266,209,57,nan
Stimme,02W522,2,Friedrichshain-Kreuzberg,522,W,025W,5,83,O,1181,921,260,0,238,3,1,237,181,56,nan
Stimme,02W523,2,Friedrichshain-Kreuzberg,523,W,025X,5,83,O,1041,832,209,0,242,6,1,241,185,56,nan
Stimme,02W524,2,Friedrichshain-Kreuzberg,524,W,025Y,5,83,O,1033,840,193,0,238,5,1,237,171,66,nan
Stimme,02W525,2,Friedrichshain-Kreuzberg,525,W,025Z,5,83,O,988,798,190,0,237,4,1,236,186,50,nan
Stimme,02W526,2,Friedrichshain-Kreuzberg,526,W,025AA,5,83,O,1153,923,230,0,312,7,0,312,254,58,nan
Stimme,02W601,2,Friedrichshain-Kreuzberg,601,W,026A,6,83,O,1309,1016,293,0,317,12,0,317,213,104,nan
Stimme,02W602,2,Friedrichshain-Kreuzberg,602,W,026B,6,83,O,885,666,219,0,222,6,0,222,140,82,nan
Stimme,02W603,2,Friedrichshain-Kreuzberg,603,W,026C,6,83,O,1098,845,253,0,289,4,1,288,220,68,nan
Stimme,02W604,2,Friedrichshain-Kreuzberg,604,W,026D,6,83,O,999,841,158,0,197,3,0,197,119,78,nan
Stimme,02W605,2,Friedrichshain-Kreuzberg,605,W,026E,6,83,O,1215,939,276,0,264,6,0,264,212,52,nan
Stimme,02W606,2,Friedrichshain-Kreuzberg,606,W,026F,6,83,O,795,598,197,0,194,6,0,194,164,30,nan
Stimme,02W607,2,Friedrichshain-Kreuzberg,607,W,026G,6,83,O,854,654,200,0,281,0,2,279,217,62,nan
Stimme,02W608,2,Friedrichshain-Kreuzberg,608,W,026H,6,83,O,1181,883,298,0,295,9,0,295,236,59,nan
Stimme,02W609,2,Friedrichshain-Kreuzberg,609,W,026J,6,83,O,1094,822,272,0,245,7,0,245,205,40,nan
Stimme,02W610,2,Friedrichshain-Kreuzberg,610,W,026K,6,83,O,1245,967,278,0,338,9,0,338,252,86,nan
Stimme,02W611,2,Friedrichshain-Kreuzberg,611,W,026L,6,83,O,959,712,247,0,257,6,1,256,205,51,nan
Stimme,02W612,2,Friedrichshain-Kreuzberg,612,W,026M,6,83,O,1038,786,252,0,284,8,0,284,237,47,nan
Stimme,02W613,2,Friedrichshain-Kreuzberg,613,W,026N,6,83,O,1177,821,356,0,288,6,2,286,253,33,nan
Stimme,02W614,2,Friedrichshain-Kreuzberg,614,W,026P,6,83,O,1198,942,256,0,316,3,0,316,249,67,nan
Stimme,02W615,2,Friedrichshain-Kreuzberg,615,W,026Q,6,83,O,731,591,140,0,160,1,0,160,133,27,nan
Stimme,02W616,2,Friedrichshain-Kreuzberg,616,W,026R,6,83,O,1177,938,239,0,293,2,0,293,224,69,nan
Stimme,02W617,2,Friedrichshain-Kreuzberg,617,W,026S,6,83,O,1133,868,265,0,267,8,0,267,219,48,nan
Stimme,02W618,2,Friedrichshain-Kreuzberg,618,W,026T,6,83,O,962,764,198,0,239,4,0,239,203,36,nan
Stimme,02W619,2,Friedrichshain-Kreuzberg,619,W,026U,6,83,O,812,622,190,0,205,4,1,204,174,30,nan
Stimme,02W620,2,Friedrichshain-Kreuzberg,620,W,026V,6,83,O,1033,758,275,0,192,6,2,190,159,31,nan
Stimme,02W621,2,Friedrichshain-Kreuzberg,621,W,026W,6,83,O,788,584,204,0,171,4,0,171,141,30,nan
Stimme,02W622,2,Friedrichshain-Kreuzberg,622,W,026X,6,83,O,981,748,233,0,194,1,0,194,148,46,nan
Stimme,02W623,2,Friedrichshain-Kreuzberg,623,W,026Y,6,83,O,888,642,246,0,209,6,1,208,175,33,nan
Stimme,02W624,2,Friedrichshain-Kreuzberg,624,W,026Z,6,83,O,883,638,245,0,201,1,1,200,178,22,nan
Stimme,02W625,2,Friedrichshain-Kreuzberg,625,W,026AA,6,83,O,691,521,170,0,195,4,0,195,157,38,nan
Stimme,02W626,2,Friedrichshain-Kreuzberg,626,W,026AA,6,83,O,977,730,247,0,255,8,2,253,207,46,nan
Stimme,02W627,2,Friedrichshain-Kreuzberg,627,W,026G,6,83,O,758,595,163,0,196,4,0,196,147,49,nan
Stimme,02W628,2,Friedrichshain-Kreuzberg,628,W,026AB,6,83,O,903,656,247,0,205,1,1,204,161,43,nan
Stimme,02B1A,2,Friedrichshain-Kreuzberg,1A,B,021A,1,83,W,0,0,0,0,362,362,0,362,294,68,nan
Stimme,02B1AA,2,Friedrichshain-Kreuzberg,1AA,B,021AA,1,83,W,0,0,0,0,283,283,0,283,224,59,nan
Stimme,02B1AB,2,Friedrichshain-Kreuzberg,1AB,B,021AB,1,83,W,0,0,0,0,306,306,0,306,215,91,nan
Stimme,02B1B,2,Friedrichshain-Kreuzberg,1B,B,021B,1,83,W,0,0,0,0,114,114,2,112,78,34,nan
Stimme,02B1C,2,Friedrichshain-Kreuzberg,1C,B,021C,1,83,W,0,0,0,0,73,73,2,71,46,25,nan
Stimme,02B1D,2,Friedrichshain-Kreuzberg,1D,B,021D,1,83,W,0,0,0,0,76,76,0,76,54,22,nan
Stimme,02B1E,2,Friedrichshain-Kreuzberg,1E,B,021E,1,83,W,0,0,0,0,84,84,1,83,56,27,nan
Stimme,02B1F,2,Friedrichshain-Kreuzberg,1F,B,021F,1,83,W,0,0,0,0,170,170,0,170,105,65,nan
Stimme,02B1G,2,Friedrichshain-Kreuzberg,1G,B,021G,1,83,W,0,0,0,0,293,293,0,293,189,104,nan
Stimme,02B1H,2,Friedrichshain-Kreuzberg,1H,B,021H,1,83,W,0,0,0,0,224,224,0,224,171,53,nan
Stimme,02B1J,2,Friedrichshain-Kreuzberg,1J,B,021J,1,83,W,0,0,0,0,240,240,0,240,187,53,nan
Stimme,02B1K,2,Friedrichshain-Kreuzberg,1K,B,021K,1,83,W,0,0,0,0,210,210,1,209,172,37,nan
Stimme,02B1L,2,Friedrichshain-Kreuzberg,1L,B,021L,1,83,W,0,0,0,0,234,234,0,234,185,49,nan
Stimme,02B1M,2,Friedrichshain-Kreuzberg,1M,B,021M,1,83,W,0,0,0,0,194,194,0,194,152,42,nan
Stimme,02B1N,2,Friedrichshain-Kreuzberg,1N,B,021N,1,83,W,0,0,0,0,316,316,1,315,248,67,nan
Stimme,02B1P,2,Friedrichshain-Kreuzberg,1P,B,021P,1,83,W,0,0,0,0,190,190,0,190,145,45,nan
Stimme,02B1Q,2,Friedrichshain-Kreuzberg,1Q,B,021Q,1,83,W,0,0,0,0,191,191,0,191,158,33,nan
Stimme,02B1R,2,Friedrichshain-Kreuzberg,1R,B,021R,1,83,W,0,0,0,0,232,232,0,232,178,54,nan
Stimme,02B1S,2,Friedrichshain-Kreuzberg,1S,B,021S,1,83,W,0,0,0,0,181,181,0,181,130,51,nan
Stimme,02B1T,2,Friedrichshain-Kreuzberg,1T,B,021T,1,83,W,0,0,0,0,130,130,0,130,108,22,nan
Stimme,02B1U,2,Friedrichshain-Kreuzberg,1U,B,021U,1,83,W,0,0,0,0,122,122,0,122,97,25,nan
Stimme,02B1V,2,Friedrichshain-Kreuzberg,1V,B,021V,1,83,W,0,0,0,0,168,168,1,167,140,27,nan
Stimme,02B1W,2,Friedrichshain-Kreuzberg,1W,B,021W,1,83,W,0,0,0,0,255,255,1,254,189,65,nan
Stimme,02B1X,2,Friedrichshain-Kreuzberg,1X,B,021X,1,83,W,0,0,0,0,294,294,1,293,254,39,nan
Stimme,02B1Y,2,Friedrichshain-Kreuzberg,1Y,B,021Y,1,83,W,0,0,0,0,166,166,1,165,119,46,nan
Stimme,02B1Z,2,Friedrichshain-Kreuzberg,1Z,B,021Z,1,83,W,0,0,0,0,146,146,1,145,123,22,nan
Stimme,02B2A,2,Friedrichshain-Kreuzberg,2A,B,022A,2,83,W,0,0,0,0,116,116,1,115,94,21,nan
Stimme,02B2B,2,Friedrichshain-Kreuzberg,2B,B,022B,2,83,W,0,0,0,0,183,183,1,182,156,26,nan
Stimme,02B2C,2,Friedrichshain-Kreuzberg,2C,B,022C,2,83,W,0,0,0,0,153,153,0,153,129,24,nan
Stimme,02B2D,2,Friedrichshain-Kreuzberg,2D,B,022D,2,83,W,0,0,0,0,158,158,0,158,138,20,nan
Stimme,02B2E,2,Friedrichshain-Kreuzberg,2E,B,022E,2,83,W,0,0,0,0,150,150,0,150,135,15,nan
Stimme,02B2F,2,Friedrichshain-Kreuzberg,2F,B,022F,2,83,W,0,0,0,0,149,149,1,148,130,18,nan
Stimme,02B2G,2,Friedrichshain-Kreuzberg,2G,B,022G,2,83,W,0,0,0,0,189,189,0,189,164,25,nan
Stimme,02B2H,2,Friedrichshain-Kreuzberg,2H,B,022H,2,83,W,0,0,0,0,191,191,0,191,155,36,nan
Stimme,02B2J,2,Friedrichshain-Kreuzberg,2J,B,022J,2,83,W,0,0,0,0,182,182,1,181,156,25,nan
Stimme,02B2K,2,Friedrichshain-Kreuzberg,2K,B,022K,2,83,W,0,0,0,0,208,208,1,207,189,18,nan
Stimme,02B2L,2,Friedrichshain-Kreuzberg,2L,B,022L,2,83,W,0,0,0,0,180,180,0,180,156,24,nan
Stimme,02B2M,2,Friedrichshain-Kreuzberg,2M,B,022M,2,83,W,0,0,0,0,169,169,2,167,141,26,nan
Stimme,02B2N,2,Friedrichshain-Kreuzberg,2N,B,022N,2,83,W,0,0,0,0,173,173,0,173,144,29,nan
Stimme,02B2P,2,Friedrichshain-Kreuzberg,2P,B,022P,2,83,W,0,0,0,0,114,114,0,114,97,17,nan
Stimme,02B2Q,2,Friedrichshain-Kreuzberg,2Q,B,022Q,2,83,W,0,0,0,0,216,216,0,216,181,35,nan
Stimme,02B2R,2,Friedrichshain-Kreuzberg,2R,B,022R,2,83,W,0,0,0,0,209,209,2,207,175,32,nan
Stimme,02B2S,2,Friedrichshain-Kreuzberg,2S,B,022S,2,83,W,0,0,0,0,208,208,1,207,181,26,nan
Stimme,02B2T,2,Friedrichshain-Kreuzberg,2T,B,022T,2,83,W,0,0,0,0,154,154,0,154,115,39,nan
Stimme,02B2U,2,Friedrichshain-Kreuzberg,2U,B,022U,2,83,W,0,0,0,0,198,198,0,198,165,33,nan
Stimme,02B2V,2,Friedrichshain-Kreuzberg,2V,B,022V,2,83,W,0,0,0,0,142,142,1,141,121,20,nan
Stimme,02B2W,2,Friedrichshain-Kreuzberg,2W,B,022W,2,83,W,0,0,0,0,173,173,0,173,150,23,nan
Stimme,02B2X,2,Friedrichshain-Kreuzberg,2X,B,022X,2,83,W,0,0,0,0,73,73,0,73,57,16,nan
Stimme,02B2Y,2,Friedrichshain-Kreuzberg,2Y,B,022Y,2,83,W,0,0,0,0,364,364,2,362,285,77,nan
Stimme,02B2Z,2,Friedrichshain-Kreuzberg,2Z,B,022Z,2,83,W,0,0,0,0,292,292,5,287,216,71,nan
Stimme,02B3A,2,Friedrichshain-Kreuzberg,3A,B,023A,3,83,W,0,0,0,0,171,171,0,171,138,33,nan
Stimme,02B3AA,2,Friedrichshain-Kreuzberg,3AA,B,023AA,3,83,W,0,0,0,0,193,193,0,193,176,17,nan
Stimme,02B3AB,2,Friedrichshain-Kreuzberg,3AB,B,023AB,3,83,W,0,0,0,0,143,143,0,143,120,23,nan
Stimme,02B3B,2,Friedrichshain-Kreuzberg,3B,B,023B,3,83,W,0,0,0,0,265,265,0,265,211,54,nan
Stimme,02B3C,2,Friedrichshain-Kreuzberg,3C,B,023C,3,83,W,0,0,0,0,224,224,1,223,173,50,nan
Stimme,02B3D,2,Friedrichshain-Kreuzberg,3D,B,023D,3,83,W,0,0,0,0,210,210,1,209,170,39,nan
Stimme,02B3E,2,Friedrichshain-Kreuzberg,3E,B,023E,3,83,W,0,0,0,0,199,199,3,196,158,38,nan
Stimme,02B3F,2,Friedrichshain-Kreuzberg,3F,B,023F,3,83,W,0,0,0,0,171,171,0,171,132,39,nan
Stimme,02B3G,2,Friedrichshain-Kreuzberg,3G,B,023G,3,83,W,0,0,0,0,60,60,1,59,46,13,nan
Stimme,02B3H,2,Friedrichshain-Kreuzberg,3H,B,023H,3,83,W,0,0,0,0,139,139,0,139,100,39,nan
Stimme,02B3J,2,Friedrichshain-Kreuzberg,3J,B,023J,3,83,W,0,0,0,0,106,106,0,106,70,36,nan
Stimme,02B3K,2,Friedrichshain-Kreuzberg,3K,B,023K,3,83,W,0,0,0,0,153,153,0,153,94,59,nan
Stimme,02B3L,2,Friedrichshain-Kreuzberg,3L,B,023L,3,83,W,0,0,0,0,143,143,8,135,98,37,nan
Stimme,02B3M,2,Friedrichshain-Kreuzberg,3M,B,023M,3,83,W,0,0,0,0,165,165,2,163,128,35,nan
Stimme,02B3N,2,Friedrichshain-Kreuzberg,3N,B,023N,3,83,W,0,0,0,0,112,112,0,112,64,48,nan
Stimme,02B3P,2,Friedrichshain-Kreuzberg,3P,B,023P,3,83,W,0,0,0,0,96,96,0,96,76,20,nan
Stimme,02B3Q,2,Friedrichshain-Kreuzberg,3Q,B,023Q,3,83,W,0,0,0,0,85,85,0,85,50,35,nan
Stimme,02B3R,2,Friedrichshain-Kreuzberg,3R,B,023R,3,83,W,0,0,0,0,178,178,0,178,158,20,nan
Stimme,02B3S,2,Friedrichshain-Kreuzberg,3S,B,023S,3,83,W,0,0,0,0,128,128,0,128,100,28,nan
Stimme,02B3T,2,Friedrichshain-Kreuzberg,3T,B,023T,3,83,W,0,0,0,0,177,177,1,176,150,26,nan
Stimme,02B3U,2,Friedrichshain-Kreuzberg,3U,B,023U,3,83,W,0,0,0,0,159,159,0,159,145,14,nan
Stimme,02B3V,2,Friedrichshain-Kreuzberg,3V,B,023V,3,83,W,0,0,0,0,108,108,0,108,90,18,nan
Stimme,02B3W,2,Friedrichshain-Kreuzberg,3W,B,023W,3,83,W,0,0,0,0,99,99,0,99,84,15,nan
Stimme,02B3X,2,Friedrichshain-Kreuzberg,3X,B,023X,3,83,W,0,0,0,0,155,155,0,155,125,30,nan
Stimme,02B3Y,2,Friedrichshain-Kreuzberg,3Y,B,023Y,3,83,W,0,0,0,0,188,188,1,187,152,35,nan
Stimme,02B3Z,2,Friedrichshain-Kreuzberg,3Z,B,023Z,3,83,W,0,0,0,0,127,127,0,127,94,33,nan
Stimme,02B4A,2,Friedrichshain-Kreuzberg,4A,B,024A,4,83,O,0,0,0,0,129,129,1,128,67,61,nan
Stimme,02B4AA,2,Friedrichshain-Kreuzberg,4AA,B,024AA,4,83,O,0,0,0,0,246,246,0,246,193,53,nan
Stimme,02B4AB,2,Friedrichshain-Kreuzberg,4AB,B,024AB,4,83,O,0,0,0,0,241,241,0,241,180,61,nan
Stimme,02B4AC,2,Friedrichshain-Kreuzberg,4AC,B,024AC,4,83,O,0,0,0,0,184,184,0,184,129,55,nan
Stimme,02B4B,2,Friedrichshain-Kreuzberg,4B,B,024B,4,83,O,0,0,0,0,157,157,0,157,77,80,nan
Stimme,02B4C,2,Friedrichshain-Kreuzberg,4C,B,024C,4,83,O,0,0,0,0,151,151,0,151,75,76,nan
Stimme,02B4D,2,Friedrichshain-Kreuzberg,4D,B,024D,4,83,O,0,0,0,0,167,167,1,166,87,79,nan
Stimme,02B4E,2,Friedrichshain-Kreuzberg,4E,B,024E,4,83,O,0,0,0,0,185,185,0,185,117,68,nan
Stimme,02B4F,2,Friedrichshain-Kreuzberg,4F,B,024F,4,83,O,0,0,0,0,170,170,0,170,123,47,nan
Stimme,02B4G,2,Friedrichshain-Kreuzberg,4G,B,024G,4,83,O,0,0,0,0,135,135,0,135,95,40,nan
Stimme,02B4H,2,Friedrichshain-Kreuzberg,4H,B,024H,4,83,O,0,0,0,0,194,194,0,194,134,60,nan
Stimme,02B4J,2,Friedrichshain-Kreuzberg,4J,B,024J,4,83,O,0,0,0,0,189,189,0,189,115,74,nan
Stimme,02B4K,2,Friedrichshain-Kreuzberg,4K,B,024K,4,83,O,0,0,0,0,252,252,0,252,177,75,nan
Stimme,02B4L,2,Friedrichshain-Kreuzberg,4L,B,024L,4,83,O,0,0,0,0,160,160,0,160,85,75,nan
Stimme,02B4M,2,Friedrichshain-Kreuzberg,4M,B,024M,4,83,O,0,0,0,0,173,173,0,173,123,50,nan
Stimme,02B4N,2,Friedrichshain-Kreuzberg,4N,B,024N,4,83,O,0,0,0,0,189,189,0,189,147,42,nan
Stimme,02B4P,2,Friedrichshain-Kreuzberg,4P,B,024P,4,83,O,0,0,0,0,190,190,1,189,130,59,nan
Stimme,02B4Q,2,Friedrichshain-Kreuzberg,4Q,B,024Q,4,83,O,0,0,0,0,219,219,0,219,161,58,nan
Stimme,02B4R,2,Friedrichshain-Kreuzberg,4R,B,024R,4,83,O,0,0,0,0,233,233,1,232,137,95,nan
Stimme,02B4S,2,Friedrichshain-Kreuzberg,4S,B,024S,4,83,O,0,0,0,0,166,166,0,166,113,53,nan
Stimme,02B4T,2,Friedrichshain-Kreuzberg,4T,B,024T,4,83,O,0,0,0,0,142,142,0,142,68,74,nan
Stimme,02B4U,2,Friedrichshain-Kreuzberg,4U,B,024U,4,83,O,0,0,0,0,186,186,2,184,102,82,nan
Stimme,02B4V,2,Friedrichshain-Kreuzberg,4V,B,024V,4,83,O,0,0,0,0,102,102,1,101,51,50,nan
Stimme,02B4W,2,Friedrichshain-Kreuzberg,4W,B,024W,4,83,O,0,0,0,0,108,108,0,108,53,55,nan
Stimme,02B4X,2,Friedrichshain-Kreuzberg,4X,B,024X,4,83,O,0,0,0,0,135,135,0,135,89,46,nan
Stimme,02B4Y,2,Friedrichshain-Kreuzberg,4Y,B,024Y,4,83,O,0,0,0,0,141,141,0,141,77,64,nan
Stimme,02B4Z,2,Friedrichshain-Kreuzberg,4Z,B,024Z,4,83,O,0,0,0,0,153,153,0,153,94,59,nan
Stimme,02B5A,2,Friedrichshain-Kreuzberg,5A,B,025A,5,83,O,0,0,0,0,163,163,0,163,136,27,nan
Stimme,02B5AA,2,Friedrichshain-Kreuzberg,5AA,B,025AA,5,83,O,0,0,0,0,198,198,0,198,158,40,nan
Stimme,02B5B,2,Friedrichshain-Kreuzberg,5B,B,025B,5,83,O,0,0,0,0,266,266,0,266,197,69,nan
Stimme,02B5C,2,Friedrichshain-Kreuzberg,5C,B,025C,5,83,O,0,0,0,0,233,233,0,233,179,54,nan
Stimme,02B5D,2,Friedrichshain-Kreuzberg,5D,B,025D,5,83,O,0,0,0,0,214,214,1,213,172,41,nan
Stimme,02B5E,2,Friedrichshain-Kreuzberg,5E,B,025E,5,83,O,0,0,0,0,275,275,0,275,230,45,nan
Stimme,02B5F,2,Friedrichshain-Kreuzberg,5F,B,025F,5,83,O,0,0,0,0,213,213,0,213,171,42,nan
Stimme,02B5G,2,Friedrichshain-Kreuzberg,5G,B,025G,5,83,O,0,0,0,0,275,275,0,275,224,51,nan
Stimme,02B5H,2,Friedrichshain-Kreuzberg,5H,B,025H,5,83,O,0,0,0,0,193,193,0,193,144,49,nan
Stimme,02B5J,2,Friedrichshain-Kreuzberg,5J,B,025J,5,83,O,0,0,0,0,171,171,0,171,140,31,nan
Stimme,02B5K,2,Friedrichshain-Kreuzberg,5K,B,025K,5,83,O,0,0,0,0,168,168,0,168,139,29,nan
Stimme,02B5L,2,Friedrichshain-Kreuzberg,5L,B,025L,5,83,O,0,0,0,0,364,364,1,363,292,71,nan
Stimme,02B5M,2,Friedrichshain-Kreuzberg,5M,B,025M,5,83,O,0,0,0,0,253,253,0,253,219,34,nan
Stimme,02B5N,2,Friedrichshain-Kreuzberg,5N,B,025N,5,83,O,0,0,0,0,184,184,0,184,152,32,nan
Stimme,02B5P,2,Friedrichshain-Kreuzberg,5P,B,025P,5,83,O,0,0,0,0,213,213,1,212,177,35,nan
Stimme,02B5Q,2,Friedrichshain-Kreuzberg,5Q,B,025Q,5,83,O,0,0,0,0,210,210,2,208,154,54,nan
Stimme,02B5R,2,Friedrichshain-Kreuzberg,5R,B,025R,5,83,O,0,0,0,0,244,244,1,243,189,54,nan
Stimme,02B5S,2,Friedrichshain-Kreuzberg,5S,B,025S,5,83,O,0,0,0,0,279,279,0,279,212,67,nan
Stimme,02B5T,2,Friedrichshain-Kreuzberg,5T,B,025T,5,83,O,0,0,0,0,237,237,0,237,180,57,nan
Stimme,02B5U,2,Friedrichshain-Kreuzberg,5U,B,025U,5,83,O,0,0,0,0,237,237,0,237,180,57,nan
Stimme,02B5V,2,Friedrichshain-Kreuzberg,5V,B,025V,5,83,O,0,0,0,0,204,204,0,204,159,45,nan
Stimme,02B5W,2,Friedrichshain-Kreuzberg,5W,B,025W,5,83,O,0,0,0,0,227,227,0,227,179,48,nan
Stimme,02B5X,2,Friedrichshain-Kreuzberg,5X,B,025X,5,83,O,0,0,0,0,169,169,0,169,130,39,nan
Stimme,02B5Y,2,Friedrichshain-Kreuzberg,5Y,B,025Y,5,83,O,0,0,0,0,161,161,1,160,119,41,nan
Stimme,02B5Z,2,Friedrichshain-Kreuzberg,5Z,B,025Z,5,83,O,0,0,0,0,162,162,1,161,131,30,nan
Stimme,02B6A,2,Friedrichshain-Kreuzberg,6A,B,026A,6,83,O,0,0,0,0,230,230,0,230,164,66,nan
Stimme,02B6AA,2,Friedrichshain-Kreuzberg,6AA,B,026AA,6,83,O,0,0,0,0,349,349,0,349,290,59,nan
Stimme,02B6AB,2,Friedrichshain-Kreuzberg,6AB,B,026AB,6,83,O,0,0,0,0,221,221,0,221,155,66,nan
Stimme,02B6B,2,Friedrichshain-Kreuzberg,6B,B,026B,6,83,O,0,0,0,0,188,188,0,188,111,77,nan
Stimme,02B6C,2,Friedrichshain-Kreuzberg,6C,B,026C,6,83,O,0,0,0,0,207,207,0,207,164,43,nan
Stimme,02B6D,2,Friedrichshain-Kreuzberg,6D,B,026D,6,83,O,0,0,0,0,129,129,1,128,80,48,nan
Stimme,02B6E,2,Friedrichshain-Kreuzberg,6E,B,026E,6,83,O,0,0,0,0,235,235,6,229,191,38,nan
Stimme,02B6F,2,Friedrichshain-Kreuzberg,6F,B,026F,6,83,O,0,0,0,0,160,160,0,160,130,30,nan
Stimme,02B6G,2,Friedrichshain-Kreuzberg,6G,B,026G,6,83,O,0,0,0,0,315,315,0,315,240,75,nan
Stimme,02B6H,2,Friedrichshain-Kreuzberg,6H,B,026H,6,83,O,0,0,0,0,247,247,0,247,207,40,nan
Stimme,02B6J,2,Friedrichshain-Kreuzberg,6J,B,026J,6,83,O,0,0,0,0,232,232,0,232,189,43,nan
Stimme,02B6K,2,Friedrichshain-Kreuzberg,6K,B,026K,6,83,O,0,0,0,0,235,235,0,235,174,61,nan
Stimme,02B6L,2,Friedrichshain-Kreuzberg,6L,B,026L,6,83,O,0,0,0,0,214,214,0,214,178,36,nan
Stimme,02B6M,2,Friedrichshain-Kreuzberg,6M,B,026M,6,83,O,0,0,0,0,212,212,0,212,171,41,nan
Stimme,02B6N,2,Friedrichshain-Kreuzberg,6N,B,026N,6,83,O,0,0,0,0,305,305,1,304,255,49,nan
Stimme,02B6P,2,Friedrichshain-Kreuzberg,6P,B,026P,6,83,O,0,0,0,0,226,226,0,226,180,46,nan
Stimme,02B6Q,2,Friedrichshain-Kreuzberg,6Q,B,026Q,6,83,O,0,0,0,0,126,126,0,126,99,27,nan
Stimme,02B6R,2,Friedrichshain-Kreuzberg,6R,B,026R,6,83,O,0,0,0,0,202,202,1,201,164,37,nan
Stimme,02B6S,2,Friedrichshain-Kreuzberg,6S,B,026S,6,83,O,0,0,0,0,235,235,0,235,194,41,nan
Stimme,02B6T,2,Friedrichshain-Kreuzberg,6T,B,026T,6,83,O,0,0,0,0,174,174,0,174,151,23,nan
Stimme,02B6U,2,Friedrichshain-Kreuzberg,6U,B,026U,6,83,O,0,0,0,0,167,167,0,167,137,30,nan
Stimme,02B6V,2,Friedrichshain-Kreuzberg,6V,B,026V,6,83,O,0,0,0,0,223,223,1,222,181,41,nan
Stimme,02B6W,2,Friedrichshain-Kreuzberg,6W,B,026W,6,83,O,0,0,0,0,180,180,0,180,153,27,nan
Stimme,02B6X,2,Friedrichshain-Kreuzberg,6X,B,026X,6,83,O,0,0,0,0,199,199,0,199,170,29,nan
Stimme,02B6Y,2,Friedrichshain-Kreuzberg,6Y,B,026Y,6,83,O,0,0,0,0,206,206,0,206,169,37,nan
Stimme,02B6Z,2,Friedrichshain-Kreuzberg,6Z,B,026Z,6,83,O,0,0,0,0,214,214,0,214,165,49,nan
Stimme,03W100,3,Pankow,100,W,031A,1,76,O,1364,1107,257,0,299,3,0,299,164,135,nan
Stimme,03W101,3,Pankow,101,W,031A,1,76,O,880,692,188,0,157,4,1,156,72,84,nan
Stimme,03W102,3,Pankow,102,W,031B,1,76,O,1667,1312,355,0,284,7,1,283,121,162,nan
Stimme,03W103,3,Pankow,103,W,031C,1,76,O,1515,1365,150,0,158,0,1,157,44,113,nan
Stimme,03W104,3,Pankow,104,W,031D,1,76,O,1449,1264,185,0,148,0,0,148,53,95,nan
Stimme,03W105,3,Pankow,105,W,031D,1,76,O,1043,926,117,0,225,3,3,222,72,150,nan
Stimme,03W106,3,Pankow,106,W,031E,1,76,O,1295,1197,98,0,131,0,0,131,31,100,nan
Stimme,03W107,3,Pankow,107,W,031E,1,76,O,878,803,75,0,153,0,1,152,39,113,nan
Stimme,03W108,3,Pankow,108,W,031C,1,76,O,1326,1218,108,0,203,2,0,203,74,129,nan
Stimme,03W109,3,Pankow,109,W,031G,1,76,O,1455,1171,284,0,338,1,0,338,78,260,nan
Stimme,03W110,3,Pankow,110,W,031G,1,76,O,1404,1225,179,0,231,1,1,230,87,143,nan
Stimme,03W111,3,Pankow,111,W,031I,1,76,O,1366,1091,275,0,268,3,0,268,75,193,nan
Stimme,03W112,3,Pankow,112,W,031I,1,76,O,1169,953,216,0,241,0,1,240,83,157,nan
Stimme,03W113,3,Pankow,113,W,031K,1,76,O,1483,1128,355,0,338,3,2,336,103,233,nan
Stimme,03W114,3,Pankow,114,W,031K,1,76,O,998,730,268,0,272,7,2,270,75,195,nan
Stimme,03W115,3,Pankow,115,W,031H,1,76,O,987,784,203,0,272,7,1,271,100,171,nan
Stimme,03W116,3,Pankow,116,W,031F,1,76,O,1548,1280,268,0,296,5,1,295,90,205,nan
Stimme,03W117,3,Pankow,117,W,031F,1,76,O,1379,1183,196,0,223,4,1,222,65,157,nan
Stimme,03W118,3,Pankow,118,W,031H,1,76,O,1365,993,372,0,328,2,1,327,117,210,nan
Stimme,03W119,3,Pankow,119,W,031L,1,76,O,1399,1116,283,0,258,3,0,258,56,202,nan
Stimme,03W120,3,Pankow,120,W,031N,1,76,O,1157,915,242,0,279,9,0,279,85,194,nan
Stimme,03W121,3,Pankow,121,W,031N,1,76,O,1259,946,313,0,286,10,2,284,90,194,nan
Stimme,03W122,3,Pankow,122,W,031M,1,76,O,1262,941,321,0,342,1,0,342,95,247,nan
Stimme,03W123,3,Pankow,123,W,031L,1,76,O,1282,1064,218,0,354,3,0,354,102,252,nan
Stimme,03W124,3,Pankow,124,W,031H,1,76,O,1105,863,242,0,317,4,0,317,116,201,nan
Stimme,03W125,3,Pankow,125,W,031M,1,76,O,1276,1023,253,0,347,0,0,347,69,278,nan
Stimme,03W126,3,Pankow,126,W,031N,1,76,O,1090,880,210,0,274,2,0,274,66,208,nan
Stimme,03W200,3,Pankow,200,W,032D,2,76,O,1399,1048,351,0,366,8,0,366,116,250,nan
Stimme,03W201,3,Pankow,201,W,032A,2,76,O,635,559,76,0,231,0,1,230,21,209,nan
Stimme,03W202,3,Pankow,202,W,032A,2,76,O,853,715,138,0,248,1,1,247,76,171,nan
Stimme,03W203,3,Pankow,203,W,032B,2,76,O,1358,1139,219,0,247,3,0,247,61,186,nan
Stimme,03W204,3,Pankow,204,W,032C,2,76,O,1152,947,205,0,190,2,0,190,47,143,nan
Stimme,03W205,3,Pankow,205,W,032C,2,76,O,1423,1119,304,0,261,6,1,260,76,184,nan
Stimme,03W206,3,Pankow,206,W,032D,2,76,O,1426,1123,303,0,322,1,0,322,101,221,nan
Stimme,03W207,3,Pankow,207,W,032F,2,76,O,1204,1010,194,0,258,2,1,257,91,166,nan
Stimme,03W208,3,Pankow,208,W,032L,2,76,O,1453,1175,278,0,257,3,2,255,88,167,nan
Stimme,03W209,3,Pankow,209,W,032K,2,76,O,1500,1200,300,0,311,7,1,310,140,170,nan
Stimme,03W210,3,Pankow,210,W,032M,2,76,O,1207,897,310,0,261,7,1,260,123,137,nan
Stimme,03W211,3,Pankow,211,W,032F,2,76,O,1405,1035,370,0,324,6,0,324,123,201,nan
Stimme,03W212,3,Pankow,212,W,032G,2,76,O,1419,1075,344,0,319,1,1,318,191,127,nan
Stimme,03W213,3,Pankow,213,W,032H,2,76,O,1476,1126,350,0,380,6,3,377,203,174,nan
Stimme,03W214,3,Pankow,214,W,032H,2,76,O,1393,998,395,0,277,9,1,276,152,124,nan
Stimme,03W215,3,Pankow,215,W,032E,2,76,O,1333,1072,261,0,273,3,0,273,68,205,nan
Stimme,03W216,3,Pankow,216,W,032I,2,76,O,1520,1190,330,0,296,1,1,295,127,168,nan
Stimme,03W217,3,Pankow,217,W,032I,2,76,O,1358,1096,262,0,313,4,2,311,149,162,nan
Stimme,03W218,3,Pankow,218,W,032E,2,76,O,1217,960,257,0,259,3,1,258,99,159,nan
Stimme,03W219,3,Pankow,219,W,032K,2,76,O,1455,1165,290,0,339,2,0,339,127,212,nan
Stimme,03W220,3,Pankow,220,W,032N,2,76,O,1443,1063,380,0,358,4,4,354,188,166,nan
Stimme,03W221,3,Pankow,221,W,032M,2,76,O,1225,877,348,0,260,3,0,260,113,147,nan
Stimme,03W222,3,Pankow,222,W,032B,2,76,O,1310,1125,185,0,271,3,0,271,71,200,nan
Stimme,03W223,3,Pankow,223,W,032G,2,76,O,1351,1041,310,0,307,4,0,307,110,197,nan
Stimme,03W224,3,Pankow,224,W,032L,2,76,O,1209,893,316,0,266,6,1,265,121,144,nan
Stimme,03W300,3,Pankow,300,W,033A,3,76,O,1296,966,330,0,262,1,0,262,87,175,nan
Stimme,03W301,3,Pankow,301,W,033A,3,76,O,1322,1003,319,0,328,5,1,327,148,179,nan
Stimme,03W302,3,Pankow,302,W,033E,3,76,O,1529,1320,209,0,206,1,3,203,87,116,nan
Stimme,03W303,3,Pankow,303,W,033C,3,76,O,1335,1142,193,0,168,0,0,168,61,107,nan
Stimme,03W304,3,Pankow,304,W,033B,3,76,O,1341,1109,232,0,295,2,0,295,105,190,nan
Stimme,03W305,3,Pankow,305,W,033B,3,76,O,1459,1165,294,0,359,11,4,355,180,175,nan
Stimme,03W306,3,Pankow,306,W,033D,3,76,O,1784,1351,433,0,389,6,1,388,197,191,nan
Stimme,03W307,3,Pankow,307,W,033E,3,76,O,1373,1088,285,0,326,4,0,326,191,135,nan
Stimme,03W308,3,Pankow,308,W,033F,3,76,O,1441,1126,315,0,331,3,1,330,189,141,nan
Stimme,03W309,3,Pankow,309,W,033I,3,76,O,1337,1029,308,0,314,2,3,311,192,119,nan
Stimme,03W310,3,Pankow,310,W,033I,3,76,O,1395,1102,293,0,338,5,0,338,226,112,nan
Stimme,03W311,3,Pankow,311,W,033D,3,76,O,1535,1129,406,0,325,9,0,325,222,103,nan
Stimme,03W312,3,Pankow,312,W,033H,3,76,O,1385,1070,315,0,383,3,0,383,284,99,nan
Stimme,03W313,3,Pankow,313,W,033G,3,76,O,1432,1089,343,0,374,2,3,371,213,158,nan
Stimme,03W314,3,Pankow,314,W,033K,3,76,O,1443,1083,360,0,289,5,0,289,223,66,nan
Stimme,03W315,3,Pankow,315,W,033K,3,76,O,1192,914,278,0,355,1,2,353,264,89,nan
Stimme,03W316,3,Pankow,316,W,033M,3,76,O,1255,941,314,0,323,4,2,321,225,96,nan
Stimme,03W317,3,Pankow,317,W,033L,3,76,O,1654,1219,435,0,405,5,1,404,304,100,nan
Stimme,03W318,3,Pankow,318,W,033M,3,76,O,1203,924,279,0,313,6,2,311,238,73,nan
Stimme,03W319,3,Pankow,319,W,033C,3,76,O,1413,1170,243,0,263,1,0,263,127,136,nan
Stimme,03W320,3,Pankow,320,W,033G,3,76,O,1310,1020,290,0,289,7,3,286,194,92,nan
Stimme,03W321,3,Pankow,321,W,033F,3,76,O,1292,1060,232,0,317,3,1,316,171,145,nan
Stimme,03W322,3,Pankow,322,W,033H,3,76,O,1216,903,313,0,328,3,0,328,236,92,nan
Stimme,03W323,3,Pankow,323,W,033L,3,76,O,1109,796,313,0,279,3,0,279,194,85,nan
Stimme,03W400,3,Pankow,400,W,034C,4,76,O,1569,1279,290,0,267,3,0,267,111,156,nan
Stimme,03W401,3,Pankow,401,W,034E,4,76,O,1411,1229,182,0,288,3,3,285,132,153,nan
Stimme,03W402,3,Pankow,402,W,034E,4,76,O,1445,1168,277,0,304,2,3,301,127,174,nan
Stimme,03W403,3,Pankow,403,W,034F,4,76,O,1504,1178,326,0,315,5,2,313,195,118,nan
Stimme,03W404,3,Pankow,404,W,034H,4,76,O,1505,1199,306,0,364,3,1,363,230,133,nan
Stimme,03W405,3,Pankow,405,W,034G,4,76,O,1542,1298,244,0,270,6,1,269,139,130,nan
Stimme,03W406,3,Pankow,406,W,034I,4,76,O,1717,1463,254,0,273,3,2,271,134,137,nan
Stimme,03W407,3,Pankow,407,W,034L,4,76,O,1475,1256,219,0,246,2,1,245,77,168,nan
Stimme,03W408,3,Pankow,408,W,034K,4,76,O,1665,1445,220,0,256,0,0,256,94,162,nan
Stimme,03W409,3,Pankow,409,W,034D,4,76,O,1605,1274,331,0,310,1,2,308,119,189,nan
Stimme,03W410,3,Pankow,410,W,034G,4,76,O,1292,1047,245,0,248,5,0,248,146,102,nan
Stimme,03W411,3,Pankow,411,W,034D,4,76,O,1633,1255,378,0,329,1,0,329,88,241,nan
Stimme,03W412,3,Pankow,412,W,034C,4,76,O,1512,1135,377,0,358,6,1,357,119,238,nan
Stimme,03W413,3,Pankow,413,W,034B,4,76,O,1455,1097,358,0,353,3,0,353,81,272,nan
Stimme,03W414,3,Pankow,414,W,034B,4,76,O,1496,1056,440,0,401,6,0,401,92,309,nan
Stimme,03W415,3,Pankow,415,W,034A,4,76,O,1369,1078,291,0,327,2,1,326,74,252,nan
Stimme,03W416,3,Pankow,416,W,034F,4,76,O,1324,1047,277,0,268,5,1,267,127,140,nan
Stimme,03W417,3,Pankow,417,W,034K,4,76,O,1546,1264,282,0,208,0,0,208,77,131,nan
Stimme,03W418,3,Pankow,418,W,034A,4,76,O,1420,1175,245,0,309,5,0,309,78,231,nan
Stimme,03W500,3,Pankow,500,W,035E,5,76,O,1322,1001,321,0,273,6,0,273,165,108,nan
Stimme,03W501,3,Pankow,501,W,035G,5,76,O,1655,1301,354,0,334,3,1,333,165,168,nan
Stimme,03W502,3,Pankow,502,W,035E,5,76,O,1300,984,316,0,337,7,2,335,223,112,nan
Stimme,03W503,3,Pankow,503,W,035H,5,76,O,1358,1073,285,0,328,8,1,327,208,119,nan
Stimme,03W504,3,Pankow,504,W,035I,5,76,O,1376,1042,334,0,366,9,2,364,271,93,nan
Stimme,03W505,3,Pankow,505,W,035K,5,76,O,1390,1121,269,0,281,2,1,280,180,100,nan
Stimme,03W506,3,Pankow,506,W,035M,5,76,O,1710,1247,463,0,333,7,1,332,212,120,nan
Stimme,03W507,3,Pankow,507,W,035L,5,76,O,1570,1254,316,0,288,7,3,285,149,136,nan
Stimme,03W508,3,Pankow,508,W,035I,5,76,O,1427,1138,289,0,282,4,1,281,156,125,nan
Stimme,03W509,3,Pankow,509,W,035F,5,76,O,1460,1126,334,0,232,4,3,229,120,109,nan
Stimme,03W510,3,Pankow,510,W,035F,5,76,O,1439,1117,322,0,291,2,0,291,124,167,nan
Stimme,03W511,3,Pankow,511,W,035D,5,76,O,1328,1022,306,0,320,6,1,319,215,104,nan
Stimme,03W512,3,Pankow,512,W,035D,5,76,O,1427,1186,241,0,302,3,2,300,157,143,nan
Stimme,03W513,3,Pankow,513,W,035C,5,76,O,1416,1159,257,0,343,4,1,342,174,168,nan
Stimme,03W514,3,Pankow,514,W,035A,5,76,O,1459,1219,240,0,229,1,0,229,112,117,nan
Stimme,03W515,3,Pankow,515,W,035B,5,76,O,1498,1168,330,0,344,7,1,343,148,195,nan
Stimme,03W516,3,Pankow,516,W,035B,5,76,O,1618,1252,366,0,416,9,5,411,139,272,nan
Stimme,03W517,3,Pankow,517,W,035A,5,76,O,1414,1149,265,0,372,4,0,372,106,266,nan
Stimme,03W518,3,Pankow,518,W,035C,5,76,O,1251,999,252,0,270,7,0,270,182,88,nan
Stimme,03W519,3,Pankow,519,W,035H,5,76,O,1351,1066,285,0,289,7,0,289,193,96,nan
Stimme,03W520,3,Pankow,520,W,035K,5,76,O,1361,1022,339,0,297,6,0,297,201,96,nan
Stimme,03W600,3,Pankow,600,W,036A,6,76,O,1194,883,311,0,315,9,1,314,239,75,nan
Stimme,03W601,3,Pankow,601,W,036A,6,76,O,1304,1001,303,0,226,1,0,226,167,59,nan
Stimme,03W602,3,Pankow,602,W,036D,6,76,O,1499,1084,415,0,333,8,2,331,249,82,nan
Stimme,03W603,3,Pankow,603,W,036C,6,76,O,1137,878,259,0,302,2,1,301,216,85,nan
Stimme,03W604,3,Pankow,604,W,036C,6,76,O,1384,1045,339,0,406,4,0,406,307,99,nan
Stimme,03W605,3,Pankow,605,W,036B,6,76,O,1122,850,272,0,300,7,0,300,243,57,nan
Stimme,03W606,3,Pankow,606,W,036E,6,76,O,1225,918,307,0,322,11,2,320,245,75,nan
Stimme,03W607,3,Pankow,607,W,036F,6,76,O,1365,1042,323,0,360,11,2,358,297,61,nan
Stimme,03W608,3,Pankow,608,W,036G,6,76,O,1576,1179,397,0,423,9,1,422,362,60,nan
Stimme,03W609,3,Pankow,609,W,036H,6,76,O,938,730,208,0,217,6,1,216,163,53,nan
Stimme,03W610,3,Pankow,610,W,036I,6,76,O,1090,856,234,0,297,9,1,296,205,91,nan
Stimme,03W611,3,Pankow,611,W,036H,6,76,O,1239,942,297,0,272,6,0,272,206,66,nan
Stimme,03W612,3,Pankow,612,W,036I,6,76,O,1324,1003,321,0,343,15,0,343,270,73,nan
Stimme,03W613,3,Pankow,613,W,036N,6,76,O,1481,1116,365,0,358,7,1,357,276,81,nan
Stimme,03W614,3,Pankow,614,W,036K,6,76,O,1190,851,339,0,315,6,1,314,256,58,nan
Stimme,03W615,3,Pankow,615,W,036N,6,76,O,899,680,219,0,242,6,0,242,207,35,nan
Stimme,03W616,3,Pankow,616,W,036M,6,76,O,772,618,154,0,195,5,0,195,157,38,nan
Stimme,03W617,3,Pankow,617,W,036M,6,76,O,1577,1221,356,0,387,13,0,387,315,72,nan
Stimme,03W618,3,Pankow,618,W,036P,6,76,O,813,609,204,0,209,5,2,207,167,40,nan
Stimme,03W619,3,Pankow,619,W,036L,6,76,O,944,714,230,0,233,8,2,231,179,52,nan
Stimme,03W620,3,Pankow,620,W,036L,6,76,O,1404,1039,365,0,367,13,0,367,295,72,nan
Stimme,03W621,3,Pankow,621,W,036B,6,76,O,1291,937,354,0,271,10,1,270,199,71,nan
Stimme,03W622,3,Pankow,622,W,036P,6,76,O,1190,911,279,0,263,3,1,262,216,46,nan
Stimme,03W623,3,Pankow,623,W,036K,6,76,O,1190,918,272,0,326,4,0,326,253,73,nan
Stimme,03W624,3,Pankow,624,W,036E,6,76,O,1352,972,380,0,343,4,2,341,279,62,nan
Stimme,03W700,3,Pankow,700,W,037C,7,76,O,1239,974,265,0,308,6,1,307,231,76,nan
Stimme,03W701,3,Pankow,701,W,037A,7,76,O,1353,1078,275,0,271,0,0,271,172,99,nan
Stimme,03W702,3,Pankow,702,W,037A,7,76,O,1105,873,232,0,270,3,1,269,161,108,nan
Stimme,03W703,3,Pankow,703,W,037B,7,76,O,1353,1060,293,0,299,7,1,298,189,109,nan
Stimme,03W704,3,Pankow,704,W,037C,7,76,O,1332,1153,179,0,271,5,0,271,161,110,nan
Stimme,03W705,3,Pankow,705,W,037D,7,76,O,1101,876,225,0,279,5,0,279,179,100,nan
Stimme,03W706,3,Pankow,706,W,037I,7,83,O,1332,1067,265,0,206,1,0,206,115,91,nan
Stimme,03W707,3,Pankow,707,W,037K,7,83,O,1453,1126,327,0,277,5,2,275,205,70,nan
Stimme,03W708,3,Pankow,708,W,037M,7,83,O,1338,1004,334,0,307,8,3,304,224,80,nan
Stimme,03W709,3,Pankow,709,W,037M,7,83,O,1458,1155,303,0,303,7,1,302,235,67,nan
Stimme,03W710,3,Pankow,710,W,037L,7,83,O,1555,1255,300,0,325,2,0,325,197,128,nan
Stimme,03W711,3,Pankow,711,W,037I,7,83,O,1459,1164,295,0,237,5,1,236,155,81,nan
Stimme,03W712,3,Pankow,712,W,037F,7,76,O,1492,1149,343,0,291,5,0,291,207,84,nan
Stimme,03W713,3,Pankow,713,W,037H,7,76,O,1157,830,327,0,297,9,2,295,234,61,nan
Stimme,03W714,3,Pankow,714,W,037G,7,76,O,1142,870,272,0,267,7,2,265,181,84,nan
Stimme,03W715,3,Pankow,715,W,037F,7,76,O,1053,840,213,0,254,0,0,254,173,81,nan
Stimme,03W716,3,Pankow,716,W,037E,7,76,O,1319,948,371,0,302,3,1,301,229,72,nan
Stimme,03W717,3,Pankow,717,W,037G,7,76,O,1275,944,331,0,274,5,0,274,193,81,nan
Stimme,03W718,3,Pankow,718,W,037B,7,76,O,1359,1083,276,0,332,9,2,330,220,110,nan
Stimme,03W719,3,Pankow,719,W,037D,7,76,O,1285,1042,243,0,285,8,2,283,196,87,nan
Stimme,03W720,3,Pankow,720,W,037H,7,76,O,1317,995,322,0,315,4,1,314,242,72,nan
Stimme,03W721,3,Pankow,721,W,037E,7,76,O,1112,866,246,0,256,13,1,255,178,77,nan
Stimme,03W722,3,Pankow,722,W,037K,7,83,O,995,766,229,0,214,6,0,214,138,76,nan
Stimme,03W800,3,Pankow,800,W,038I,8,83,O,1663,1412,251,0,329,7,2,327,153,174,nan
Stimme,03W801,3,Pankow,801,W,038K,8,83,O,1018,814,204,0,242,8,1,241,188,53,nan
Stimme,03W802,3,Pankow,802,W,038I,8,83,O,1126,833,293,0,279,6,4,275,218,57,nan
Stimme,03W803,3,Pankow,803,W,038K,8,83,O,1277,969,308,0,356,11,1,355,274,81,nan
Stimme,03W804,3,Pankow,804,W,038M,8,83,O,768,606,162,0,221,1,0,221,170,51,nan
Stimme,03W805,3,Pankow,805,W,038L,8,83,O,827,630,197,0,217,3,1,216,181,35,nan
Stimme,03W806,3,Pankow,806,W,038M,8,83,O,1342,988,354,0,329,7,0,329,268,61,nan
Stimme,03W807,3,Pankow,807,W,038N,8,83,O,1038,771,267,0,303,10,0,303,243,60,nan
Stimme,03W808,3,Pankow,808,W,038P,8,83,O,1165,857,308,0,270,5,0,270,217,53,nan
Stimme,03W809,3,Pankow,809,W,038P,8,83,O,1196,1006,190,0,218,2,1,217,111,106,nan
Stimme,03W810,3,Pankow,810,W,038L,8,83,O,1329,965,364,0,306,9,2,304,247,57,nan
Stimme,03W811,3,Pankow,811,W,038F,8,76,O,1383,1032,351,0,309,8,0,309,222,87,nan
Stimme,03W812,3,Pankow,812,W,038E,8,76,O,1151,859,292,0,280,9,1,279,202,77,nan
Stimme,03W813,3,Pankow,813,W,038E,8,76,O,1117,863,254,0,258,5,1,257,179,78,nan
Stimme,03W814,3,Pankow,814,W,038G,8,76,O,1514,1181,333,0,394,0,0,394,318,76,nan
Stimme,03W815,3,Pankow,815,W,038D,8,76,O,1567,1156,411,0,414,0,1,413,338,75,nan
Stimme,03W816,3,Pankow,816,W,038A,8,76,O,1001,783,218,0,280,6,0,280,221,59,nan
Stimme,03W817,3,Pankow,817,W,038A,8,76,O,1287,949,338,0,272,8,2,270,206,64,nan
Stimme,03W818,3,Pankow,818,W,038C,8,76,O,1290,941,349,0,249,4,1,248,192,56,nan
Stimme,03W819,3,Pankow,819,W,038C,8,76,O,959,730,229,0,213,6,0,213,180,33,nan
Stimme,03W820,3,Pankow,820,W,038B,8,76,O,1132,848,284,0,279,2,0,279,221,58,nan
Stimme,03W821,3,Pankow,821,W,038F,8,76,O,1070,830,240,0,268,7,2,266,215,51,nan
Stimme,03W822,3,Pankow,822,W,038H,8,76,O,1255,921,334,0,251,9,1,250,176,74,nan
Stimme,03W823,3,Pankow,823,W,038B,8,76,O,1294,1005,289,0,359,9,2,357,265,92,nan
Stimme,03W900,3,Pankow,900,W,039C,9,76,O,1264,963,301,0,320,4,2,318,193,125,nan
Stimme,03W901,3,Pankow,901,W,039A,9,76,O,1314,1065,249,0,357,9,1,356,238,118,nan
Stimme,03W902,3,Pankow,902,W,039C,9,76,O,1378,1194,184,0,317,1,0,317,134,183,nan
Stimme,03W903,3,Pankow,903,W,039B,9,76,O,1276,984,292,0,319,16,1,318,218,100,nan
Stimme,03W904,3,Pankow,904,W,039B,9,76,O,1341,1034,307,0,359,14,1,358,238,120,nan
Stimme,03W905,3,Pankow,905,W,039D,9,83,O,1240,1075,165,0,218,1,0,218,101,117,nan
Stimme,03W906,3,Pankow,906,W,039G,9,83,O,1032,859,173,0,177,2,0,177,59,118,nan
Stimme,03W907,3,Pankow,907,W,039F,9,83,O,1061,899,162,0,180,1,0,180,53,127,nan
Stimme,03W908,3,Pankow,908,W,039E,9,83,O,1469,1311,158,0,248,3,1,247,120,127,nan
Stimme,03W909,3,Pankow,909,W,039E,9,83,O,971,790,181,0,236,0,0,236,108,128,nan
Stimme,03W910,3,Pankow,910,W,039H,9,83,O,1076,975,101,0,128,3,1,127,70,57,nan
Stimme,03W911,3,Pankow,911,W,039P,9,83,O,1325,1085,240,0,258,6,1,257,173,84,nan
Stimme,03W912,3,Pankow,912,W,039H,9,83,O,1412,1115,297,0,280,5,0,280,187,93,nan
Stimme,03W913,3,Pankow,913,W,039I,9,83,O,864,689,175,0,177,3,2,175,105,70,nan
Stimme,03W914,3,Pankow,914,W,039L,9,83,O,1153,835,318,0,233,6,2,231,179,52,nan
Stimme,03W915,3,Pankow,915,W,039K,9,83,O,839,667,172,0,177,3,1,176,117,59,nan
Stimme,03W916,3,Pankow,916,W,039L,9,83,O,1290,951,339,0,339,14,2,337,261,76,nan
Stimme,03W917,3,Pankow,917,W,039N,9,83,O,1511,1098,413,0,363,12,1,362,285,77,nan
Stimme,03W918,3,Pankow,918,W,039M,9,83,O,1410,1021,389,0,344,10,2,342,271,71,nan
Stimme,03W919,3,Pankow,919,W,039M,9,83,O,1161,854,307,0,323,10,2,321,250,71,nan
Stimme,03W920,3,Pankow,920,W,039F,9,83,O,1084,922,162,0,163,0,0,163,55,108,nan
Stimme,03W921,3,Pankow,921,W,039G,9,83,O,1086,889,197,0,204,2,2,202,120,82,nan
Stimme,03W922,3,Pankow,922,W,039Q,9,83,O,1673,1170,503,0,461,16,1,460,314,146,nan
Stimme,03W923,3,Pankow,923,W,039D,9,83,O,602,545,57,0,49,1,1,48,23,25,nan
Stimme,03W924,3,Pankow,924,W,039I,9,83,O,1338,973,365,0,279,9,1,278,216,62,nan
Stimme,03W925,3,Pankow,925,W,039N,9,83,O,1253,932,321,0,268,12,0,268,198,70,nan
Stimme,03W926,3,Pankow,926,W,039K,9,83,O,1370,1078,292,0,318,16,1,317,229,88,nan
Stimme,03B1A,3,Pankow,1A,B,031A,1,76,O,0,0,0,0,997,997,1,996,392,604,nan
Stimme,03B1B,3,Pankow,1B,B,031B,1,76,O,0,0,0,0,797,797,4,793,248,545,nan
Stimme,03B1C,3,Pankow,1C,B,031C,1,76,O,0,0,0,0,656,656,0,656,204,452,nan
Stimme,03B1D,3,Pankow,1D,B,031D,1,76,O,0,0,0,0,805,805,3,802,238,564,nan
Stimme,03B1E,3,Pankow,1E,B,031E,1,76,O,0,0,0,0,584,584,0,584,218,366,nan
Stimme,03B1F,3,Pankow,1F,B,031F,1,76,O,0,0,0,0,783,783,3,780,254,526,nan
Stimme,03B1G,3,Pankow,1G,B,031G,1,76,O,0,0,0,0,0,0,0,0,0,0,03B1F
Stimme,03B1H,3,Pankow,1H,B,031H,1,76,O,0,0,0,0,709,709,1,708,213,495,nan
Stimme,03B1I,3,Pankow,1I,B,031I,1,76,O,0,0,0,0,0,0,0,0,0,0,03B1E
Stimme,03B1K,3,Pankow,1K,B,031K,1,76,O,0,0,0,0,0,0,0,0,0,0,03B1D
Stimme,03B1L,3,Pankow,1L,B,031L,1,76,O,0,0,0,0,0,0,0,0,0,0,03B1C
Stimme,03B1M,3,Pankow,1M,B,031M,1,76,O,0,0,0,0,0,0,0,0,0,0,03B1B
Stimme,03B1N,3,Pankow,1N,B,031N,1,76,O,0,0,0,0,0,0,0,0,0,0,03B1A
Stimme,03B2A,3,Pankow,2A,B,032A,2,76,O,0,0,0,0,1064,1064,0,1064,436,628,nan
Stimme,03B2B,3,Pankow,2B,B,032B,2,76,O,0,0,0,0,857,857,2,855,341,514,nan
Stimme,03B2C,3,Pankow,2C,B,032C,2,76,O,0,0,0,0,917,917,0,917,342,575,nan
Stimme,03B2D,3,Pankow,2D,B,032D,2,76,O,0,0,0,0,1082,1082,0,1082,406,676,nan
Stimme,03B2E,3,Pankow,2E,B,032E,2,76,O,0,0,0,0,1084,1084,1,1083,487,596,nan
Stimme,03B2F,3,Pankow,2F,B,032F,2,76,O,0,0,0,0,1029,1029,2,1027,443,584,nan
Stimme,03B2G,3,Pankow,2G,B,032G,2,76,O,0,0,0,0,0,0,0,0,0,0,03B2F
Stimme,03B2H,3,Pankow,2H,B,032H,2,76,O,0,0,0,0,0,0,0,0,0,0,03B2E
Stimme,03B2I,3,Pankow,2I,B,032I,2,76,O,0,0,0,0,0,0,0,0,0,0,03B2D
Stimme,03B2K,3,Pankow,2K,B,032K,2,76,O,0,0,0,0,0,0,0,0,0,0,03B2C
Stimme,03B2L,3,Pankow,2L,B,032L,2,76,O,0,0,0,0,0,0,0,0,0,0,03B2B
Stimme,03B2M,3,Pankow,2M,B,032M,2,76,O,0,0,0,0,0,0,0,0,0,0,03B2A
Stimme,03B2N,3,Pankow,2N,B,032N,2,76,O,0,0,0,0,0,0,0,0,0,0,03B2A
Stimme,03B3A,3,Pankow,3A,B,033A,3,76,O,0,0,0,0,1061,1061,0,1061,571,490,nan
Stimme,03B3B,3,Pankow,3B,B,033B,3,76,O,0,0,0,0,1081,1081,2,1079,698,381,nan
Stimme,03B3C,3,Pankow,3C,B,033C,3,76,O,0,0,0,0,1016,1016,1,1015,633,382,nan
Stimme,03B3D,3,Pankow,3D,B,033D,3,76,O,0,0,0,0,1184,1184,4,1180,754,426,nan
Stimme,03B3E,3,Pankow,3E,B,033E,3,76,O,0,0,0,0,967,967,1,966,580,386,nan
Stimme,03B3F,3,Pankow,3F,B,033F,3,76,O,0,0,0,0,981,981,4,977,575,402,nan
Stimme,03B3G,3,Pankow,3G,B,033G,3,76,O,0,0,0,0,0,0,0,0,0,0,03B3F
Stimme,03B3H,3,Pankow,3H,B,033H,3,76,O,0,0,0,0,0,0,0,0,0,0,03B3E
Stimme,03B3I,3,Pankow,3I,B,033I,3,76,O,0,0,0,0,0,0,0,0,0,0,03B3D
Stimme,03B3K,3,Pankow,3K,B,033K,3,76,O,0,0,0,0,0,0,0,0,0,0,03B3C
Stimme,03B3L,3,Pankow,3L,B,033L,3,76,O,0,0,0,0,0,0,0,0,0,0,03B3B
Stimme,03B3M,3,Pankow,3M,B,033M,3,76,O,0,0,0,0,0,0,0,0,0,0,03B3A
Stimme,03B4A,3,Pankow,4A,B,034A,4,76,O,0,0,0,0,686,686,0,686,246,440,nan
Stimme,03B4B,3,Pankow,4B,B,034B,4,76,O,0,0,0,0,1131,1131,2,1129,361,768,nan
Stimme,03B4C,3,Pankow,4C,B,034C,4,76,O,0,0,0,0,1048,1048,2,1046,486,560,nan
Stimme,03B4D,3,Pankow,4D,B,034D,4,76,O,0,0,0,0,1022,1022,24,998,433,565,nan
Stimme,03B4E,3,Pankow,4E,B,034E,4,76,O,0,0,0,0,888,888,3,885,497,388,nan
Stimme,03B4F,3,Pankow,4F,B,034F,4,76,O,0,0,0,0,0,0,0,0,0,0,03B4E
Stimme,03B4G,3,Pankow,4G,B,034G,4,76,O,0,0,0,0,0,0,0,0,0,0,03B4D
Stimme,03B4H,3,Pankow,4H,B,034H,4,76,O,0,0,0,0,0,0,0,0,0,0,03B4C
Stimme,03B4I,3,Pankow,4I,B,034I,4,76,O,0,0,0,0,0,0,0,0,0,0,03B4C
Stimme,03B4K,3,Pankow,4K,B,034K,4,76,O,0,0,0,0,0,0,0,0,0,0,03B4B
Stimme,03B4L,3,Pankow,4L,B,034L,4,76,O,0,0,0,0,0,0,0,0,0,0,03B4A
Stimme,03B5A,3,Pankow,5A,B,035A,5,76,O,0,0,0,0,922,922,4,918,485,433,nan
Stimme,03B5B,3,Pankow,5B,B,035B,5,76,O,0,0,0,0,834,834,0,834,319,515,nan
Stimme,03B5C,3,Pankow,5C,B,035C,5,76,O,0,0,0,0,952,952,3,949,611,338,nan
Stimme,03B5D,3,Pankow,5D,B,035D,5,76,O,0,0,0,0,1007,1007,1,1006,669,337,nan
Stimme,03B5E,3,Pankow,5E,B,035E,5,76,O,0,0,0,0,1013,1013,4,1009,629,380,nan
Stimme,03B5F,3,Pankow,5F,B,035F,5,76,O,0,0,0,0,878,878,4,874,458,416,nan
Stimme,03B5G,3,Pankow,5G,B,035G,5,76,O,0,0,0,0,0,0,0,0,0,0,03B5F
Stimme,03B5H,3,Pankow,5H,B,035H,5,76,O,0,0,0,0,0,0,0,0,0,0,03B5E
Stimme,03B5I,3,Pankow,5I,B,035I,5,76,O,0,0,0,0,0,0,0,0,0,0,03B5D
Stimme,03B5K,3,Pankow,5K,B,035K,5,76,O,0,0,0,0,0,0,0,0,0,0,03B5C
Stimme,03B5L,3,Pankow,5L,B,035L,5,76,O,0,0,0,0,0,0,0,0,0,0,03B5B
Stimme,03B5M,3,Pankow,5M,B,035M,5,76,O,0,0,0,0,0,0,0,0,0,0,03B5A
Stimme,03B6A,3,Pankow,6A,B,036A,6,76,O,0,0,0,0,906,906,0,906,820,86,nan
Stimme,03B6B,3,Pankow,6B,B,036B,6,76,O,0,0,0,0,1029,1029,2,1027,799,228,nan
Stimme,03B6C,3,Pankow,6C,B,036C,6,76,O,0,0,0,0,921,921,2,919,717,202,nan
Stimme,03B6D,3,Pankow,6D,B,036D,6,76,O,0,0,0,0,842,842,0,842,654,188,nan
Stimme,03B6E,3,Pankow,6E,B,036E,6,76,O,0,0,0,0,1130,1130,2,1128,855,273,nan
Stimme,03B6F,3,Pankow,6F,B,036F,6,76,O,0,0,0,0,771,771,1,770,590,180,nan
Stimme,03B6G,3,Pankow,6G,B,036G,6,76,O,0,0,0,0,755,755,0,755,596,159,nan
Stimme,03B6H,3,Pankow,6H,B,036H,6,76,O,0,0,0,0,0,0,0,0,0,0,03B6G
Stimme,03B6I,3,Pankow,6I,B,036I,6,76,O,0,0,0,0,0,0,0,0,0,0,03B6F
Stimme,03B6K,3,Pankow,6K,B,036K,6,76,O,0,0,0,0,0,0,0,0,0,0,03B6E
Stimme,03B6L,3,Pankow,6L,B,036L,6,76,O,0,0,0,0,0,0,0,0,0,0,03B6D
Stimme,03B6M,3,Pankow,6M,B,036M,6,76,O,0,0,0,0,0,0,0,0,0,0,03B6C
Stimme,03B6N,3,Pankow,6N,B,036N,6,76,O,0,0,0,0,0,0,0,0,0,0,03B6B
Stimme,03B6P,3,Pankow,6P,B,036P,6,76,O,0,0,0,0,0,0,0,0,0,0,03B6A
Stimme,03B7A,3,Pankow,7A,B,037A,7,76,O,0,0,0,0,967,967,1,966,671,295,nan
Stimme,03B7B,3,Pankow,7B,B,037B,7,76,O,0,0,0,0,774,774,2,772,491,281,nan
Stimme,03B7C,3,Pankow,7C,B,037C,7,76,O,0,0,0,0,847,847,2,845,558,287,nan
Stimme,03B7D,3,Pankow,7D,B,037D,7,76,O,0,0,0,0,878,878,1,877,544,333,nan
Stimme,03B7E,3,Pankow,7E,B,037E,7,76,O,0,0,0,0,1083,1083,1,1082,817,265,nan
Stimme,03B7F,3,Pankow,7F,B,037F,7,76,O,0,0,0,0,992,992,0,992,695,297,nan
Stimme,03B7G,3,Pankow,7G,B,037G,7,76,O,0,0,0,0,0,0,0,0,0,0,03B7F
Stimme,03B7H,3,Pankow,7H,B,037H,7,76,O,0,0,0,0,0,0,0,0,0,0,03B7E
Stimme,03B7I,3,Pankow,7I,B,037I,7,83,O,0,0,0,0,0,0,0,0,0,0,03B7D
Stimme,03B7K,3,Pankow,7K,B,037K,7,83,O,0,0,0,0,0,0,0,0,0,0,03B7C
Stimme,03B7L,3,Pankow,7L,B,037L,7,83,O,0,0,0,0,0,0,0,0,0,0,03B7B
Stimme,03B7M,3,Pankow,7M,B,037M,7,83,O,0,0,0,0,0,0,0,0,0,0,03B7A
Stimme,03B8A,3,Pankow,8A,B,038A,8,76,O,0,0,0,0,886,886,1,885,599,286,nan
Stimme,03B8B,3,Pankow,8B,B,038B,8,76,O,0,0,0,0,683,683,1,682,522,160,nan
Stimme,03B8C,3,Pankow,8C,B,038C,8,76,O,0,0,0,0,913,913,3,910,681,229,nan
Stimme,03B8D,3,Pankow,8D,B,038D,8,76,O,0,0,0,0,801,801,0,801,613,188,nan
Stimme,03B8E,3,Pankow,8E,B,038E,8,76,O,0,0,0,0,891,891,0,891,653,238,nan
Stimme,03B8F,3,Pankow,8F,B,038F,8,76,O,0,0,0,0,960,960,0,960,647,313,nan
Stimme,03B8G,3,Pankow,8G,B,038G,8,76,O,0,0,0,0,578,578,2,576,464,112,nan
Stimme,03B8H,3,Pankow,8H,B,038H,8,76,O,0,0,0,0,0,0,0,0,0,0,03B8G
Stimme,03B8I,3,Pankow,8I,B,038I,8,83,O,0,0,0,0,0,0,0,0,0,0,03B8F
Stimme,03B8K,3,Pankow,8K,B,038K,8,83,O,0,0,0,0,0,0,0,0,0,0,03B8E
Stimme,03B8L,3,Pankow,8L,B,038L,8,83,O,0,0,0,0,0,0,0,0,0,0,03B8D
Stimme,03B8M,3,Pankow,8M,B,038M,8,83,O,0,0,0,0,0,0,0,0,0,0,03B8C
Stimme,03B8N,3,Pankow,8N,B,038N,8,83,O,0,0,0,0,0,0,0,0,0,0,03B8B
Stimme,03B8P,3,Pankow,8P,B,038P,8,83,O,0,0,0,0,0,0,0,0,0,0,03B8A
Stimme,03B9A,3,Pankow,9A,B,039A,9,76,O,0,0,0,0,823,823,1,822,547,275,nan
Stimme,03B9B,3,Pankow,9B,B,039B,9,76,O,0,0,0,0,1099,1099,6,1093,788,305,nan
Stimme,03B9C,3,Pankow,9C,B,039C,9,76,O,0,0,0,0,1012,1012,0,1012,646,366,nan
Stimme,03B9D,3,Pankow,9D,B,039D,9,83,O,0,0,0,0,727,727,1,726,494,232,nan
Stimme,03B9E,3,Pankow,9E,B,039E,9,83,O,0,0,0,0,672,672,1,671,403,268,nan
Stimme,03B9F,3,Pankow,9F,B,039F,9,83,O,0,0,0,0,741,741,0,741,458,283,nan
Stimme,03B9G,3,Pankow,9G,B,039G,9,83,O,0,0,0,0,692,692,1,691,394,297,nan
Stimme,03B9H,3,Pankow,9H,B,039H,9,83,O,0,0,0,0,0,0,0,0,0,0,03B9G
Stimme,03B9I,3,Pankow,9I,B,039I,9,83,O,0,0,0,0,0,0,0,0,0,0,03B9F
Stimme,03B9K,3,Pankow,9K,B,039K,9,83,O,0,0,0,0,0,0,0,0,0,0,03B9E
Stimme,03B9L,3,Pankow,9L,B,039L,9,83,O,0,0,0,0,0,0,0,0,0,0,03B9D
Stimme,03B9M,3,Pankow,9M,B,039M,9,83,O,0,0,0,0,0,0,0,0,0,0,03B9C
Stimme,03B9N,3,Pankow,9N,B,039N,9,83,O,0,0,0,0,0,0,0,0,0,0,03B9B
Stimme,03B9P,3,Pankow,9P,B,039P,9,83,O,0,0,0,0,0,0,0,0,0,0,03B9A
Stimme,03B9Q,3,Pankow,9Q,B,039Q,9,83,O,0,0,0,0,0,0,0,0,0,0,03B9A
Stimme,04W101,4,Charlottenburg-Wilmersdorf,101,W,041A,1,78,W,1114,963,151,0,143,0,0,143,59,84,nan
Stimme,04W102,4,Charlottenburg-Wilmersdorf,102,W,041B,1,78,W,659,563,96,0,72,2,1,71,42,29,nan
Stimme,04W103,4,Charlottenburg-Wilmersdorf,103,W,041C,1,78,W,1238,1038,200,0,219,2,1,218,77,141,nan
Stimme,04W104,4,Charlottenburg-Wilmersdorf,104,W,041D,1,78,W,1039,932,107,0,115,0,1,114,30,84,nan
Stimme,04W105,4,Charlottenburg-Wilmersdorf,105,W,041E,1,78,W,1112,1009,103,0,137,1,1,136,50,86,nan
Stimme,04W106,4,Charlottenburg-Wilmersdorf,106,W,041F,1,78,W,986,867,119,0,120,3,0,120,48,72,nan
Stimme,04W107,4,Charlottenburg-Wilmersdorf,107,W,041G,1,78,W,1132,1025,107,0,143,2,0,143,27,116,nan
Stimme,04W108,4,Charlottenburg-Wilmersdorf,108,W,041H,1,78,W,460,412,48,0,70,2,0,70,24,46,nan
Stimme,04W109,4,Charlottenburg-Wilmersdorf,109,W,041I,1,78,W,1057,965,92,0,122,0,0,122,45,77,nan
Stimme,04W110,4,Charlottenburg-Wilmersdorf,110,W,041J,1,78,W,1147,1002,145,0,166,4,0,166,47,119,nan
Stimme,04W111,4,Charlottenburg-Wilmersdorf,111,W,041H,1,78,W,987,882,105,0,128,2,0,128,36,92,nan
Stimme,04W112,4,Charlottenburg-Wilmersdorf,112,W,041K,1,78,W,1136,992,144,0,226,5,0,226,124,102,nan
Stimme,04W113,4,Charlottenburg-Wilmersdorf,113,W,041L,1,78,W,1301,1074,227,0,288,2,0,288,167,121,nan
Stimme,04W114,4,Charlottenburg-Wilmersdorf,114,W,041M,1,78,W,1148,901,247,0,217,5,0,217,133,84,nan
Stimme,04W115,4,Charlottenburg-Wilmersdorf,115,W,041N,1,78,W,1127,905,222,0,233,3,0,233,148,85,nan
Stimme,04W116,4,Charlottenburg-Wilmersdorf,116,W,041P,1,78,W,1239,1007,232,0,274,2,0,274,175,99,nan
Stimme,04W117,4,Charlottenburg-Wilmersdorf,117,W,041Q,1,78,W,1049,831,218,0,172,1,0,172,100,72,nan
Stimme,04W118,4,Charlottenburg-Wilmersdorf,118,W,041R,1,78,W,1153,917,236,0,183,8,1,182,112,70,nan
Stimme,04W119,4,Charlottenburg-Wilmersdorf,119,W,041S,1,78,W,1201,990,211,0,231,4,3,228,153,75,nan
Stimme,04W201,4,Charlottenburg-Wilmersdorf,201,W,042A,2,80,W,920,658,262,0,196,6,1,195,86,109,nan
Stimme,04W202,4,Charlottenburg-Wilmersdorf,202,W,042B,2,80,W,1076,824,252,0,234,1,5,229,120,109,nan
Stimme,04W203,4,Charlottenburg-Wilmersdorf,203,W,042A,2,80,W,983,752,231,0,157,0,0,157,71,86,nan
Stimme,04W204,4,Charlottenburg-Wilmersdorf,204,W,042C,2,80,W,1307,1079,228,0,184,1,1,183,54,129,nan
Stimme,04W205,4,Charlottenburg-Wilmersdorf,205,W,042B,2,80,W,923,672,251,0,178,5,1,177,74,103,nan
Stimme,04W206,4,Charlottenburg-Wilmersdorf,206,W,042D,2,80,W,1149,930,219,0,235,5,2,233,87,146,nan
Stimme,04W207,4,Charlottenburg-Wilmersdorf,207,W,042E,2,80,W,1175,938,237,0,247,2,0,247,125,122,nan
Stimme,04W208,4,Charlottenburg-Wilmersdorf,208,W,042F,2,80,W,1235,1018,217,0,103,1,1,102,64,38,nan
Stimme,04W209,4,Charlottenburg-Wilmersdorf,209,W,042G,2,80,W,977,765,212,0,236,0,0,236,122,114,nan
Stimme,04W210,4,Charlottenburg-Wilmersdorf,210,W,042H,2,80,W,1163,901,262,0,284,0,2,282,113,169,nan
Stimme,04W211,4,Charlottenburg-Wilmersdorf,211,W,042I,2,80,W,1088,873,215,0,264,6,2,262,130,132,nan
Stimme,04W212,4,Charlottenburg-Wilmersdorf,212,W,042J,2,80,W,1214,930,284,0,289,4,0,289,133,156,nan
Stimme,04W213,4,Charlottenburg-Wilmersdorf,213,W,042K,2,80,W,822,633,189,0,183,5,0,183,66,117,nan
Stimme,04W214,4,Charlottenburg-Wilmersdorf,214,W,042L,2,80,W,1255,1023,232,0,214,0,0,214,126,88,nan
Stimme,04W215,4,Charlottenburg-Wilmersdorf,215,W,042M,2,80,W,1038,831,207,0,197,4,0,197,132,65,nan
Stimme,04W216,4,Charlottenburg-Wilmersdorf,216,W,042N,2,80,W,1289,1021,268,0,273,6,2,271,128,143,nan
Stimme,04W217,4,Charlottenburg-Wilmersdorf,217,W,042P,2,80,W,1242,980,262,0,279,0,1,278,158,120,nan
Stimme,04W218,4,Charlottenburg-Wilmersdorf,218,W,042Q,2,80,W,1234,998,236,0,274,4,3,271,134,137,nan
Stimme,04W219,4,Charlottenburg-Wilmersdorf,219,W,042R,2,80,W,1178,979,199,0,249,4,0,249,112,137,nan
Stimme,04W220,4,Charlottenburg-Wilmersdorf,220,W,042S,2,80,W,1155,872,283,0,320,5,1,319,174,145,nan
Stimme,04W221,4,Charlottenburg-Wilmersdorf,221,W,042T,2,80,W,1220,939,281,0,229,4,2,227,124,103,nan
Stimme,04W222,4,Charlottenburg-Wilmersdorf,222,W,042U,2,80,W,1208,966,242,0,225,0,1,224,137,87,nan
Stimme,04W223,4,Charlottenburg-Wilmersdorf,223,W,042V,2,80,W,1094,863,231,0,198,4,0,198,107,91,nan
Stimme,04W224,4,Charlottenburg-Wilmersdorf,224,W,042W,2,80,W,1050,803,247,0,353,5,2,351,178,173,nan
Stimme,04W225,4,Charlottenburg-Wilmersdorf,225,W,042X,2,80,W,1586,1250,336,0,223,5,0,223,145,78,nan
Stimme,04W226,4,Charlottenburg-Wilmersdorf,226,W,042I,2,80,W,1088,828,260,0,220,0,2,218,115,103,nan
Stimme,04W227,4,Charlottenburg-Wilmersdorf,227,W,042Y,2,80,W,1062,790,272,0,245,7,2,243,99,144,nan
Stimme,04W301,4,Charlottenburg-Wilmersdorf,301,W,043A,3,80,W,1270,1034,236,0,242,3,1,241,162,79,nan
Stimme,04W302,4,Charlottenburg-Wilmersdorf,302,W,043B,3,80,W,1051,874,177,0,247,4,1,246,146,100,nan
Stimme,04W303,4,Charlottenburg-Wilmersdorf,303,W,043C,3,80,W,1165,950,215,0,279,6,1,278,183,95,nan
Stimme,04W304,4,Charlottenburg-Wilmersdorf,304,W,043D,3,80,W,1030,838,192,0,261,2,7,254,162,92,nan
Stimme,04W305,4,Charlottenburg-Wilmersdorf,305,W,043E,3,80,W,929,715,214,0,213,1,1,212,145,67,nan
Stimme,04W306,4,Charlottenburg-Wilmersdorf,306,W,043F,3,80,W,1030,846,184,0,272,3,1,271,206,65,nan
Stimme,04W307,4,Charlottenburg-Wilmersdorf,307,W,043G,3,80,W,1192,960,232,0,314,7,1,313,197,116,nan
Stimme,04W308,4,Charlottenburg-Wilmersdorf,308,W,043H,3,80,W,750,559,191,0,183,2,2,181,82,99,nan
Stimme,04W309,4,Charlottenburg-Wilmersdorf,309,W,043I,3,80,W,1296,1016,280,0,247,3,0,247,127,120,nan
Stimme,04W310,4,Charlottenburg-Wilmersdorf,310,W,043J,3,80,W,1135,877,258,0,267,6,0,267,169,98,nan
Stimme,04W311,4,Charlottenburg-Wilmersdorf,311,W,043K,3,80,W,967,761,206,0,207,7,0,207,144,63,nan
Stimme,04W312,4,Charlottenburg-Wilmersdorf,312,W,043E,3,80,W,794,650,144,0,202,5,2,200,145,55,nan
Stimme,04W313,4,Charlottenburg-Wilmersdorf,313,W,043L,3,80,W,1173,934,239,0,215,1,3,212,141,71,nan
Stimme,04W314,4,Charlottenburg-Wilmersdorf,314,W,043M,3,80,W,1127,857,270,0,255,5,1,254,193,61,nan
Stimme,04W315,4,Charlottenburg-Wilmersdorf,315,W,043N,3,80,W,1110,888,222,0,253,4,4,249,169,80,nan
Stimme,04W316,4,Charlottenburg-Wilmersdorf,316,W,043P,3,80,W,1161,920,241,0,263,2,3,260,148,112,nan
Stimme,04W317,4,Charlottenburg-Wilmersdorf,317,W,043K,3,80,W,991,793,198,0,268,2,4,264,154,110,nan
Stimme,04W318,4,Charlottenburg-Wilmersdorf,318,W,043Q,3,80,W,1117,826,291,0,300,2,4,296,206,90,nan
Stimme,04W319,4,Charlottenburg-Wilmersdorf,319,W,043R,3,80,W,906,679,227,0,255,5,1,254,176,78,nan
Stimme,04W320,4,Charlottenburg-Wilmersdorf,320,W,043S,3,80,W,1012,759,253,0,174,5,2,172,112,60,nan
Stimme,04W321,4,Charlottenburg-Wilmersdorf,321,W,043T,3,80,W,1102,895,207,0,261,1,1,260,164,96,nan
Stimme,04W322,4,Charlottenburg-Wilmersdorf,322,W,043U,3,80,W,1196,919,277,0,314,14,4,310,198,112,nan
Stimme,04W323,4,Charlottenburg-Wilmersdorf,323,W,043V,3,80,W,1107,885,222,0,201,1,2,199,111,88,nan
Stimme,04W324,4,Charlottenburg-Wilmersdorf,324,W,043V,3,80,W,1080,849,231,0,209,3,0,209,125,84,nan
Stimme,04W325,4,Charlottenburg-Wilmersdorf,325,W,043R,3,80,W,697,562,135,0,92,2,0,92,60,32,nan
Stimme,04W326,4,Charlottenburg-Wilmersdorf,326,W,043S,3,80,W,912,728,184,0,193,3,0,193,120,73,nan
Stimme,04W327,4,Charlottenburg-Wilmersdorf,327,W,043D,3,80,W,971,770,201,0,207,0,0,207,142,65,nan
Stimme,04W328,4,Charlottenburg-Wilmersdorf,328,W,043H,3,80,W,976,810,166,0,226,3,0,226,129,97,nan
Stimme,04W329,4,Charlottenburg-Wilmersdorf,329,W,043W,3,80,W,1207,978,229,0,324,6,1,323,224,99,nan
Stimme,04W401,4,Charlottenburg-Wilmersdorf,401,W,044A,4,80,W,1319,1038,281,0,291,0,2,289,179,110,nan
Stimme,04W402,4,Charlottenburg-Wilmersdorf,402,W,044B,4,80,W,1136,949,187,0,199,0,1,198,115,83,nan
Stimme,04W403,4,Charlottenburg-Wilmersdorf,403,W,044C,4,80,W,537,428,109,0,61,0,0,61,39,22,nan
Stimme,04W404,4,Charlottenburg-Wilmersdorf,404,W,044D,4,80,W,1033,880,153,0,237,0,3,234,142,92,nan
Stimme,04W405,4,Charlottenburg-Wilmersdorf,405,W,044E,4,80,W,1119,864,255,0,244,5,2,242,164,78,nan
Stimme,04W406,4,Charlottenburg-Wilmersdorf,406,W,044F,4,80,W,1137,951,186,0,182,1,0,182,96,86,nan
Stimme,04W407,4,Charlottenburg-Wilmersdorf,407,W,044D,4,80,W,957,795,162,0,186,4,0,186,135,51,nan
Stimme,04W408,4,Charlottenburg-Wilmersdorf,408,W,044G,4,80,W,1149,960,189,0,188,0,2,186,104,82,nan
Stimme,04W409,4,Charlottenburg-Wilmersdorf,409,W,044H,4,80,W,1271,983,288,0,255,0,1,254,156,98,nan
Stimme,04W410,4,Charlottenburg-Wilmersdorf,410,W,044I,4,80,W,1203,1010,193,0,247,1,1,246,169,77,nan
Stimme,04W411,4,Charlottenburg-Wilmersdorf,411,W,044J,4,80,W,1172,913,259,0,235,4,2,233,142,91,nan
Stimme,04W412,4,Charlottenburg-Wilmersdorf,412,W,044K,4,80,W,1028,812,216,0,204,0,1,203,128,75,nan
Stimme,04W413,4,Charlottenburg-Wilmersdorf,413,W,044L,4,80,W,1116,919,197,0,255,2,0,255,158,97,nan
Stimme,04W414,4,Charlottenburg-Wilmersdorf,414,W,044M,4,80,W,1017,766,251,0,179,2,0,179,125,54,nan
Stimme,04W415,4,Charlottenburg-Wilmersdorf,415,W,044N,4,80,W,977,771,206,0,181,4,2,179,114,65,nan
Stimme,04W416,4,Charlottenburg-Wilmersdorf,416,W,044K,4,80,W,866,701,165,0,162,2,0,162,109,53,nan
Stimme,04W417,4,Charlottenburg-Wilmersdorf,417,W,044P,4,80,W,1103,920,183,0,214,5,2,212,126,86,nan
Stimme,04W418,4,Charlottenburg-Wilmersdorf,418,W,044Q,4,80,W,843,664,179,0,199,1,0,199,105,94,nan
Stimme,04W419,4,Charlottenburg-Wilmersdorf,419,W,044R,4,80,W,1234,1014,220,0,282,4,0,282,185,97,nan
Stimme,04W420,4,Charlottenburg-Wilmersdorf,420,W,044S,4,80,W,799,685,114,0,127,1,0,127,71,56,nan
Stimme,04W421,4,Charlottenburg-Wilmersdorf,421,W,044S,4,80,W,964,788,176,0,163,2,0,163,100,63,nan
Stimme,04W422,4,Charlottenburg-Wilmersdorf,422,W,044T,4,80,W,1256,952,304,0,208,5,3,205,124,81,nan
Stimme,04W423,4,Charlottenburg-Wilmersdorf,423,W,044U,4,80,W,839,681,158,0,77,0,2,75,33,42,nan
Stimme,04W424,4,Charlottenburg-Wilmersdorf,424,W,044V,4,80,W,1181,979,202,0,245,1,0,245,140,105,nan
Stimme,04W425,4,Charlottenburg-Wilmersdorf,425,W,044W,4,80,W,1146,881,265,0,192,2,0,192,92,100,nan
Stimme,04W426,4,Charlottenburg-Wilmersdorf,426,W,044Q,4,80,W,1052,809,243,0,203,1,2,201,135,66,nan
Stimme,04W427,4,Charlottenburg-Wilmersdorf,427,W,044X,4,80,W,1293,1038,255,0,183,5,0,183,104,79,nan
Stimme,04W428,4,Charlottenburg-Wilmersdorf,428,W,044Y,4,80,W,1210,956,254,0,295,3,0,295,187,108,nan
Stimme,04W429,4,Charlottenburg-Wilmersdorf,429,W,044C,4,80,W,874,716,158,0,200,8,2,198,129,69,nan
Stimme,04W430,4,Charlottenburg-Wilmersdorf,430,W,044N,4,80,W,796,646,150,0,138,0,0,138,84,54,nan
Stimme,04W501,4,Charlottenburg-Wilmersdorf,501,W,045A,5,80,W,1105,867,238,0,207,3,1,206,68,138,nan
Stimme,04W502,4,Charlottenburg-Wilmersdorf,502,W,045B,5,80,W,1073,835,238,0,227,5,1,226,83,143,nan
Stimme,04W503,4,Charlottenburg-Wilmersdorf,503,W,045C,5,80,W,1089,864,225,0,187,2,0,187,75,112,nan
Stimme,04W504,4,Charlottenburg-Wilmersdorf,504,W,045D,5,80,W,1226,1025,201,0,228,0,6,222,118,104,nan
Stimme,04W505,4,Charlottenburg-Wilmersdorf,505,W,045E,5,80,W,1131,875,256,0,177,2,0,177,102,75,nan
Stimme,04W506,4,Charlottenburg-Wilmersdorf,506,W,045F,5,80,W,1158,915,243,0,184,6,0,184,109,75,nan
Stimme,04W507,4,Charlottenburg-Wilmersdorf,507,W,045G,5,80,W,895,710,185,0,170,1,1,169,90,79,nan
Stimme,04W508,4,Charlottenburg-Wilmersdorf,508,W,045G,5,80,W,826,687,139,0,204,1,0,204,113,91,nan
Stimme,04W509,4,Charlottenburg-Wilmersdorf,509,W,045H,5,80,W,1153,885,268,0,136,0,0,136,85,51,nan
Stimme,04W510,4,Charlottenburg-Wilmersdorf,510,W,045I,5,80,W,1112,866,246,0,176,5,1,175,98,77,nan
Stimme,04W511,4,Charlottenburg-Wilmersdorf,511,W,045J,5,80,W,1177,968,209,0,178,5,1,177,63,114,nan
Stimme,04W512,4,Charlottenburg-Wilmersdorf,512,W,045K,5,80,W,1119,920,199,0,171,3,2,169,83,86,nan
Stimme,04W513,4,Charlottenburg-Wilmersdorf,513,W,045J,5,80,W,885,731,154,0,154,1,0,154,68,86,nan
Stimme,04W514,4,Charlottenburg-Wilmersdorf,514,W,045L,5,80,W,879,676,203,0,154,2,1,153,88,65,nan
Stimme,04W515,4,Charlottenburg-Wilmersdorf,515,W,045M,5,80,W,848,664,184,0,157,2,1,156,85,71,nan
Stimme,04W516,4,Charlottenburg-Wilmersdorf,516,W,045M,5,80,W,972,726,246,0,216,0,0,216,128,88,nan
Stimme,04W517,4,Charlottenburg-Wilmersdorf,517,W,045N,5,80,W,752,588,164,0,130,1,0,130,68,62,nan
Stimme,04W518,4,Charlottenburg-Wilmersdorf,518,W,045E,5,80,W,977,761,216,0,127,2,0,127,69,58,nan
Stimme,04W519,4,Charlottenburg-Wilmersdorf,519,W,045P,5,80,W,1219,1005,214,0,220,0,1,219,96,123,nan
Stimme,04W520,4,Charlottenburg-Wilmersdorf,520,W,045Q,5,80,W,1275,1024,251,0,246,6,0,246,122,124,nan
Stimme,04W521,4,Charlottenburg-Wilmersdorf,521,W,045B,5,80,W,966,778,188,0,158,0,3,155,47,108,nan
Stimme,04W522,4,Charlottenburg-Wilmersdorf,522,W,045R,5,80,W,1127,902,225,0,222,1,0,222,83,139,nan
Stimme,04W523,4,Charlottenburg-Wilmersdorf,523,W,045S,5,80,W,1088,890,198,0,237,3,2,235,92,143,nan
Stimme,04W524,4,Charlottenburg-Wilmersdorf,524,W,045T,5,80,W,1174,863,311,0,148,0,0,148,41,107,nan
Stimme,04W525,4,Charlottenburg-Wilmersdorf,525,W,045U,5,80,W,1124,840,284,0,178,2,4,174,79,95,nan
Stimme,04W526,4,Charlottenburg-Wilmersdorf,526,W,045V,5,80,W,1030,806,224,0,155,5,3,152,67,85,nan
Stimme,04W527,4,Charlottenburg-Wilmersdorf,527,W,045N,5,80,W,815,706,109,0,128,2,0,128,58,70,nan
Stimme,04W528,4,Charlottenburg-Wilmersdorf,528,W,045W,5,80,W,773,607,166,0,163,3,0,163,83,80,nan
Stimme,04W529,4,Charlottenburg-Wilmersdorf,529,W,045L,5,80,W,1108,830,278,0,146,2,0,146,82,64,nan
Stimme,04W601,4,Charlottenburg-Wilmersdorf,601,W,046A,6,80,W,1036,830,206,0,220,1,0,220,129,91,nan
Stimme,04W602,4,Charlottenburg-Wilmersdorf,602,W,046B,6,80,W,1052,870,182,0,222,0,0,222,139,83,nan
Stimme,04W603,4,Charlottenburg-Wilmersdorf,603,W,046C,6,80,W,1140,934,206,0,216,1,0,216,104,112,nan
Stimme,04W604,4,Charlottenburg-Wilmersdorf,604,W,046D,6,80,W,1008,837,171,0,152,0,0,152,81,71,nan
Stimme,04W605,4,Charlottenburg-Wilmersdorf,605,W,046D,6,80,W,1047,834,213,0,190,1,1,189,111,78,nan
Stimme,04W606,4,Charlottenburg-Wilmersdorf,606,W,046E,6,80,W,1231,989,242,0,268,2,0,268,144,124,nan
Stimme,04W607,4,Charlottenburg-Wilmersdorf,607,W,046B,6,80,W,1101,876,225,0,205,0,1,204,128,76,nan
Stimme,04W608,4,Charlottenburg-Wilmersdorf,608,W,046F,6,80,W,1185,928,257,0,190,8,0,190,117,73,nan
Stimme,04W609,4,Charlottenburg-Wilmersdorf,609,W,046A,6,80,W,1115,923,192,0,215,0,0,215,105,110,nan
Stimme,04W610,4,Charlottenburg-Wilmersdorf,610,W,046G,6,80,W,1140,885,255,0,281,2,4,277,160,117,nan
Stimme,04W611,4,Charlottenburg-Wilmersdorf,611,W,046H,6,80,W,1033,823,210,0,255,0,2,253,149,104,nan
Stimme,04W612,4,Charlottenburg-Wilmersdorf,612,W,046I,6,80,W,1329,1044,285,0,240,2,2,238,115,123,nan
Stimme,04W613,4,Charlottenburg-Wilmersdorf,613,W,046J,6,80,W,1291,931,360,0,205,4,0,205,146,59,nan
Stimme,04W614,4,Charlottenburg-Wilmersdorf,614,W,046K,6,80,W,1109,825,284,0,188,3,5,183,110,73,nan
Stimme,04W615,4,Charlottenburg-Wilmersdorf,615,W,046L,6,80,W,1105,851,254,0,209,0,1,208,126,82,nan
Stimme,04W616,4,Charlottenburg-Wilmersdorf,616,W,046M,6,80,W,1027,794,233,0,245,8,1,244,170,74,nan
Stimme,04W617,4,Charlottenburg-Wilmersdorf,617,W,046N,6,80,W,1307,1052,255,0,283,3,2,281,169,112,nan
Stimme,04W618,4,Charlottenburg-Wilmersdorf,618,W,046P,6,80,W,1130,866,264,0,229,1,5,224,142,82,nan
Stimme,04W619,4,Charlottenburg-Wilmersdorf,619,W,046Q,6,80,W,1081,858,223,0,244,4,3,241,144,97,nan
Stimme,04W620,4,Charlottenburg-Wilmersdorf,620,W,046R,6,80,W,1254,942,312,0,177,3,2,175,112,63,nan
Stimme,04W621,4,Charlottenburg-Wilmersdorf,621,W,046S,6,80,W,1260,966,294,0,270,2,1,269,171,98,nan
Stimme,04W622,4,Charlottenburg-Wilmersdorf,622,W,046T,6,80,W,1290,986,304,0,276,0,0,276,168,108,nan
Stimme,04W623,4,Charlottenburg-Wilmersdorf,623,W,046U,6,80,W,1221,983,238,0,308,7,3,305,176,129,nan
Stimme,04W624,4,Charlottenburg-Wilmersdorf,624,W,046V,6,80,W,1238,972,266,0,320,2,4,316,190,126,nan
Stimme,04W625,4,Charlottenburg-Wilmersdorf,625,W,046W,6,80,W,1196,957,239,0,296,3,0,296,180,116,nan
Stimme,04W626,4,Charlottenburg-Wilmersdorf,626,W,046X,6,80,W,1091,867,224,0,237,3,0,237,161,76,nan
Stimme,04W627,4,Charlottenburg-Wilmersdorf,627,W,046Y,6,80,W,929,761,168,0,126,4,1,125,64,61,nan
Stimme,04W701,4,Charlottenburg-Wilmersdorf,701,W,047A,7,80,W,1229,965,264,0,253,4,2,251,122,129,nan
Stimme,04W702,4,Charlottenburg-Wilmersdorf,702,W,047B,7,80,W,1126,915,211,0,212,5,0,212,102,110,nan
Stimme,04W703,4,Charlottenburg-Wilmersdorf,703,W,047C,7,80,W,1227,990,237,0,286,6,1,285,181,104,nan
Stimme,04W704,4,Charlottenburg-Wilmersdorf,704,W,047D,7,80,W,1177,924,253,0,218,3,0,218,103,115,nan
Stimme,04W705,4,Charlottenburg-Wilmersdorf,705,W,047E,7,80,W,1058,793,265,0,270,2,2,268,169,99,nan
Stimme,04W706,4,Charlottenburg-Wilmersdorf,706,W,047F,7,80,W,1168,911,257,0,379,1,3,376,225,151,nan
Stimme,04W707,4,Charlottenburg-Wilmersdorf,707,W,047G,7,80,W,986,805,181,0,190,5,0,190,106,84,nan
Stimme,04W708,4,Charlottenburg-Wilmersdorf,708,W,047H,7,80,W,1225,994,231,0,289,3,2,287,159,128,nan
Stimme,04W709,4,Charlottenburg-Wilmersdorf,709,W,047I,7,80,W,1244,978,266,0,161,1,0,161,73,88,nan
Stimme,04W710,4,Charlottenburg-Wilmersdorf,710,W,047J,7,80,W,1282,953,329,0,324,5,2,322,185,137,nan
Stimme,04W711,4,Charlottenburg-Wilmersdorf,711,W,047K,7,80,W,1279,952,327,0,231,8,2,229,105,124,nan
Stimme,04W712,4,Charlottenburg-Wilmersdorf,712,W,047L,7,80,W,1240,957,283,0,318,8,4,314,190,124,nan
Stimme,04W713,4,Charlottenburg-Wilmersdorf,713,W,047M,7,80,W,1207,930,277,0,303,5,1,302,149,153,nan
Stimme,04W714,4,Charlottenburg-Wilmersdorf,714,W,047N,7,80,W,1276,1047,229,0,303,0,0,303,184,119,nan
Stimme,04W715,4,Charlottenburg-Wilmersdorf,715,W,047P,7,80,W,1191,933,258,0,154,0,1,153,70,83,nan
Stimme,04W716,4,Charlottenburg-Wilmersdorf,716,W,047Q,7,80,W,1324,1055,269,0,289,4,1,288,183,105,nan
Stimme,04W717,4,Charlottenburg-Wilmersdorf,717,W,047R,7,80,W,1176,855,321,0,330,4,0,330,182,148,nan
Stimme,04W718,4,Charlottenburg-Wilmersdorf,718,W,047S,7,80,W,998,792,206,0,212,5,1,211,90,121,nan
Stimme,04W719,4,Charlottenburg-Wilmersdorf,719,W,047S,7,80,W,972,815,157,0,145,3,2,143,62,81,nan
Stimme,04W720,4,Charlottenburg-Wilmersdorf,720,W,047T,7,80,W,1248,1024,224,0,272,8,1,271,103,168,nan
Stimme,04W721,4,Charlottenburg-Wilmersdorf,721,W,047U,7,80,W,1229,936,293,0,262,3,0,262,126,136,nan
Stimme,04W722,4,Charlottenburg-Wilmersdorf,722,W,047V,7,80,W,1131,908,223,0,271,0,2,269,141,128,nan
Stimme,04W723,4,Charlottenburg-Wilmersdorf,723,W,047W,7,80,W,1993,1543,450,0,399,3,2,397,192,205,nan
Stimme,04W724,4,Charlottenburg-Wilmersdorf,724,W,047X,7,80,W,782,603,179,0,157,3,0,157,74,83,nan
Stimme,04W725,4,Charlottenburg-Wilmersdorf,725,W,047Y,7,80,W,1184,986,198,0,272,8,1,271,163,108,nan
Stimme,04W726,4,Charlottenburg-Wilmersdorf,726,W,047Z,7,80,W,1223,943,280,0,352,6,1,351,164,187,nan
Stimme,04W727,4,Charlottenburg-Wilmersdorf,727,W,047X,7,80,W,876,666,210,0,223,2,1,222,86,136,nan
Stimme,04W801,4,Charlottenburg-Wilmersdorf,801,W,048A,1,80,W,980,757,223,0,184,1,0,184,95,89,nan
Stimme,04W802,4,Charlottenburg-Wilmersdorf,802,W,048B,1,80,W,1315,1017,298,0,192,1,1,191,118,73,nan
Stimme,04W803,4,Charlottenburg-Wilmersdorf,803,W,048C,1,80,W,1154,944,210,0,184,2,0,184,109,75,nan
Stimme,04W804,4,Charlottenburg-Wilmersdorf,804,W,048D,1,80,W,1102,921,181,0,210,1,0,210,112,98,nan
Stimme,04W805,4,Charlottenburg-Wilmersdorf,805,W,048E,1,80,W,932,776,156,0,164,1,1,163,97,66,nan
Stimme,04W806,4,Charlottenburg-Wilmersdorf,806,W,048F,1,80,W,1218,945,273,0,229,5,0,229,142,87,nan
Stimme,04W807,4,Charlottenburg-Wilmersdorf,807,W,048G,1,80,W,1130,896,234,0,195,5,0,195,111,84,nan
Stimme,04B1A,4,Charlottenburg-Wilmersdorf,1A,B,041A,1,78,W,0,0,0,0,191,191,0,191,103,88,nan
Stimme,04B1B,4,Charlottenburg-Wilmersdorf,1B,B,041B,1,78,W,0,0,0,0,0,0,0,0,0,0,04B1A
Stimme,04B1C,4,Charlottenburg-Wilmersdorf,1C,B,041C,1,78,W,0,0,0,0,271,271,0,271,67,204,nan
Stimme,04B1D,4,Charlottenburg-Wilmersdorf,1D,B,041D,1,78,W,0,0,0,0,0,0,0,0,0,0,04B1C
Stimme,04B1E,4,Charlottenburg-Wilmersdorf,1E,B,041E,1,78,W,0,0,0,0,193,193,0,193,83,110,nan
Stimme,04B1F,4,Charlottenburg-Wilmersdorf,1F,B,041F,1,78,W,0,0,0,0,0,0,0,0,0,0,04B1E
Stimme,04B1G,4,Charlottenburg-Wilmersdorf,1G,B,041G,1,78,W,0,0,0,0,216,216,0,216,51,165,nan
Stimme,04B1H,4,Charlottenburg-Wilmersdorf,1H,B,041H,1,78,W,0,0,0,0,0,0,0,0,0,0,04B1G
Stimme,04B1I,4,Charlottenburg-Wilmersdorf,1I,B,041I,1,78,W,0,0,0,0,202,202,0,202,77,125,nan
Stimme,04B1J,4,Charlottenburg-Wilmersdorf,1J,B,041J,1,78,W,0,0,0,0,0,0,0,0,0,0,04B1I
Stimme,04B1K,4,Charlottenburg-Wilmersdorf,1K,B,041K,1,78,W,0,0,0,0,321,321,0,321,197,124,nan
Stimme,04B1L,4,Charlottenburg-Wilmersdorf,1L,B,041L,1,78,W,0,0,0,0,0,0,0,0,0,0,04B1K
Stimme,04B1M,4,Charlottenburg-Wilmersdorf,1M,B,041M,1,78,W,0,0,0,0,406,406,1,405,276,129,nan
Stimme,04B1N,4,Charlottenburg-Wilmersdorf,1N,B,041N,1,78,W,0,0,0,0,0,0,0,0,0,0,04B1M
Stimme,04B1P,4,Charlottenburg-Wilmersdorf,1P,B,041P,1,78,W,0,0,0,0,395,395,1,394,233,161,nan
Stimme,04B1Q,4,Charlottenburg-Wilmersdorf,1Q,B,041Q,1,78,W,0,0,0,0,0,0,0,0,0,0,04B1P
Stimme,04B1R,4,Charlottenburg-Wilmersdorf,1R,B,041R,1,78,W,0,0,0,0,386,386,0,386,249,137,nan
Stimme,04B1S,4,Charlottenburg-Wilmersdorf,1S,B,041S,1,78,W,0,0,0,0,0,0,0,0,0,0,04B1R
Stimme,04B2A,4,Charlottenburg-Wilmersdorf,2A,B,042A,2,80,W,0,0,0,0,859,859,0,859,297,562,nan
Stimme,04B2B,4,Charlottenburg-Wilmersdorf,2B,B,042B,2,80,W,0,0,0,0,0,0,0,0,0,0,04B2A
Stimme,04B2C,4,Charlottenburg-Wilmersdorf,2C,B,042C,2,80,W,0,0,0,0,395,395,1,394,136,258,nan
Stimme,04B2D,4,Charlottenburg-Wilmersdorf,2D,B,042D,2,80,W,0,0,0,0,0,0,0,0,0,0,04B2C
Stimme,04B2E,4,Charlottenburg-Wilmersdorf,2E,B,042E,2,80,W,0,0,0,0,402,402,2,400,219,181,nan
Stimme,04B2F,4,Charlottenburg-Wilmersdorf,2F,B,042F,2,80,W,0,0,0,0,0,0,0,0,0,0,04B2E
Stimme,04B2G,4,Charlottenburg-Wilmersdorf,2G,B,042G,2,80,W,0,0,0,0,423,423,0,423,171,252,nan
Stimme,04B2H,4,Charlottenburg-Wilmersdorf,2H,B,042H,2,80,W,0,0,0,0,0,0,0,0,0,0,04B2G
Stimme,04B2I,4,Charlottenburg-Wilmersdorf,2I,B,042I,2,80,W,0,0,0,0,662,662,2,660,270,390,nan
Stimme,04B2J,4,Charlottenburg-Wilmersdorf,2J,B,042J,2,80,W,0,0,0,0,0,0,0,0,0,0,04B2I
Stimme,04B2K,4,Charlottenburg-Wilmersdorf,2K,B,042K,2,80,W,0,0,0,0,360,360,1,359,206,153,nan
Stimme,04B2L,4,Charlottenburg-Wilmersdorf,2L,B,042L,2,80,W,0,0,0,0,0,0,0,0,0,0,04B2K
Stimme,04B2M,4,Charlottenburg-Wilmersdorf,2M,B,042M,2,80,W,0,0,0,0,399,399,1,398,222,176,nan
Stimme,04B2N,4,Charlottenburg-Wilmersdorf,2N,B,042N,2,80,W,0,0,0,0,0,0,0,0,0,0,04B2M
Stimme,04B2P,4,Charlottenburg-Wilmersdorf,2P,B,042P,2,80,W,0,0,0,0,414,414,2,412,179,233,nan
Stimme,04B2Q,4,Charlottenburg-Wilmersdorf,2Q,B,042Q,2,80,W,0,0,0,0,0,0,0,0,0,0,04B2P
Stimme,04B2R,4,Charlottenburg-Wilmersdorf,2R,B,042R,2,80,W,0,0,0,0,420,420,1,419,198,221,nan
Stimme,04B2S,4,Charlottenburg-Wilmersdorf,2S,B,042S,2,80,W,0,0,0,0,0,0,0,0,0,0,04B2R
Stimme,04B2T,4,Charlottenburg-Wilmersdorf,2T,B,042T,2,80,W,0,0,0,0,444,444,0,444,224,220,nan
Stimme,04B2U,4,Charlottenburg-Wilmersdorf,2U,B,042U,2,80,W,0,0,0,0,0,0,0,0,0,0,04B2T
Stimme,04B2V,4,Charlottenburg-Wilmersdorf,2V,B,042V,2,80,W,0,0,0,0,422,422,2,420,202,218,nan
Stimme,04B2W,4,Charlottenburg-Wilmersdorf,2W,B,042W,2,80,W,0,0,0,0,0,0,0,0,0,0,04B2V
Stimme,04B2X,4,Charlottenburg-Wilmersdorf,2X,B,042X,2,80,W,0,0,0,0,509,509,2,507,270,237,nan
Stimme,04B2Y,4,Charlottenburg-Wilmersdorf,2Y,B,042Y,2,80,W,0,0,0,0,0,0,0,0,0,0,04B2X
Stimme,04B3A,4,Charlottenburg-Wilmersdorf,3A,B,043A,3,80,W,0,0,0,0,358,358,4,354,233,121,nan
Stimme,04B3B,4,Charlottenburg-Wilmersdorf,3B,B,043B,3,80,W,0,0,0,0,0,0,0,0,0,0,04B3A
Stimme,04B3C,4,Charlottenburg-Wilmersdorf,3C,B,043C,3,80,W,0,0,0,0,544,544,1,543,327,216,nan
Stimme,04B3D,4,Charlottenburg-Wilmersdorf,3D,B,043D,3,80,W,0,0,0,0,0,0,0,0,0,0,04B3C
Stimme,04B3E,4,Charlottenburg-Wilmersdorf,3E,B,043E,3,80,W,0,0,0,0,469,469,2,467,343,124,nan
Stimme,04B3F,4,Charlottenburg-Wilmersdorf,3F,B,043F,3,80,W,0,0,0,0,0,0,0,0,0,0,04B3E
Stimme,04B3G,4,Charlottenburg-Wilmersdorf,3G,B,043G,3,80,W,0,0,0,0,513,513,3,510,309,201,nan
Stimme,04B3H,4,Charlottenburg-Wilmersdorf,3H,B,043H,3,80,W,0,0,0,0,0,0,0,0,0,0,04B3G
Stimme,04B3I,4,Charlottenburg-Wilmersdorf,3I,B,043I,3,80,W,0,0,0,0,454,454,0,454,257,197,nan
Stimme,04B3J,4,Charlottenburg-Wilmersdorf,3J,B,043J,3,80,W,0,0,0,0,0,0,0,0,0,0,04B3I
Stimme,04B3K,4,Charlottenburg-Wilmersdorf,3K,B,043K,3,80,W,0,0,0,0,547,547,1,546,298,248,nan
Stimme,04B3L,4,Charlottenburg-Wilmersdorf,3L,B,043L,3,80,W,0,0,0,0,0,0,0,0,0,0,04B3K
Stimme,04B3M,4,Charlottenburg-Wilmersdorf,3M,B,043M,3,80,W,0,0,0,0,433,433,0,433,295,138,nan
Stimme,04B3N,4,Charlottenburg-Wilmersdorf,3N,B,043N,3,80,W,0,0,0,0,0,0,0,0,0,0,04B3M
Stimme,04B3P,4,Charlottenburg-Wilmersdorf,3P,B,043P,3,80,W,0,0,0,0,472,472,0,472,286,186,nan
Stimme,04B3Q,4,Charlottenburg-Wilmersdorf,3Q,B,043Q,3,80,W,0,0,0,0,0,0,0,0,0,0,04B3P
Stimme,04B3R,4,Charlottenburg-Wilmersdorf,3R,B,043R,3,80,W,0,0,0,0,674,674,2,672,457,215,nan
Stimme,04B3S,4,Charlottenburg-Wilmersdorf,3S,B,043S,3,80,W,0,0,0,0,0,0,0,0,0,0,04B3R
Stimme,04B3T,4,Charlottenburg-Wilmersdorf,3T,B,043T,3,80,W,0,0,0,0,409,409,1,408,256,152,nan
Stimme,04B3U,4,Charlottenburg-Wilmersdorf,3U,B,043U,3,80,W,0,0,0,0,0,0,0,0,0,0,04B3T
Stimme,04B3V,4,Charlottenburg-Wilmersdorf,3V,B,043V,3,80,W,0,0,0,0,581,581,2,579,315,264,nan
Stimme,04B3W,4,Charlottenburg-Wilmersdorf,3W,B,043W,3,80,W,0,0,0,0,0,0,0,0,0,0,04B3V
Stimme,04B4A,4,Charlottenburg-Wilmersdorf,4A,B,044A,4,80,W,0,0,0,0,428,428,2,426,237,189,nan
Stimme,04B4B,4,Charlottenburg-Wilmersdorf,4B,B,044B,4,80,W,0,0,0,0,0,0,0,0,0,0,04B4A
Stimme,04B4C,4,Charlottenburg-Wilmersdorf,4C,B,044C,4,80,W,0,0,0,0,495,495,0,495,286,209,nan
Stimme,04B4D,4,Charlottenburg-Wilmersdorf,4D,B,044D,4,80,W,0,0,0,0,0,0,0,0,0,0,04B4C
Stimme,04B4E,4,Charlottenburg-Wilmersdorf,4E,B,044E,4,80,W,0,0,0,0,393,393,0,393,251,142,nan
Stimme,04B4F,4,Charlottenburg-Wilmersdorf,4F,B,044F,4,80,W,0,0,0,0,0,0,0,0,0,0,04B4E
Stimme,04B4G,4,Charlottenburg-Wilmersdorf,4G,B,044G,4,80,W,0,0,0,0,420,420,1,419,230,189,nan
Stimme,04B4H,4,Charlottenburg-Wilmersdorf,4H,B,044H,4,80,W,0,0,0,0,0,0,0,0,0,0,04B4G
Stimme,04B4I,4,Charlottenburg-Wilmersdorf,4I,B,044I,4,80,W,0,0,0,0,391,391,0,391,246,145,nan
Stimme,04B4J,4,Charlottenburg-Wilmersdorf,4J,B,044J,4,80,W,0,0,0,0,0,0,0,0,0,0,04B4I
Stimme,04B4K,4,Charlottenburg-Wilmersdorf,4K,B,044K,4,80,W,0,0,0,0,488,488,0,488,296,192,nan
Stimme,04B4L,4,Charlottenburg-Wilmersdorf,4L,B,044L,4,80,W,0,0,0,0,0,0,0,0,0,0,04B4K
Stimme,04B4M,4,Charlottenburg-Wilmersdorf,4M,B,044M,4,80,W,0,0,0,0,515,515,1,514,271,243,nan
Stimme,04B4N,4,Charlottenburg-Wilmersdorf,4N,B,044N,4,80,W,0,0,0,0,0,0,0,0,0,0,04B4M
Stimme,04B4P,4,Charlottenburg-Wilmersdorf,4P,B,044P,4,80,W,0,0,0,0,519,519,2,517,311,206,nan
Stimme,04B4Q,4,Charlottenburg-Wilmersdorf,4Q,B,044Q,4,80,W,0,0,0,0,0,0,0,0,0,0,04B4P
Stimme,04B4R,4,Charlottenburg-Wilmersdorf,4R,B,044R,4,80,W,0,0,0,0,434,434,0,434,235,199,nan
Stimme,04B4S,4,Charlottenburg-Wilmersdorf,4S,B,044S,4,80,W,0,0,0,0,0,0,0,0,0,0,04B4R
Stimme,04B4T,4,Charlottenburg-Wilmersdorf,4T,B,044T,4,80,W,0,0,0,0,394,394,1,393,185,208,nan
Stimme,04B4U,4,Charlottenburg-Wilmersdorf,4U,B,044U,4,80,W,0,0,0,0,0,0,0,0,0,0,04B4T
Stimme,04B4V,4,Charlottenburg-Wilmersdorf,4V,B,044V,4,80,W,0,0,0,0,410,410,2,408,185,223,nan
Stimme,04B4W,4,Charlottenburg-Wilmersdorf,4W,B,044W,4,80,W,0,0,0,0,0,0,0,0,0,0,04B4V
Stimme,04B4X,4,Charlottenburg-Wilmersdorf,4X,B,044X,4,80,W,0,0,0,0,435,435,1,434,259,175,nan
Stimme,04B4Y,4,Charlottenburg-Wilmersdorf,4Y,B,044Y,4,80,W,0,0,0,0,0,0,0,0,0,0,04B4X
Stimme,04B5A,4,Charlottenburg-Wilmersdorf,5A,B,045A,5,80,W,0,0,0,0,560,560,1,559,167,392,nan
Stimme,04B5B,4,Charlottenburg-Wilmersdorf,5B,B,045B,5,80,W,0,0,0,0,0,0,0,0,0,0,04B5A
Stimme,04B5C,4,Charlottenburg-Wilmersdorf,5C,B,045C,5,80,W,0,0,0,0,374,374,8,366,128,238,nan
Stimme,04B5D,4,Charlottenburg-Wilmersdorf,5D,B,045D,5,80,W,0,0,0,0,0,0,0,0,0,0,04B5C
Stimme,04B5E,4,Charlottenburg-Wilmersdorf,5E,B,045E,5,80,W,0,0,0,0,606,606,0,606,319,287,nan
Stimme,04B5F,4,Charlottenburg-Wilmersdorf,5F,B,045F,5,80,W,0,0,0,0,0,0,0,0,0,0,04B5E
Stimme,04B5G,4,Charlottenburg-Wilmersdorf,5G,B,045G,5,80,W,0,0,0,0,510,510,0,510,263,247,nan
Stimme,04B5H,4,Charlottenburg-Wilmersdorf,5H,B,045H,5,80,W,0,0,0,0,0,0,0,0,0,0,04B5G
Stimme,04B5I,4,Charlottenburg-Wilmersdorf,5I,B,045I,5,80,W,0,0,0,0,533,533,2,531,248,283,nan
Stimme,04B5J,4,Charlottenburg-Wilmersdorf,5J,B,045J,5,80,W,0,0,0,0,0,0,0,0,0,0,04B5I
Stimme,04B5K,4,Charlottenburg-Wilmersdorf,5K,B,045K,5,80,W,0,0,0,0,585,585,0,585,298,287,nan
Stimme,04B5L,4,Charlottenburg-Wilmersdorf,5L,B,045L,5,80,W,0,0,0,0,0,0,0,0,0,0,04B5K
Stimme,04B5M,4,Charlottenburg-Wilmersdorf,5M,B,045M,5,80,W,0,0,0,0,625,625,1,624,307,317,nan
Stimme,04B5N,4,Charlottenburg-Wilmersdorf,5N,B,045N,5,80,W,0,0,0,0,0,0,0,0,0,0,04B5M
Stimme,04B5P,4,Charlottenburg-Wilmersdorf,5P,B,045P,5,80,W,0,0,0,0,396,396,1,395,171,224,nan
Stimme,04B5Q,4,Charlottenburg-Wilmersdorf,5Q,B,045Q,5,80,W,0,0,0,0,0,0,0,0,0,0,04B5P
Stimme,04B5R,4,Charlottenburg-Wilmersdorf,5R,B,045R,5,80,W,0,0,0,0,365,365,3,362,109,253,nan
Stimme,04B5S,4,Charlottenburg-Wilmersdorf,5S,B,045S,5,80,W,0,0,0,0,0,0,0,0,0,0,04B5R
Stimme,04B5T,4,Charlottenburg-Wilmersdorf,5T,B,045T,5,80,W,0,0,0,0,511,511,1,510,125,385,nan
Stimme,04B5U,4,Charlottenburg-Wilmersdorf,5U,B,045U,5,80,W,0,0,0,0,0,0,0,0,0,0,04B5T
Stimme,04B5V,4,Charlottenburg-Wilmersdorf,5V,B,045V,5,80,W,0,0,0,0,332,332,1,331,142,189,nan
Stimme,04B5W,4,Charlottenburg-Wilmersdorf,5W,B,045W,5,80,W,0,0,0,0,0,0,0,0,0,0,04B5V
Stimme,04B6A,4,Charlottenburg-Wilmersdorf,6A,B,046A,6,80,W,0,0,0,0,698,698,0,698,378,320,nan
Stimme,04B6B,4,Charlottenburg-Wilmersdorf,6B,B,046B,6,80,W,0,0,0,0,0,0,0,0,0,0,04B6A
Stimme,04B6C,4,Charlottenburg-Wilmersdorf,6C,B,046C,6,80,W,0,0,0,0,489,489,0,489,264,225,nan
Stimme,04B6D,4,Charlottenburg-Wilmersdorf,6D,B,046D,6,80,W,0,0,0,0,0,0,0,0,0,0,04B6C
Stimme,04B6E,4,Charlottenburg-Wilmersdorf,6E,B,046E,6,80,W,0,0,0,0,446,446,0,446,216,230,nan
Stimme,04B6F,4,Charlottenburg-Wilmersdorf,6F,B,046F,6,80,W,0,0,0,0,0,0,0,0,0,0,04B6E
Stimme,04B6G,4,Charlottenburg-Wilmersdorf,6G,B,046G,6,80,W,0,0,0,0,418,418,0,418,222,196,nan
Stimme,04B6H,4,Charlottenburg-Wilmersdorf,6H,B,046H,6,80,W,0,0,0,0,0,0,0,0,0,0,04B6G
Stimme,04B6I,4,Charlottenburg-Wilmersdorf,6I,B,046I,6,80,W,0,0,0,0,567,567,2,565,333,232,nan
Stimme,04B6J,4,Charlottenburg-Wilmersdorf,6J,B,046J,6,80,W,0,0,0,0,0,0,0,0,0,0,04B6I
Stimme,04B6K,4,Charlottenburg-Wilmersdorf,6K,B,046K,6,80,W,0,0,0,0,469,469,0,469,239,230,nan
Stimme,04B6L,4,Charlottenburg-Wilmersdorf,6L,B,046L,6,80,W,0,0,0,0,0,0,0,0,0,0,04B6K
Stimme,04B6M,4,Charlottenburg-Wilmersdorf,6M,B,046M,6,80,W,0,0,0,0,429,429,4,425,274,151,nan
Stimme,04B6N,4,Charlottenburg-Wilmersdorf,6N,B,046N,6,80,W,0,0,0,0,0,0,0,0,0,0,04B6M
Stimme,04B6P,4,Charlottenburg-Wilmersdorf,6P,B,046P,6,80,W,0,0,0,0,430,430,10,420,258,162,nan
Stimme,04B6Q,4,Charlottenburg-Wilmersdorf,6Q,B,046Q,6,80,W,0,0,0,0,0,0,0,0,0,0,04B6P
Stimme,04B6R,4,Charlottenburg-Wilmersdorf,6R,B,046R,6,80,W,0,0,0,0,529,529,1,528,304,224,nan
Stimme,04B6S,4,Charlottenburg-Wilmersdorf,6S,B,046S,6,80,W,0,0,0,0,0,0,0,0,0,0,04B6R
Stimme,04B6T,4,Charlottenburg-Wilmersdorf,6T,B,046T,6,80,W,0,0,0,0,458,458,2,456,268,188,nan
Stimme,04B6U,4,Charlottenburg-Wilmersdorf,6U,B,046U,6,80,W,0,0,0,0,0,0,0,0,0,0,04B6T
Stimme,04B6V,4,Charlottenburg-Wilmersdorf,6V,B,046V,6,80,W,0,0,0,0,426,426,1,425,285,140,nan
Stimme,04B6W,4,Charlottenburg-Wilmersdorf,6W,B,046W,6,80,W,0,0,0,0,0,0,0,0,0,0,04B6V
Stimme,04B6X,4,Charlottenburg-Wilmersdorf,6X,B,046X,6,80,W,0,0,0,0,344,344,0,344,211,133,nan
Stimme,04B6Y,4,Charlottenburg-Wilmersdorf,6Y,B,046Y,6,80,W,0,0,0,0,0,0,0,0,0,0,04B6X
Stimme,04B7A,4,Charlottenburg-Wilmersdorf,7A,B,047A,7,80,W,0,0,0,0,414,414,0,414,230,184,nan
Stimme,04B7B,4,Charlottenburg-Wilmersdorf,7B,B,047B,7,80,W,0,0,0,0,0,0,0,0,0,0,04B7A
Stimme,04B7C,4,Charlottenburg-Wilmersdorf,7C,B,047C,7,80,W,0,0,0,0,415,415,0,415,247,168,nan
Stimme,04B7D,4,Charlottenburg-Wilmersdorf,7D,B,047D,7,80,W,0,0,0,0,0,0,0,0,0,0,04B7C
Stimme,04B7E,4,Charlottenburg-Wilmersdorf,7E,B,047E,7,80,W,0,0,0,0,447,447,0,447,294,153,nan
Stimme,04B7F,4,Charlottenburg-Wilmersdorf,7F,B,047F,7,80,W,0,0,0,0,0,0,0,0,0,0,04B7E
Stimme,04B7G,4,Charlottenburg-Wilmersdorf,7G,B,047G,7,80,W,0,0,0,0,367,367,0,367,207,160,nan
Stimme,04B7H,4,Charlottenburg-Wilmersdorf,7H,B,047H,7,80,W,0,0,0,0,0,0,0,0,0,0,04B7G
Stimme,04B7I,4,Charlottenburg-Wilmersdorf,7I,B,047I,7,80,W,0,0,0,0,513,513,5,508,233,275,nan
Stimme,04B7J,4,Charlottenburg-Wilmersdorf,7J,B,047J,7,80,W,0,0,0,0,0,0,0,0,0,0,04B7I
Stimme,04B7K,4,Charlottenburg-Wilmersdorf,7K,B,047K,7,80,W,0,0,0,0,539,539,0,539,273,266,nan
Stimme,04B7L,4,Charlottenburg-Wilmersdorf,7L,B,047L,7,80,W,0,0,0,0,0,0,0,0,0,0,04B7K
Stimme,04B7M,4,Charlottenburg-Wilmersdorf,7M,B,047M,7,80,W,0,0,0,0,446,446,2,444,230,214,nan
Stimme,04B7N,4,Charlottenburg-Wilmersdorf,7N,B,047N,7,80,W,0,0,0,0,0,0,0,0,0,0,04B7M
Stimme,04B7P,4,Charlottenburg-Wilmersdorf,7P,B,047P,7,80,W,0,0,0,0,460,460,0,460,210,250,nan
Stimme,04B7Q,4,Charlottenburg-Wilmersdorf,7Q,B,047Q,7,80,W,0,0,0,0,0,0,0,0,0,0,04B7P
Stimme,04B7R,4,Charlottenburg-Wilmersdorf,7R,B,047R,7,80,W,0,0,0,0,607,607,1,606,284,322,nan
Stimme,04B7S,4,Charlottenburg-Wilmersdorf,7S,B,047S,7,80,W,0,0,0,0,0,0,0,0,0,0,04B7R
Stimme,04B7T,4,Charlottenburg-Wilmersdorf,7T,B,047T,7,80,W,0,0,0,0,453,453,2,451,188,263,nan
Stimme,04B7U,4,Charlottenburg-Wilmersdorf,7U,B,047U,7,80,W,0,0,0,0,0,0,0,0,0,0,04B7T
Stimme,04B7V,4,Charlottenburg-Wilmersdorf,7V,B,047V,7,80,W,0,0,0,0,572,572,2,570,251,319,nan
Stimme,04B7W,4,Charlottenburg-Wilmersdorf,7W,B,047W,7,80,W,0,0,0,0,0,0,0,0,0,0,04B7V
Stimme,04B7X,4,Charlottenburg-Wilmersdorf,7X,B,047X,7,80,W,0,0,0,0,505,505,3,502,232,270,nan
Stimme,04B7Y,4,Charlottenburg-Wilmersdorf,7Y,B,047Y,7,80,W,0,0,0,0,0,0,0,0,0,0,04B7X
Stimme,04B7Z,4,Charlottenburg-Wilmersdorf,7Z,B,047Z,7,80,W,0,0,0,0,240,240,0,240,122,118,nan
Stimme,04B8A,4,Charlottenburg-Wilmersdorf,8A,B,048A,1,80,W,0,0,0,0,208,208,4,204,145,59,nan
Stimme,04B8B,4,Charlottenburg-Wilmersdorf,8B,B,048B,1,80,W,0,0,0,0,454,454,2,452,254,198,nan
Stimme,04B8C,4,Charlottenburg-Wilmersdorf,8C,B,048C,1,80,W,0,0,0,0,0,0,0,0,0,0,04B8B
Stimme,04B8D,4,Charlottenburg-Wilmersdorf,8D,B,048D,1,80,W,0,0,0,0,302,302,0,302,184,118,nan
Stimme,04B8E,4,Charlottenburg-Wilmersdorf,8E,B,048E,1,80,W,0,0,0,0,0,0,0,0,0,0,04B8D
Stimme,04B8F,4,Charlottenburg-Wilmersdorf,8F,B,048F,1,80,W,0,0,0,0,458,458,1,457,283,174,nan
Stimme,04B8G,4,Charlottenburg-Wilmersdorf,8G,B,048G,1,80,W,0,0,0,0,0,0,0,0,0,0,04B8F
Stimme,05W101,5,Spandau,101,W,051A,1,78,W,731,659,72,0,133,1,0,133,88,45,nan
Stimme,05W102,5,Spandau,102,W,051B,1,78,W,1133,906,227,0,167,0,0,167,58,109,nan
Stimme,05W103,5,Spandau,103,W,051A,1,78,W,1018,855,163,0,297,3,1,296,125,171,nan
Stimme,05W104,5,Spandau,104,W,051B,1,78,W,928,805,123,0,146,0,1,145,46,99,nan
Stimme,05W105,5,Spandau,105,W,051M,1,78,W,1001,761,240,0,213,1,2,211,57,154,nan
Stimme,05W106,5,Spandau,106,W,051N,1,78,W,1153,924,229,0,222,1,1,221,64,157,nan
Stimme,05W107,5,Spandau,107,W,051M,1,78,W,801,683,118,0,140,0,0,140,45,95,nan
Stimme,05W108,5,Spandau,108,W,051C,1,78,W,927,806,121,0,69,0,0,69,27,42,nan
Stimme,05W109,5,Spandau,109,W,051E,1,78,W,0,0,0,0,0,0,0,0,0,0,05W113
Stimme,05W110,5,Spandau,110,W,051J,1,78,W,841,710,131,0,131,3,1,130,62,68,nan
Stimme,05W111,5,Spandau,111,W,051L,1,78,W,1198,1040,158,0,185,4,1,184,67,117,nan
Stimme,05W112,5,Spandau,112,W,051J,1,78,W,1048,869,179,0,157,0,0,157,51,106,nan
Stimme,05W113,5,Spandau,113,W,051L,1,78,W,1661,1353,308,0,254,4,0,254,114,140,nan
Stimme,05W114,5,Spandau,114,W,051G,1,78,W,875,718,157,0,147,1,0,147,57,90,nan
Stimme,05W115,5,Spandau,115,W,051G,1,78,W,985,888,97,0,149,0,0,149,57,92,nan
Stimme,05W116,5,Spandau,116,W,051N,1,78,W,749,653,96,0,102,0,1,101,31,70,nan
Stimme,05W117,5,Spandau,117,W,051Q,1,78,W,954,884,70,0,86,0,0,86,30,56,nan
Stimme,05W118,5,Spandau,118,W,051H,1,78,W,1362,1177,185,0,146,0,0,146,60,86,nan
Stimme,05W119,5,Spandau,119,W,051K,1,78,W,1165,938,227,0,155,0,0,155,47,108,nan
Stimme,05W120,5,Spandau,120,W,051E,1,78,W,1211,1107,104,0,185,2,0,185,65,120,nan
Stimme,05W121,5,Spandau,121,W,051D,1,78,W,1139,1023,116,0,155,1,0,155,37,118,nan
Stimme,05W122,5,Spandau,122,W,051R,1,78,W,834,744,90,0,80,0,0,80,19,61,nan
Stimme,05W123,5,Spandau,123,W,051R,1,78,W,718,614,104,0,100,3,0,100,29,71,nan
Stimme,05W124,5,Spandau,124,W,051Q,1,78,W,1292,1093,199,0,185,1,0,185,46,139,nan
Stimme,05W125,5,Spandau,125,W,051P,1,78,W,962,866,96,0,89,0,0,89,29,60,nan
Stimme,05W126,5,Spandau,126,W,051P,1,78,W,1117,1012,105,0,110,1,3,107,41,66,nan
Stimme,05W127,5,Spandau,127,W,051P,1,78,W,892,828,64,0,76,0,0,76,19,57,nan
Stimme,05W128,5,Spandau,128,W,051S,1,78,W,868,794,74,0,60,1,0,60,16,44,nan
Stimme,05W129,5,Spandau,129,W,051S,1,78,W,952,858,94,0,108,0,0,108,35,73,nan
Stimme,05W130,5,Spandau,130,W,051S,1,78,W,1086,1017,69,0,147,0,0,147,33,114,nan
Stimme,05W131,5,Spandau,131,W,051E,1,78,W,524,418,106,0,82,0,1,81,47,34,nan
Stimme,05W132,5,Spandau,132,W,051G,1,78,W,1190,1056,134,0,129,2,1,128,46,82,nan
Stimme,05W133,5,Spandau,133,W,051C,1,78,W,1195,986,209,0,119,2,0,119,37,82,nan
Stimme,05W134,5,Spandau,134,W,051F,1,78,W,1092,965,127,0,106,0,0,106,40,66,nan
Stimme,05W201,5,Spandau,201,W,052L,2,78,W,1209,1052,157,0,199,2,1,198,58,140,nan
Stimme,05W202,5,Spandau,202,W,052J,2,78,W,1074,946,128,0,97,1,0,97,30,67,nan
Stimme,05W203,5,Spandau,203,W,052M,2,78,W,1159,1089,70,0,121,0,0,121,38,83,nan
Stimme,05W204,5,Spandau,204,W,052M,2,78,W,879,805,74,0,106,1,0,106,32,74,nan
Stimme,05W205,5,Spandau,205,W,052M,2,78,W,983,872,111,0,119,2,1,118,45,73,nan
Stimme,05W206,5,Spandau,206,W,052P,2,78,W,660,568,92,0,102,4,1,101,53,48,nan
Stimme,05W207,5,Spandau,207,W,052J,2,78,W,1005,944,61,0,66,0,0,66,24,42,nan
Stimme,05W208,5,Spandau,208,W,052D,2,78,W,1008,900,108,0,146,0,1,145,75,70,nan
Stimme,05W209,5,Spandau,209,W,052A,2,78,W,969,828,141,0,143,0,2,141,48,93,nan
Stimme,05W210,5,Spandau,210,W,052C,2,78,W,1042,938,104,0,140,3,1,139,74,65,nan
Stimme,05W211,5,Spandau,211,W,052B,2,78,W,765,679,86,0,115,0,0,115,36,79,nan
Stimme,05W212,5,Spandau,212,W,052Q,2,78,W,863,761,102,0,135,0,1,134,49,85,nan
Stimme,05W213,5,Spandau,213,W,052L,2,78,W,966,822,144,0,219,2,1,218,56,162,nan
Stimme,05W214,5,Spandau,214,W,052K,2,78,W,1148,1049,99,0,105,0,0,105,29,76,nan
Stimme,05W215,5,Spandau,215,W,052H,2,78,W,1023,928,95,0,97,0,1,96,37,59,nan
Stimme,05W216,5,Spandau,216,W,052E,2,78,W,942,774,168,0,115,1,0,115,38,77,nan
Stimme,05W217,5,Spandau,217,W,052R,2,78,W,707,619,88,0,109,0,0,109,33,76,nan
Stimme,05W218,5,Spandau,218,W,052E,2,78,W,928,801,127,0,159,0,0,159,66,93,nan
Stimme,05W219,5,Spandau,219,W,052D,2,78,W,1192,1055,137,0,185,4,0,185,80,105,nan
Stimme,05W220,5,Spandau,220,W,052R,2,78,W,990,883,107,0,125,3,0,125,41,84,nan
Stimme,05W221,5,Spandau,221,W,052F,2,78,W,785,674,111,0,123,0,0,123,53,70,nan
Stimme,05W222,5,Spandau,222,W,052D,2,78,W,843,706,137,0,167,5,1,166,67,99,nan
Stimme,05W223,5,Spandau,223,W,052F,2,78,W,1024,914,110,0,116,0,0,116,47,69,nan
Stimme,05W224,5,Spandau,224,W,052F,2,78,W,865,766,99,0,143,4,1,142,60,82,nan
Stimme,05W225,5,Spandau,225,W,052B,2,78,W,944,880,64,0,145,0,0,145,58,87,nan
Stimme,05W226,5,Spandau,226,W,052N,2,78,W,995,816,179,0,149,0,0,149,53,96,nan
Stimme,05W227,5,Spandau,227,W,052C,2,78,W,1225,1083,142,0,106,2,0,106,40,66,nan
Stimme,05W228,5,Spandau,228,W,052Q,2,78,W,703,615,88,0,151,1,0,151,42,109,nan
Stimme,05W229,5,Spandau,229,W,052G,2,78,W,950,837,113,0,72,0,0,72,21,51,nan
Stimme,05W230,5,Spandau,230,W,052A,2,78,W,619,549,70,0,77,0,1,76,34,42,nan
Stimme,05W301,5,Spandau,301,W,053N,3,78,W,1160,998,162,0,161,0,0,161,48,113,nan
Stimme,05W302,5,Spandau,302,W,053F,3,78,W,892,833,59,0,118,1,1,117,41,76,nan
Stimme,05W303,5,Spandau,303,W,053F,3,78,W,908,688,220,0,171,3,0,171,60,111,nan
Stimme,05W304,5,Spandau,304,W,053S,3,78,W,1356,1091,265,0,212,1,3,209,66,143,nan
Stimme,05W305,5,Spandau,305,W,053V,3,78,W,1164,1083,81,0,149,0,0,149,44,105,nan
Stimme,05W306,5,Spandau,306,W,053E,3,78,W,811,667,144,0,135,0,0,135,56,79,nan
Stimme,05W307,5,Spandau,307,W,053Q,3,78,W,1217,1102,115,0,154,0,0,154,62,92,nan
Stimme,05W308,5,Spandau,308,W,053R,3,78,W,1143,1012,131,0,212,0,1,211,69,142,nan
Stimme,05W309,5,Spandau,309,W,053R,3,78,W,1279,1093,186,0,105,0,0,105,34,71,nan
Stimme,05W310,5,Spandau,310,W,053A,3,78,W,1134,954,180,0,185,2,0,185,82,103,nan
Stimme,05W311,5,Spandau,311,W,053A,3,78,W,1105,941,164,0,207,2,1,206,115,91,nan
Stimme,05W312,5,Spandau,312,W,053E,3,78,W,903,792,111,0,151,0,0,151,59,92,nan
Stimme,05W313,5,Spandau,313,W,053G,3,78,W,1288,1115,173,0,218,0,0,218,88,130,nan
Stimme,05W314,5,Spandau,314,W,053D,3,78,W,1155,1000,155,0,194,1,1,193,74,119,nan
Stimme,05W315,5,Spandau,315,W,053K,3,78,W,1130,881,249,0,321,2,2,319,179,140,nan
Stimme,05W316,5,Spandau,316,W,053B,3,78,W,1255,1059,196,0,186,0,0,186,64,122,nan
Stimme,05W317,5,Spandau,317,W,053P,3,78,W,1057,960,97,0,122,2,0,122,52,70,nan
Stimme,05W318,5,Spandau,318,W,053B,3,78,W,1147,977,170,0,175,1,0,175,80,95,nan
Stimme,05W319,5,Spandau,319,W,053K,3,78,W,642,605,37,0,55,0,3,52,20,32,nan
Stimme,05W320,5,Spandau,320,W,053Q,3,78,W,915,849,65,1,124,0,1,123,35,88,nan
Stimme,05W321,5,Spandau,321,W,053C,3,78,W,1106,925,181,0,167,1,0,167,82,85,nan
Stimme,05W322,5,Spandau,322,W,053C,3,78,W,1068,948,120,0,172,2,0,172,75,97,nan
Stimme,05W323,5,Spandau,323,W,053M,3,78,W,839,726,113,0,79,1,0,79,28,51,nan
Stimme,05W324,5,Spandau,324,W,053L,3,78,W,1070,962,108,0,161,0,1,160,49,111,nan
Stimme,05W325,5,Spandau,325,W,053J,3,78,W,1213,1048,165,0,238,3,2,236,123,113,nan
Stimme,05W326,5,Spandau,326,W,053D,3,78,W,1062,907,155,0,96,0,1,95,38,57,nan
Stimme,05W327,5,Spandau,327,W,053J,3,78,W,1031,859,172,0,200,2,1,199,93,106,nan
Stimme,05W328,5,Spandau,328,W,053H,3,78,W,1190,1020,170,0,180,3,0,180,84,96,nan
Stimme,05W329,5,Spandau,329,W,053H,3,78,W,936,791,145,0,135,0,0,135,69,66,nan
Stimme,05W330,5,Spandau,330,W,053U,3,78,W,707,595,112,0,76,2,0,76,32,44,nan
Stimme,05W331,5,Spandau,331,W,053T,3,78,W,577,506,71,0,58,1,0,58,18,40,nan
Stimme,05W332,5,Spandau,332,W,053V,3,78,W,0,0,0,0,0,0,0,0,0,0,05W304
Stimme,05W401,5,Spandau,401,W,054C,4,78,W,1356,1053,303,0,193,2,0,193,60,133,nan
Stimme,05W402,5,Spandau,402,W,054D,4,78,W,703,589,114,0,142,1,0,142,61,81,nan
Stimme,05W403,5,Spandau,403,W,054C,4,78,W,929,746,183,0,214,4,1,213,62,151,nan
Stimme,05W404,5,Spandau,404,W,054R,4,78,W,1015,806,209,0,204,1,0,204,67,137,nan
Stimme,05W405,5,Spandau,405,W,054D,4,78,W,1054,858,196,0,242,2,2,240,62,178,nan
Stimme,05W406,5,Spandau,406,W,054L,4,78,W,983,841,142,0,137,0,0,137,26,111,nan
Stimme,05W407,5,Spandau,407,W,054H,4,78,W,974,757,217,0,230,0,0,230,70,160,nan
Stimme,05W408,5,Spandau,408,W,054F,4,78,W,824,789,35,0,76,0,0,76,28,48,nan
Stimme,05W409,5,Spandau,409,W,054F,4,78,W,1080,867,213,0,235,3,0,235,45,190,nan
Stimme,05W410,5,Spandau,410,W,054B,4,78,W,1293,1113,180,0,144,2,0,144,35,109,nan
Stimme,05W411,5,Spandau,411,W,054K,4,78,W,996,897,99,0,139,1,0,139,43,96,nan
Stimme,05W412,5,Spandau,412,W,054J,4,78,W,1275,1116,159,0,177,1,0,177,50,127,nan
Stimme,05W413,5,Spandau,413,W,054E,4,78,W,1335,1114,221,0,179,2,0,179,61,118,nan
Stimme,05W414,5,Spandau,414,W,054J,4,78,W,764,696,68,0,112,0,0,112,24,88,nan
Stimme,05W415,5,Spandau,415,W,054L,4,78,W,1249,1115,134,0,105,0,1,104,23,81,nan
Stimme,05W416,5,Spandau,416,W,054U,4,78,W,1221,872,349,0,173,1,0,173,48,125,nan
Stimme,05W417,5,Spandau,417,W,054Q,4,78,W,937,745,192,0,235,3,0,235,75,160,nan
Stimme,05W418,5,Spandau,418,W,054A,4,78,W,717,638,79,0,83,1,0,83,15,68,nan
Stimme,05W419,5,Spandau,419,W,054S,4,78,W,1076,807,269,0,213,1,2,211,67,144,nan
Stimme,05W420,5,Spandau,420,W,054T,4,78,W,1071,741,330,0,195,5,0,195,61,134,nan
Stimme,05W421,5,Spandau,421,W,054G,4,78,W,1194,1096,98,0,153,0,0,153,51,102,nan
Stimme,05W422,5,Spandau,422,W,054G,4,78,W,953,866,87,0,80,0,0,80,27,53,nan
Stimme,05W423,5,Spandau,423,W,054A,4,78,W,815,706,109,0,99,0,0,99,16,83,nan
Stimme,05W424,5,Spandau,424,W,054B,4,78,W,1189,1029,160,0,177,5,1,176,52,124,nan
Stimme,05W425,5,Spandau,425,W,054P,4,78,W,997,831,166,0,159,4,0,159,52,107,nan
Stimme,05W426,5,Spandau,426,W,054N,4,78,W,1168,952,216,0,216,1,0,216,67,149,nan
Stimme,05W427,5,Spandau,427,W,054G,4,78,W,745,684,61,0,93,0,0,93,31,62,nan
Stimme,05W428,5,Spandau,428,W,054S,4,78,W,1083,897,186,0,219,0,0,219,68,151,nan
Stimme,05W429,5,Spandau,429,W,054K,4,78,W,942,782,160,0,194,3,0,194,76,118,nan
Stimme,05W430,5,Spandau,430,W,054M,4,78,W,1007,840,167,0,174,1,0,174,61,113,nan
Stimme,05W501,5,Spandau,501,W,055E,5,78,W,983,851,132,0,168,1,2,166,67,99,nan
Stimme,05W502,5,Spandau,502,W,055F,5,78,W,1175,1001,174,0,269,2,0,269,118,151,nan
Stimme,05W503,5,Spandau,503,W,055J,5,78,W,780,607,173,0,214,0,0,214,74,140,nan
Stimme,05W504,5,Spandau,504,W,055J,5,78,W,911,696,215,0,236,4,0,236,76,160,nan
Stimme,05W505,5,Spandau,505,W,055H,5,78,W,1097,834,263,0,194,1,1,193,81,112,nan
Stimme,05W506,5,Spandau,506,W,055A,5,78,W,1068,887,181,0,281,2,0,281,80,201,nan
Stimme,05W507,5,Spandau,507,W,055L,5,78,W,985,762,223,0,282,1,3,279,92,187,nan
Stimme,05W508,5,Spandau,508,W,055M,5,78,W,968,743,225,0,264,0,3,261,84,177,nan
Stimme,05W509,5,Spandau,509,W,055P,5,78,W,695,530,165,0,121,0,0,121,44,77,nan
Stimme,05W510,5,Spandau,510,W,055R,5,78,W,965,786,179,0,232,1,0,232,76,156,nan
Stimme,05W511,5,Spandau,511,W,055V,5,78,W,911,685,226,0,248,1,1,247,64,183,nan
Stimme,05W512,5,Spandau,512,W,055K,5,78,W,855,656,199,0,207,3,1,206,67,139,nan
Stimme,05W513,5,Spandau,513,W,055Y,5,78,W,970,807,163,0,271,1,1,270,91,179,nan
Stimme,05W514,5,Spandau,514,W,055D,5,78,W,979,884,95,0,76,0,0,76,21,55,nan
Stimme,05W515,5,Spandau,515,W,055G,5,78,W,1067,872,195,0,191,1,1,190,56,134,nan
Stimme,05W516,5,Spandau,516,W,055T,5,78,W,1193,950,243,0,294,6,1,293,98,195,nan
Stimme,05W517,5,Spandau,517,W,055F,5,78,W,994,855,139,0,150,0,0,150,48,102,nan
Stimme,05W518,5,Spandau,518,W,055Z,5,78,W,915,696,219,0,239,4,3,236,81,155,nan
Stimme,05W519,5,Spandau,519,W,055B,5,78,W,962,805,157,0,151,3,0,151,39,112,nan
Stimme,05W520,5,Spandau,520,W,055B,5,78,W,1121,1002,119,0,154,0,1,153,30,123,nan
Stimme,05W521,5,Spandau,521,W,055D,5,78,W,1108,1010,98,0,89,0,1,88,39,49,nan
Stimme,05W522,5,Spandau,522,W,055Q,5,78,W,951,761,190,0,263,4,0,263,93,170,nan
Stimme,05W523,5,Spandau,523,W,055W,5,78,W,956,732,224,0,204,1,1,203,68,135,nan
Stimme,05W524,5,Spandau,524,W,055S,5,78,W,963,709,254,0,208,1,1,207,89,118,nan
Stimme,05W525,5,Spandau,525,W,055L,5,78,W,800,619,181,0,198,2,1,197,78,119,nan
Stimme,05W526,5,Spandau,526,W,055C,5,78,W,1120,935,185,0,245,1,1,244,71,173,nan
Stimme,05W527,5,Spandau,527,W,055D,5,78,W,1390,1318,72,0,80,0,1,79,32,47,nan
Stimme,05W528,5,Spandau,528,W,055R,5,78,W,884,723,161,0,262,9,2,260,89,171,nan
Stimme,05W529,5,Spandau,529,W,055U,5,78,W,901,701,200,0,239,2,1,238,89,149,nan
Stimme,05W530,5,Spandau,530,W,055E,5,78,W,957,837,120,0,174,0,1,173,65,108,nan
Stimme,05W531,5,Spandau,531,W,055N,5,78,W,784,611,173,0,184,2,1,183,66,117,nan
Stimme,05W532,5,Spandau,532,W,055X,5,78,W,1021,855,166,0,326,5,1,325,104,221,nan
Stimme,05B1A,5,Spandau,1A,B,051A,1,78,W,0,0,0,0,544,544,1,543,232,311,nan
Stimme,05B1B,5,Spandau,1B,B,051B,1,78,W,0,0,0,0,0,0,0,0,0,0,05B1A
Stimme,05B1C,5,Spandau,1C,B,051C,1,78,W,0,0,0,0,361,361,0,361,146,215,nan
Stimme,05B1D,5,Spandau,1D,B,051D,1,78,W,0,0,0,0,0,0,0,0,0,0,05B1C
Stimme,05B1E,5,Spandau,1E,B,051E,1,78,W,0,0,0,0,377,377,1,376,170,206,nan
Stimme,05B1F,5,Spandau,1F,B,051F,1,78,W,0,0,0,0,0,0,0,0,0,0,05B1E
Stimme,05B1G,5,Spandau,1G,B,051G,1,78,W,0,0,0,0,480,480,2,478,185,293,nan
Stimme,05B1H,5,Spandau,1H,B,051H,1,78,W,0,0,0,0,0,0,0,0,0,0,05B1G
Stimme,05B1J,5,Spandau,1J,B,051J,1,78,W,0,0,0,0,464,464,1,463,168,295,nan
Stimme,05B1K,5,Spandau,1K,B,051K,1,78,W,0,0,0,0,0,0,0,0,0,0,05B1J
Stimme,05B1L,5,Spandau,1L,B,051L,1,78,W,0,0,0,0,628,628,1,627,192,435,nan
Stimme,05B1M,5,Spandau,1M,B,051M,1,78,W,0,0,0,0,0,0,0,0,0,0,05B1L
Stimme,05B1N,5,Spandau,1N,B,051N,1,78,W,0,0,0,0,495,495,3,492,168,324,nan
Stimme,05B1P,5,Spandau,1P,B,051P,1,78,W,0,0,0,0,0,0,0,0,0,0,05B1N
Stimme,05B1Q,5,Spandau,1Q,B,051Q,1,78,W,0,0,0,0,389,389,2,387,111,276,nan
Stimme,05B1R,5,Spandau,1R,B,051R,1,78,W,0,0,0,0,0,0,0,0,0,0,05B1Q
Stimme,05B1S,5,Spandau,1S,B,051S,1,78,W,0,0,0,0,206,206,2,204,82,122,nan
Stimme,05B2A,5,Spandau,2A,B,052A,2,78,W,0,0,0,0,287,287,1,286,118,168,nan
Stimme,05B2B,5,Spandau,2B,B,052B,2,78,W,0,0,0,0,0,0,0,0,0,0,05B2A
Stimme,05B2C,5,Spandau,2C,B,052C,2,78,W,0,0,0,0,522,522,2,520,265,255,nan
Stimme,05B2D,5,Spandau,2D,B,052D,2,78,W,0,0,0,0,0,0,0,0,0,0,05B2C
Stimme,05B2E,5,Spandau,2E,B,052E,2,78,W,0,0,0,0,518,518,0,518,230,288,nan
Stimme,05B2F,5,Spandau,2F,B,052F,2,78,W,0,0,0,0,0,0,0,0,0,0,05B2E
Stimme,05B2G,5,Spandau,2G,B,052G,2,78,W,0,0,0,0,349,349,1,348,129,219,nan
Stimme,05B2H,5,Spandau,2H,B,052H,2,78,W,0,0,0,0,0,0,0,0,0,0,05B2G
Stimme,05B2J,5,Spandau,2J,B,052J,2,78,W,0,0,0,0,0,0,0,0,0,0,05B2G
Stimme,05B2K,5,Spandau,2K,B,052K,2,78,W,0,0,0,0,334,334,2,332,109,223,nan
Stimme,05B2L,5,Spandau,2L,B,052L,2,78,W,0,0,0,0,0,0,0,0,0,0,05B2K
Stimme,05B2M,5,Spandau,2M,B,052M,2,78,W,0,0,0,0,356,356,0,356,176,180,nan
Stimme,05B2N,5,Spandau,2N,B,052N,2,78,W,0,0,0,0,0,0,0,0,0,0,05B2M
Stimme,05B2P,5,Spandau,2P,B,052P,2,78,W,0,0,0,0,408,408,3,405,145,260,nan
Stimme,05B2Q,5,Spandau,2Q,B,052Q,2,78,W,0,0,0,0,0,0,0,0,0,0,05B2P
Stimme,05B2R,5,Spandau,2R,B,052R,2,78,W,0,0,0,0,0,0,0,0,0,0,05B2P
Stimme,05B3A,5,Spandau,3A,B,053A,3,78,W,0,0,0,0,609,609,2,607,283,324,nan
Stimme,05B3B,5,Spandau,3B,B,053B,3,78,W,0,0,0,0,0,0,0,0,0,0,05B3A
Stimme,05B3C,5,Spandau,3C,B,053C,3,78,W,0,0,0,0,515,515,0,515,265,250,nan
Stimme,05B3D,5,Spandau,3D,B,053D,3,78,W,0,0,0,0,0,0,0,0,0,0,05B3C
Stimme,05B3E,5,Spandau,3E,B,053E,3,78,W,0,0,0,0,609,609,0,609,267,342,nan
Stimme,05B3F,5,Spandau,3F,B,053F,3,78,W,0,0,0,0,0,0,0,0,0,0,05B3E
Stimme,05B3G,5,Spandau,3G,B,053G,3,78,W,0,0,0,0,0,0,0,0,0,0,05B3E
Stimme,05B3H,5,Spandau,3H,B,053H,3,78,W,0,0,0,0,524,524,0,524,263,261,nan
Stimme,05B3J,5,Spandau,3J,B,053J,3,78,W,0,0,0,0,0,0,0,0,0,0,05B3H
Stimme,05B3K,5,Spandau,3K,B,053K,3,78,W,0,0,0,0,420,420,0,420,174,246,nan
Stimme,05B3L,5,Spandau,3L,B,053L,3,78,W,0,0,0,0,0,0,0,0,0,0,05B3K
Stimme,05B3M,5,Spandau,3M,B,053M,3,78,W,0,0,0,0,0,0,0,0,0,0,05B3K
Stimme,05B3N,5,Spandau,3N,B,053N,3,78,W,0,0,0,0,387,387,0,387,163,224,nan
Stimme,05B3P,5,Spandau,3P,B,053P,3,78,W,0,0,0,0,0,0,0,0,0,0,05B3N
Stimme,05B3Q,5,Spandau,3Q,B,053Q,3,78,W,0,0,0,0,0,0,0,0,0,0,05B3N
Stimme,05B3R,5,Spandau,3R,B,053R,3,78,W,0,0,0,0,501,501,2,499,156,343,nan
Stimme,05B3S,5,Spandau,3S,B,053S,3,78,W,0,0,0,0,0,0,0,0,0,0,05B3R
Stimme,05B3T,5,Spandau,3T,B,053T,3,78,W,0,0,0,0,0,0,0,0,0,0,05B3R
Stimme,05B3U,5,Spandau,3U,B,053U,3,78,W,0,0,0,0,223,223,0,223,108,115,nan
Stimme,05B3V,5,Spandau,3V,B,053V,3,78,W,0,0,0,0,0,0,0,0,0,0,05B3U
Stimme,05B4A,5,Spandau,4A,B,054A,4,78,W,0,0,0,0,460,460,0,460,119,341,nan
Stimme,05B4B,5,Spandau,4B,B,054B,4,78,W,0,0,0,0,0,0,0,0,0,0,05B4A
Stimme,05B4C,5,Spandau,4C,B,054C,4,78,W,0,0,0,0,687,687,2,685,207,478,nan
Stimme,05B4D,5,Spandau,4D,B,054D,4,78,W,0,0,0,0,0,0,0,0,0,0,05B4C
Stimme,05B4E,5,Spandau,4E,B,054E,4,78,W,0,0,0,0,421,421,0,421,121,300,nan
Stimme,05B4F,5,Spandau,4F,B,054F,4,78,W,0,0,0,0,0,0,0,0,0,0,05B4E
Stimme,05B4G,5,Spandau,4G,B,054G,4,78,W,0,0,0,0,411,411,5,406,107,299,nan
Stimme,05B4H,5,Spandau,4H,B,054H,4,78,W,0,0,0,0,0,0,0,0,0,0,05B4G
Stimme,05B4J,5,Spandau,4J,B,054J,4,78,W,0,0,0,0,404,404,0,404,128,276,nan
Stimme,05B4K,5,Spandau,4K,B,054K,4,78,W,0,0,0,0,0,0,0,0,0,0,05B4J
Stimme,05B4L,5,Spandau,4L,B,054L,4,78,W,0,0,0,0,377,377,1,376,129,247,nan
Stimme,05B4M,5,Spandau,4M,B,054M,4,78,W,0,0,0,0,0,0,0,0,0,0,05B4L
Stimme,05B4N,5,Spandau,4N,B,054N,4,78,W,0,0,0,0,492,492,1,491,151,340,nan
Stimme,05B4P,5,Spandau,4P,B,054P,4,78,W,0,0,0,0,0,0,0,0,0,0,05B4N
Stimme,05B4Q,5,Spandau,4Q,B,054Q,4,78,W,0,0,0,0,0,0,0,0,0,0,05B4N
Stimme,05B4R,5,Spandau,4R,B,054R,4,78,W,0,0,0,0,580,580,0,580,184,396,nan
Stimme,05B4S,5,Spandau,4S,B,054S,4,78,W,0,0,0,0,0,0,0,0,0,0,05B4R
Stimme,05B4T,5,Spandau,4T,B,054T,4,78,W,0,0,0,0,595,595,3,592,167,425,nan
Stimme,05B4U,5,Spandau,4U,B,054U,4,78,W,0,0,0,0,0,0,0,0,0,0,05B4T
Stimme,05B5A,5,Spandau,5A,B,055A,5,78,W,0,0,0,0,389,389,1,388,109,279,nan
Stimme,05B5B,5,Spandau,5B,B,055B,5,78,W,0,0,0,0,0,0,0,0,0,0,05B5A
Stimme,05B5C,5,Spandau,5C,B,055C,5,78,W,0,0,0,0,395,395,0,395,113,282,nan
Stimme,05B5D,5,Spandau,5D,B,055D,5,78,W,0,0,0,0,0,0,0,0,0,0,05B5C
Stimme,05B5E,5,Spandau,5E,B,055E,5,78,W,0,0,0,0,482,482,2,480,215,265,nan
Stimme,05B5F,5,Spandau,5F,B,055F,5,78,W,0,0,0,0,0,0,0,0,0,0,05B5E
Stimme,05B5G,5,Spandau,5G,B,055G,5,78,W,0,0,0,0,411,411,3,408,160,248,nan
Stimme,05B5H,5,Spandau,5H,B,055H,5,78,W,0,0,0,0,0,0,0,0,0,0,05B5G
Stimme,05B5J,5,Spandau,5J,B,055J,5,78,W,0,0,0,0,521,521,5,516,161,355,nan
Stimme,05B5K,5,Spandau,5K,B,055K,5,78,W,0,0,0,0,0,0,0,0,0,0,05B5J
Stimme,05B5L,5,Spandau,5L,B,055L,5,78,W,0,0,0,0,561,561,3,558,201,357,nan
Stimme,05B5M,5,Spandau,5M,B,055M,5,78,W,0,0,0,0,0,0,0,0,0,0,05B5L
Stimme,05B5N,5,Spandau,5N,B,055N,5,78,W,0,0,0,0,291,291,1,290,113,177,nan
Stimme,05B5P,5,Spandau,5P,B,055P,5,78,W,0,0,0,0,0,0,0,0,0,0,05B5N
Stimme,05B5Q,5,Spandau,5Q,B,055Q,5,78,W,0,0,0,0,448,448,1,447,162,285,nan
Stimme,05B5R,5,Spandau,5R,B,055R,5,78,W,0,0,0,0,0,0,0,0,0,0,05B5Q
Stimme,05B5S,5,Spandau,5S,B,055S,5,78,W,0,0,0,0,440,440,4,436,126,310,nan
Stimme,05B5T,5,Spandau,5T,B,055T,5,78,W,0,0,0,0,0,0,0,0,0,0,05B5S
Stimme,05B5U,5,Spandau,5U,B,055U,5,78,W,0,0,0,0,343,343,0,343,98,245,nan
Stimme,05B5V,5,Spandau,5V,B,055V,5,78,W,0,0,0,0,0,0,0,0,0,0,05B5U
Stimme,05B5W,5,Spandau,5W,B,055W,5,78,W,0,0,0,0,344,344,4,340,106,234,nan
Stimme,05B5X,5,Spandau,5X,B,055X,5,78,W,0,0,0,0,0,0,0,0,0,0,05B5W
Stimme,05B5Y,5,Spandau,5Y,B,055Y,5,78,W,0,0,0,0,332,332,0,332,93,239,nan
Stimme,05B5Z,5,Spandau,5Z,B,055Z,5,78,W,0,0,0,0,0,0,0,0,0,0,05B5Y
Stimme,06W101,6,Steglitz-Zehlendorf,101,W,061A,1,79,W,1256,948,308,0,283,4,1,282,121,161,nan
Stimme,06W102,6,Steglitz-Zehlendorf,102,W,061B,1,79,W,1293,946,347,0,272,7,2,270,149,121,nan
Stimme,06W103,6,Steglitz-Zehlendorf,103,W,061C,1,79,W,1249,976,273,0,276,7,1,275,174,101,nan
Stimme,06W104,6,Steglitz-Zehlendorf,104,W,061D,1,79,W,1285,1000,285,0,336,10,1,335,227,108,nan
Stimme,06W105,6,Steglitz-Zehlendorf,105,W,061E,1,79,W,1158,899,259,0,223,10,0,223,128,95,nan
Stimme,06W106,6,Steglitz-Zehlendorf,106,W,061F,1,79,W,1141,930,211,0,207,2,0,207,109,98,nan
Stimme,06W107,6,Steglitz-Zehlendorf,107,W,061G,1,79,W,1190,952,238,0,255,7,3,252,113,139,nan
Stimme,06W108,6,Steglitz-Zehlendorf,108,W,061H,1,79,W,1279,970,309,0,356,9,4,352,191,161,nan
Stimme,06W109,6,Steglitz-Zehlendorf,109,W,061J,1,79,W,1276,1064,212,0,327,7,0,327,190,137,nan
Stimme,06W110,6,Steglitz-Zehlendorf,110,W,061K,1,79,W,1136,912,224,0,242,10,1,241,138,103,nan
Stimme,06W111,6,Steglitz-Zehlendorf,111,W,061L,1,79,W,1133,938,195,0,302,3,1,301,179,122,nan
Stimme,06W112,6,Steglitz-Zehlendorf,112,W,061M,1,79,W,1243,1017,226,0,258,3,2,256,127,129,nan
Stimme,06W113,6,Steglitz-Zehlendorf,113,W,061N,1,79,W,1177,962,215,0,166,5,1,165,73,92,nan
Stimme,06W114,6,Steglitz-Zehlendorf,114,W,061P,1,79,W,1205,929,276,0,254,3,4,250,118,132,nan
Stimme,06W115,6,Steglitz-Zehlendorf,115,W,061Q,1,79,W,1243,1003,240,0,244,4,1,243,141,102,nan
Stimme,06W116,6,Steglitz-Zehlendorf,116,W,061R,1,79,W,1226,962,264,0,322,3,5,317,195,122,nan
Stimme,06W117,6,Steglitz-Zehlendorf,117,W,061S,1,79,W,1173,844,329,0,189,0,1,188,101,87,nan
Stimme,06W118,6,Steglitz-Zehlendorf,118,W,061T,1,79,W,1238,932,306,0,307,8,3,304,161,143,nan
Stimme,06W119,6,Steglitz-Zehlendorf,119,W,061U,1,79,W,1211,924,287,0,274,4,4,270,164,106,nan
Stimme,06W120,6,Steglitz-Zehlendorf,120,W,061V,1,79,W,1100,873,227,0,278,7,0,278,177,101,nan
Stimme,06W121,6,Steglitz-Zehlendorf,121,W,061W,1,79,W,1191,951,240,0,286,1,3,283,146,137,nan
Stimme,06W122,6,Steglitz-Zehlendorf,122,W,061X,1,79,W,1287,995,292,0,319,4,0,319,177,142,nan
Stimme,06W123,6,Steglitz-Zehlendorf,123,W,061Y,1,79,W,1171,919,252,0,271,4,2,269,143,126,nan
Stimme,06W124,6,Steglitz-Zehlendorf,124,W,061Z,1,79,W,1291,969,322,0,241,7,0,241,146,95,nan
Stimme,06W125,6,Steglitz-Zehlendorf,125,W,061AA,1,79,W,1247,964,283,0,273,1,2,271,167,104,nan
Stimme,06W126,6,Steglitz-Zehlendorf,126,W,061AB,1,79,W,1139,897,242,0,259,5,0,259,156,103,nan
Stimme,06W201,6,Steglitz-Zehlendorf,201,W,062A,2,79,W,1205,954,251,0,300,8,1,299,168,131,nan
Stimme,06W202,6,Steglitz-Zehlendorf,202,W,062B,2,79,W,1348,1105,243,0,318,0,1,317,159,158,nan
Stimme,06W203,6,Steglitz-Zehlendorf,203,W,062C,2,79,W,1189,983,206,0,226,2,2,224,111,113,nan
Stimme,06W204,6,Steglitz-Zehlendorf,204,W,062D,2,79,W,1240,1020,220,0,292,4,0,292,121,171,nan
Stimme,06W205,6,Steglitz-Zehlendorf,205,W,062E,2,79,W,1135,910,225,0,208,0,0,208,81,127,nan
Stimme,06W206,6,Steglitz-Zehlendorf,206,W,062F,2,79,W,1234,974,260,0,320,4,1,319,123,196,nan
Stimme,06W207,6,Steglitz-Zehlendorf,207,W,062G,2,79,W,1133,918,215,0,186,0,0,186,91,95,nan
Stimme,06W208,6,Steglitz-Zehlendorf,208,W,062H,2,79,W,1246,1015,231,0,238,3,1,237,100,137,nan
Stimme,06W209,6,Steglitz-Zehlendorf,209,W,062J,2,79,W,1303,1070,233,0,259,4,0,259,150,109,nan
Stimme,06W210,6,Steglitz-Zehlendorf,210,W,062K,2,79,W,1292,1001,291,0,359,7,0,359,180,179,nan
Stimme,06W211,6,Steglitz-Zehlendorf,211,W,062L,2,79,W,1340,1055,285,0,240,3,3,237,134,103,nan
Stimme,06W212,6,Steglitz-Zehlendorf,212,W,062M,2,79,W,1290,964,326,0,244,3,1,243,123,120,nan
Stimme,06W213,6,Steglitz-Zehlendorf,213,W,062N,2,79,W,1281,1065,216,0,247,2,1,246,143,103,nan
Stimme,06W214,6,Steglitz-Zehlendorf,214,W,062P,2,79,W,1146,855,291,0,277,5,2,275,162,113,nan
Stimme,06W215,6,Steglitz-Zehlendorf,215,W,062Q,2,79,W,1286,1020,266,0,288,3,2,286,152,134,nan
Stimme,06W216,6,Steglitz-Zehlendorf,216,W,062R,2,79,W,1235,942,293,0,247,5,1,246,148,98,nan
Stimme,06W217,6,Steglitz-Zehlendorf,217,W,062S,2,79,W,1272,1014,258,0,291,4,4,287,151,136,nan
Stimme,06W218,6,Steglitz-Zehlendorf,218,W,062T,2,79,W,1182,959,223,0,184,4,0,184,97,87,nan
Stimme,06W219,6,Steglitz-Zehlendorf,219,W,062U,2,79,W,1164,923,241,0,273,4,0,273,178,95,nan
Stimme,06W220,6,Steglitz-Zehlendorf,220,W,062V,2,79,W,1242,1003,239,0,284,2,0,284,151,133,nan
Stimme,06W221,6,Steglitz-Zehlendorf,221,W,062W,2,79,W,1337,1090,247,0,296,3,6,290,131,159,nan
Stimme,06W222,6,Steglitz-Zehlendorf,222,W,062X,2,79,W,1090,936,154,0,183,3,0,183,87,96,nan
Stimme,06W223,6,Steglitz-Zehlendorf,223,W,062Y,2,79,W,1071,871,200,0,262,0,1,261,143,118,nan
Stimme,06W224,6,Steglitz-Zehlendorf,224,W,062Z,2,79,W,1222,1009,213,0,255,2,1,254,140,114,nan
Stimme,06W225,6,Steglitz-Zehlendorf,225,W,062AA,2,79,W,1177,904,273,0,218,7,2,216,114,102,nan
Stimme,06W301,6,Steglitz-Zehlendorf,301,W,063A,3,79,W,1314,971,343,0,281,7,4,277,148,129,nan
Stimme,06W302,6,Steglitz-Zehlendorf,302,W,063B,3,79,W,1277,954,323,0,273,6,3,270,144,126,nan
Stimme,06W303,6,Steglitz-Zehlendorf,303,W,063C,3,79,W,1106,933,173,0,286,5,1,285,153,132,nan
Stimme,06W304,6,Steglitz-Zehlendorf,304,W,063D,3,79,W,1286,950,336,0,344,8,5,339,152,187,nan
Stimme,06W305,6,Steglitz-Zehlendorf,305,W,063E,3,79,W,1143,937,206,0,273,1,3,270,150,120,nan
Stimme,06W306,6,Steglitz-Zehlendorf,306,W,063F,3,79,W,1259,941,318,0,245,2,2,243,102,141,nan
Stimme,06W307,6,Steglitz-Zehlendorf,307,W,063G,3,79,W,1207,842,365,0,265,7,5,260,137,123,nan
Stimme,06W308,6,Steglitz-Zehlendorf,308,W,063H,3,79,W,1167,842,325,0,312,4,3,309,131,178,nan
Stimme,06W309,6,Steglitz-Zehlendorf,309,W,063J,3,79,W,1269,917,352,0,281,2,1,280,135,145,nan
Stimme,06W310,6,Steglitz-Zehlendorf,310,W,063K,3,79,W,1237,918,319,0,351,8,5,346,187,159,nan
Stimme,06W311,6,Steglitz-Zehlendorf,311,W,063L,3,79,W,1093,800,293,0,230,3,0,230,112,118,nan
Stimme,06W312,6,Steglitz-Zehlendorf,312,W,063M,3,79,W,1170,869,301,0,314,3,3,311,140,171,nan
Stimme,06W313,6,Steglitz-Zehlendorf,313,W,063N,3,79,W,1179,922,257,0,265,0,2,263,112,151,nan
Stimme,06W314,6,Steglitz-Zehlendorf,314,W,063P,3,79,W,1262,954,308,0,249,3,1,248,98,150,nan
Stimme,06W315,6,Steglitz-Zehlendorf,315,W,063Q,3,79,W,1228,914,314,0,250,2,0,250,117,133,nan
Stimme,06W316,6,Steglitz-Zehlendorf,316,W,063R,3,79,W,1259,998,261,0,232,1,4,228,85,143,nan
Stimme,06W317,6,Steglitz-Zehlendorf,317,W,063S,3,79,W,1348,1072,276,0,247,1,1,246,125,121,nan
Stimme,06W318,6,Steglitz-Zehlendorf,318,W,063T,3,79,W,1293,1061,232,0,215,4,1,214,93,121,nan
Stimme,06W319,6,Steglitz-Zehlendorf,319,W,063U,3,79,W,1143,860,283,0,221,4,0,221,123,98,nan
Stimme,06W320,6,Steglitz-Zehlendorf,320,W,063V,3,79,W,1237,883,354,0,235,4,1,234,113,121,nan
Stimme,06W321,6,Steglitz-Zehlendorf,321,W,063W,3,79,W,1264,1013,251,0,246,5,3,243,122,121,nan
Stimme,06W322,6,Steglitz-Zehlendorf,322,W,063X,3,79,W,1295,984,311,0,261,1,0,261,106,155,nan
Stimme,06W323,6,Steglitz-Zehlendorf,323,W,063Y,3,79,W,1193,880,313,0,284,3,1,283,131,152,nan
Stimme,06W324,6,Steglitz-Zehlendorf,324,W,063Z,3,79,W,1180,895,285,0,262,2,1,261,110,151,nan
Stimme,06W325,6,Steglitz-Zehlendorf,325,W,063AA,3,79,W,1312,976,336,0,251,3,1,250,120,130,nan
Stimme,06W326,6,Steglitz-Zehlendorf,326,W,063AB,3,79,W,1222,919,303,0,315,5,1,314,177,137,nan
Stimme,06W327,6,Steglitz-Zehlendorf,327,W,063AC,3,79,W,1168,887,281,0,316,4,1,315,166,149,nan
Stimme,06W401,6,Steglitz-Zehlendorf,401,W,064A,4,79,W,1240,973,267,0,354,7,2,352,182,170,nan
Stimme,06W402,6,Steglitz-Zehlendorf,402,W,064B,4,79,W,1291,1037,254,0,256,3,0,256,108,148,nan
Stimme,06W403,6,Steglitz-Zehlendorf,403,W,064C,4,79,W,1312,1029,283,0,225,6,0,225,100,125,nan
Stimme,06W404,6,Steglitz-Zehlendorf,404,W,064D,4,79,W,1152,844,308,0,274,5,2,272,133,139,nan
Stimme,06W405,6,Steglitz-Zehlendorf,405,W,064E,4,79,W,1263,944,319,0,344,2,2,342,138,204,nan
Stimme,06W406,6,Steglitz-Zehlendorf,406,W,064F,4,79,W,1215,940,275,0,243,1,1,242,117,125,nan
Stimme,06W407,6,Steglitz-Zehlendorf,407,W,064G,4,79,W,1320,1086,234,0,241,3,1,240,102,138,nan
Stimme,06W408,6,Steglitz-Zehlendorf,408,W,064H,4,79,W,1305,920,385,0,254,2,2,252,125,127,nan
Stimme,06W409,6,Steglitz-Zehlendorf,409,W,064J,4,79,W,1198,907,291,0,242,1,0,242,101,141,nan
Stimme,06W410,6,Steglitz-Zehlendorf,410,W,064K,4,79,W,1254,1032,222,0,185,3,1,184,72,112,nan
Stimme,06W411,6,Steglitz-Zehlendorf,411,W,064L,4,79,W,1595,1261,334,0,320,1,1,319,105,214,nan
Stimme,06W412,6,Steglitz-Zehlendorf,412,W,064M,4,79,W,1218,1008,210,0,268,3,2,266,117,149,nan
Stimme,06W413,6,Steglitz-Zehlendorf,413,W,064N,4,79,W,1224,983,241,0,197,2,0,197,74,123,nan
Stimme,06W414,6,Steglitz-Zehlendorf,414,W,064P,4,79,W,1177,1111,66,0,168,2,0,168,52,116,nan
Stimme,06W415,6,Steglitz-Zehlendorf,415,W,064Q,4,79,W,1050,887,163,0,157,1,0,157,69,88,nan
Stimme,06W416,6,Steglitz-Zehlendorf,416,W,064R,4,79,W,1282,916,366,0,257,7,1,256,116,140,nan
Stimme,06W417,6,Steglitz-Zehlendorf,417,W,064S,4,79,W,1253,930,323,0,247,1,2,245,108,137,nan
Stimme,06W418,6,Steglitz-Zehlendorf,418,W,064T,4,79,W,1209,947,262,0,347,3,2,345,176,169,nan
Stimme,06W419,6,Steglitz-Zehlendorf,419,W,064U,4,79,W,1165,933,232,0,204,2,0,204,88,116,nan
Stimme,06W420,6,Steglitz-Zehlendorf,420,W,064V,4,79,W,1161,981,180,0,180,4,0,180,53,127,nan
Stimme,06W421,6,Steglitz-Zehlendorf,421,W,064W,4,79,W,1257,914,343,0,206,5,2,204,89,115,nan
Stimme,06W422,6,Steglitz-Zehlendorf,422,W,064X,4,79,W,1228,920,308,0,293,2,3,290,161,129,nan
Stimme,06W423,6,Steglitz-Zehlendorf,423,W,064Y,4,79,W,1250,895,355,0,302,6,0,302,90,212,nan
Stimme,06W501,6,Steglitz-Zehlendorf,501,W,065A,5,79,W,1181,972,209,0,214,1,1,213,80,133,nan
Stimme,06W502,6,Steglitz-Zehlendorf,502,W,065B,5,79,W,1305,1081,224,0,254,2,1,253,97,156,nan
Stimme,06W503,6,Steglitz-Zehlendorf,503,W,065C,5,79,W,1229,961,268,0,228,6,2,226,96,130,nan
Stimme,06W504,6,Steglitz-Zehlendorf,504,W,065D,5,79,W,1078,817,261,0,265,3,1,264,124,140,nan
Stimme,06W505,6,Steglitz-Zehlendorf,505,W,065E,5,79,W,1235,956,279,0,316,6,1,315,139,176,nan
Stimme,06W506,6,Steglitz-Zehlendorf,506,W,065F,5,79,W,1201,939,262,0,190,2,0,190,77,113,nan
Stimme,06W507,6,Steglitz-Zehlendorf,507,W,065G,5,79,W,1149,970,179,0,216,9,0,216,63,153,nan
Stimme,06W508,6,Steglitz-Zehlendorf,508,W,065H,5,79,W,1266,1049,217,0,203,2,2,201,77,124,nan
Stimme,06W509,6,Steglitz-Zehlendorf,509,W,065J,5,79,W,1295,988,307,0,309,5,2,307,92,215,nan
Stimme,06W510,6,Steglitz-Zehlendorf,510,W,065K,5,79,W,1240,1019,221,0,339,4,1,338,121,217,nan
Stimme,06W511,6,Steglitz-Zehlendorf,511,W,065L,5,79,W,1130,905,225,0,273,7,3,270,128,142,nan
Stimme,06W512,6,Steglitz-Zehlendorf,512,W,065M,5,79,W,1166,957,209,0,161,0,2,159,50,109,nan
Stimme,06W513,6,Steglitz-Zehlendorf,513,W,065N,5,79,W,1471,1266,205,0,250,2,0,250,107,143,nan
Stimme,06W514,6,Steglitz-Zehlendorf,514,W,065P,5,79,W,1231,937,294,0,338,7,3,335,139,196,nan
Stimme,06W515,6,Steglitz-Zehlendorf,515,W,065Q,5,79,W,1232,999,233,0,287,4,1,286,107,179,nan
Stimme,06W516,6,Steglitz-Zehlendorf,516,W,065R,5,79,W,1080,919,161,0,161,1,1,160,50,110,nan
Stimme,06W517,6,Steglitz-Zehlendorf,517,W,065S,5,79,W,1342,1142,200,0,232,0,0,232,78,154,nan
Stimme,06W518,6,Steglitz-Zehlendorf,518,W,065T,5,79,W,1033,885,148,0,163,1,1,162,51,111,nan
Stimme,06W519,6,Steglitz-Zehlendorf,519,W,065U,5,79,W,1003,790,213,0,163,4,1,162,77,85,nan
Stimme,06W520,6,Steglitz-Zehlendorf,520,W,065V,5,79,W,1086,831,255,0,259,3,1,258,111,147,nan
Stimme,06W521,6,Steglitz-Zehlendorf,521,W,065W,5,79,W,1110,830,280,0,291,3,2,289,107,182,nan
Stimme,06W522,6,Steglitz-Zehlendorf,522,W,065X,5,79,W,1279,1091,188,0,219,0,0,219,85,134,nan
Stimme,06W523,6,Steglitz-Zehlendorf,523,W,065Y,5,79,W,1282,1121,161,0,195,2,0,195,90,105,nan
Stimme,06W524,6,Steglitz-Zehlendorf,524,W,065Z,5,79,W,975,831,144,0,153,1,0,153,41,112,nan
Stimme,06W525,6,Steglitz-Zehlendorf,525,W,065AA,5,79,W,950,838,112,0,121,0,1,120,26,94,nan
Stimme,06W601,6,Steglitz-Zehlendorf,601,W,066A,6,79,W,1207,876,331,0,207,0,1,206,126,80,nan
Stimme,06W602,6,Steglitz-Zehlendorf,602,W,066B,6,79,W,1199,919,280,0,339,3,1,338,181,157,nan
Stimme,06W603,6,Steglitz-Zehlendorf,603,W,066C,6,79,W,1224,885,339,0,283,2,2,281,131,150,nan
Stimme,06W604,6,Steglitz-Zehlendorf,604,W,066D,6,79,W,1167,915,252,0,313,2,3,310,166,144,nan
Stimme,06W605,6,Steglitz-Zehlendorf,605,W,066E,6,79,W,1332,1086,246,0,332,4,1,331,182,149,nan
Stimme,06W606,6,Steglitz-Zehlendorf,606,W,066F,6,79,W,1200,930,270,0,241,1,0,241,88,153,nan
Stimme,06W607,6,Steglitz-Zehlendorf,607,W,066G,6,79,W,1215,925,290,0,271,0,3,268,93,175,nan
Stimme,06W608,6,Steglitz-Zehlendorf,608,W,066H,6,79,W,1401,1052,349,0,258,0,0,258,103,155,nan
Stimme,06W609,6,Steglitz-Zehlendorf,609,W,066J,6,79,W,1165,835,330,0,279,0,0,279,149,130,nan
Stimme,06W610,6,Steglitz-Zehlendorf,610,W,066K,6,79,W,1130,801,329,0,270,3,0,270,113,157,nan
Stimme,06W611,6,Steglitz-Zehlendorf,611,W,066L,6,79,W,1225,895,330,0,241,2,2,239,128,111,nan
Stimme,06W612,6,Steglitz-Zehlendorf,612,W,066M,6,79,W,1121,889,232,0,307,1,5,302,154,148,nan
Stimme,06W613,6,Steglitz-Zehlendorf,613,W,066N,6,79,W,1137,754,383,0,265,5,3,262,160,102,nan
Stimme,06W614,6,Steglitz-Zehlendorf,614,W,066P,6,79,W,1202,869,333,0,327,8,2,325,138,187,nan
Stimme,06W615,6,Steglitz-Zehlendorf,615,W,066Q,6,79,W,1295,997,298,0,218,1,2,216,109,107,nan
Stimme,06W616,6,Steglitz-Zehlendorf,616,W,066R,6,79,W,1290,1042,248,0,367,5,1,366,163,203,nan
Stimme,06W617,6,Steglitz-Zehlendorf,617,W,066S,6,79,W,1268,1051,217,0,317,2,2,315,150,165,nan
Stimme,06W618,6,Steglitz-Zehlendorf,618,W,066T,6,79,W,1330,1031,299,0,333,6,2,331,174,157,nan
Stimme,06W619,6,Steglitz-Zehlendorf,619,W,066U,6,79,W,1286,1000,286,0,283,1,2,281,127,154,nan
Stimme,06W620,6,Steglitz-Zehlendorf,620,W,066V,6,79,W,1281,925,356,0,249,2,3,246,136,110,nan
Stimme,06W621,6,Steglitz-Zehlendorf,621,W,066W,6,79,W,1307,1012,295,0,205,7,0,205,109,96,nan
Stimme,06W622,6,Steglitz-Zehlendorf,622,W,066X,6,79,W,1300,1022,278,0,336,9,0,336,202,134,nan
Stimme,06W623,6,Steglitz-Zehlendorf,623,W,066Y,6,79,W,1360,1019,341,0,309,5,4,305,186,119,nan
Stimme,06W624,6,Steglitz-Zehlendorf,624,W,066Z,6,79,W,1261,988,273,0,295,3,3,292,176,116,nan
Stimme,06W625,6,Steglitz-Zehlendorf,625,W,066AA,6,79,W,1289,966,323,0,272,7,2,270,101,169,nan
Stimme,06W701,6,Steglitz-Zehlendorf,701,W,067A,7,79,W,1157,849,308,0,234,5,1,233,102,131,nan
Stimme,06W702,6,Steglitz-Zehlendorf,702,W,067B,7,79,W,1211,918,293,0,228,7,0,228,89,139,nan
Stimme,06W703,6,Steglitz-Zehlendorf,703,W,067C,7,79,W,1094,848,246,0,236,3,0,236,95,141,nan
Stimme,06W704,6,Steglitz-Zehlendorf,704,W,067D,7,79,W,1252,941,311,0,236,5,3,233,95,138,nan
Stimme,06W705,6,Steglitz-Zehlendorf,705,W,067E,7,79,W,1108,799,309,0,209,0,0,209,112,97,nan
Stimme,06W706,6,Steglitz-Zehlendorf,706,W,067F,7,79,W,1379,1064,315,0,365,1,4,361,167,194,nan
Stimme,06W707,6,Steglitz-Zehlendorf,707,W,067G,7,79,W,1373,1002,371,0,266,6,3,263,120,143,nan
Stimme,06W708,6,Steglitz-Zehlendorf,708,W,067H,7,79,W,1124,871,253,0,284,8,3,281,148,133,nan
Stimme,06W709,6,Steglitz-Zehlendorf,709,W,067J,7,79,W,1031,737,294,0,223,4,2,221,97,124,nan
Stimme,06W710,6,Steglitz-Zehlendorf,710,W,067K,7,79,W,1200,940,260,0,296,1,0,296,119,177,nan
Stimme,06W711,6,Steglitz-Zehlendorf,711,W,067L,7,79,W,1151,853,298,0,241,1,2,239,94,145,nan
Stimme,06W712,6,Steglitz-Zehlendorf,712,W,067M,7,79,W,1086,834,252,0,304,3,2,302,181,121,nan
Stimme,06W713,6,Steglitz-Zehlendorf,713,W,067N,7,79,W,1203,856,347,0,262,6,1,261,129,132,nan
Stimme,06W714,6,Steglitz-Zehlendorf,714,W,067P,7,79,W,1144,909,235,0,263,6,0,263,145,118,nan
Stimme,06W715,6,Steglitz-Zehlendorf,715,W,067Q,7,79,W,1022,781,241,0,227,4,0,227,93,134,nan
Stimme,06W716,6,Steglitz-Zehlendorf,716,W,067R,7,79,W,1175,864,311,0,309,1,3,306,138,168,nan
Stimme,06W717,6,Steglitz-Zehlendorf,717,W,067S,7,79,W,1141,874,267,0,298,3,3,295,160,135,nan
Stimme,06W718,6,Steglitz-Zehlendorf,718,W,067T,7,79,W,1251,921,330,0,291,2,1,290,114,176,nan
Stimme,06W719,6,Steglitz-Zehlendorf,719,W,067U,7,79,W,1202,888,314,0,329,6,2,327,187,140,nan
Stimme,06W720,6,Steglitz-Zehlendorf,720,W,067V,7,79,W,1202,921,281,0,294,6,3,291,121,170,nan
Stimme,06W721,6,Steglitz-Zehlendorf,721,W,067W,7,79,W,1178,945,233,0,275,3,1,274,116,158,nan
Stimme,06W722,6,Steglitz-Zehlendorf,722,W,067X,7,79,W,1310,918,392,0,296,5,3,293,151,142,nan
Stimme,06W723,6,Steglitz-Zehlendorf,723,W,067Y,7,79,W,1186,867,319,0,276,3,3,273,128,145,nan
Stimme,06W724,6,Steglitz-Zehlendorf,724,W,067Z,7,79,W,1133,865,268,0,286,3,0,286,128,158,nan
Stimme,06W725,6,Steglitz-Zehlendorf,725,W,067AA,7,79,W,1056,851,205,0,216,0,0,216,70,146,nan
Stimme,06B1A,6,Steglitz-Zehlendorf,1A,B,061A,1,79,W,0,0,0,0,514,514,0,514,283,231,nan
Stimme,06B1AA,6,Steglitz-Zehlendorf,1AA,B,061AA,1,79,W,0,0,0,0,0,0,0,0,0,0,06B1A
Stimme,06B1AB,6,Steglitz-Zehlendorf,1AB,B,061AB,1,79,W,0,0,0,0,0,0,0,0,0,0,06B1B
Stimme,06B1B,6,Steglitz-Zehlendorf,1B,B,061B,1,79,W,0,0,0,0,724,724,1,723,395,328,nan
Stimme,06B1C,6,Steglitz-Zehlendorf,1C,B,061C,1,79,W,0,0,0,0,0,0,0,0,0,0,06B1B
Stimme,06B1D,6,Steglitz-Zehlendorf,1D,B,061D,1,79,W,0,0,0,0,648,648,0,648,335,313,nan
Stimme,06B1E,6,Steglitz-Zehlendorf,1E,B,061E,1,79,W,0,0,0,0,0,0,0,0,0,0,06B1D
Stimme,06B1F,6,Steglitz-Zehlendorf,1F,B,061F,1,79,W,0,0,0,0,0,0,0,0,0,0,06B1D
Stimme,06B1G,6,Steglitz-Zehlendorf,1G,B,061G,1,79,W,0,0,0,0,657,657,3,654,340,314,nan
Stimme,06B1H,6,Steglitz-Zehlendorf,1H,B,061H,1,79,W,0,0,0,0,0,0,0,0,0,0,06B1G
Stimme,06B1J,6,Steglitz-Zehlendorf,1J,B,061J,1,79,W,0,0,0,0,0,0,0,0,0,0,06B1G
Stimme,06B1K,6,Steglitz-Zehlendorf,1K,B,061K,1,79,W,0,0,0,0,546,546,1,545,299,246,nan
Stimme,06B1L,6,Steglitz-Zehlendorf,1L,B,061L,1,79,W,0,0,0,0,0,0,0,0,0,0,06B1K
Stimme,06B1M,6,Steglitz-Zehlendorf,1M,B,061M,1,79,W,0,0,0,0,0,0,0,0,0,0,06B1K
Stimme,06B1N,6,Steglitz-Zehlendorf,1N,B,061N,1,79,W,0,0,0,0,633,633,0,633,334,299,nan
Stimme,06B1P,6,Steglitz-Zehlendorf,1P,B,061P,1,79,W,0,0,0,0,0,0,0,0,0,0,06B1N
Stimme,06B1Q,6,Steglitz-Zehlendorf,1Q,B,061Q,1,79,W,0,0,0,0,0,0,0,0,0,0,06B1N
Stimme,06B1R,6,Steglitz-Zehlendorf,1R,B,061R,1,79,W,0,0,0,0,805,805,1,804,400,404,nan
Stimme,06B1S,6,Steglitz-Zehlendorf,1S,B,061S,1,79,W,0,0,0,0,0,0,0,0,0,0,06B1R
Stimme,06B1T,6,Steglitz-Zehlendorf,1T,B,061T,1,79,W,0,0,0,0,0,0,0,0,0,0,06B1R
Stimme,06B1U,6,Steglitz-Zehlendorf,1U,B,061U,1,79,W,0,0,0,0,648,648,2,646,356,290,nan
Stimme,06B1V,6,Steglitz-Zehlendorf,1V,B,061V,1,79,W,0,0,0,0,0,0,0,0,0,0,06B1U
Stimme,06B1W,6,Steglitz-Zehlendorf,1W,B,061W,1,79,W,0,0,0,0,0,0,0,0,0,0,06B1U
Stimme,06B1X,6,Steglitz-Zehlendorf,1X,B,061X,1,79,W,0,0,0,0,734,734,2,732,412,320,nan
Stimme,06B1Y,6,Steglitz-Zehlendorf,1Y,B,061Y,1,79,W,0,0,0,0,0,0,0,0,0,0,06B1X
Stimme,06B1Z,6,Steglitz-Zehlendorf,1Z,B,061Z,1,79,W,0,0,0,0,0,0,0,0,0,0,06B1X
Stimme,06B2A,6,Steglitz-Zehlendorf,2A,B,062A,2,79,W,0,0,0,0,652,652,2,650,328,322,nan
Stimme,06B2AA,6,Steglitz-Zehlendorf,2AA,B,062AA,2,79,W,0,0,0,0,0,0,0,0,0,0,06B2A
Stimme,06B2B,6,Steglitz-Zehlendorf,2B,B,062B,2,79,W,0,0,0,0,0,0,0,0,0,0,06B2A
Stimme,06B2C,6,Steglitz-Zehlendorf,2C,B,062C,2,79,W,0,0,0,0,564,564,3,561,249,312,nan
Stimme,06B2D,6,Steglitz-Zehlendorf,2D,B,062D,2,79,W,0,0,0,0,0,0,0,0,0,0,06B2C
Stimme,06B2E,6,Steglitz-Zehlendorf,2E,B,062E,2,79,W,0,0,0,0,0,0,0,0,0,0,06B2C
Stimme,06B2F,6,Steglitz-Zehlendorf,2F,B,062F,2,79,W,0,0,0,0,603,603,1,602,276,326,nan
Stimme,06B2G,6,Steglitz-Zehlendorf,2G,B,062G,2,79,W,0,0,0,0,0,0,0,0,0,0,06B2F
Stimme,06B2H,6,Steglitz-Zehlendorf,2H,B,062H,2,79,W,0,0,0,0,0,0,0,0,0,0,06B2F
Stimme,06B2J,6,Steglitz-Zehlendorf,2J,B,062J,2,79,W,0,0,0,0,687,687,2,685,334,351,nan
Stimme,06B2K,6,Steglitz-Zehlendorf,2K,B,062K,2,79,W,0,0,0,0,0,0,0,0,0,0,06B2J
Stimme,06B2L,6,Steglitz-Zehlendorf,2L,B,062L,2,79,W,0,0,0,0,0,0,0,0,0,0,06B2J
Stimme,06B2M,6,Steglitz-Zehlendorf,2M,B,062M,2,79,W,0,0,0,0,723,723,1,722,415,307,nan
Stimme,06B2N,6,Steglitz-Zehlendorf,2N,B,062N,2,79,W,0,0,0,0,0,0,0,0,0,0,06B2M
Stimme,06B2P,6,Steglitz-Zehlendorf,2P,B,062P,2,79,W,0,0,0,0,0,0,0,0,0,0,06B2M
Stimme,06B2Q,6,Steglitz-Zehlendorf,2Q,B,062Q,2,79,W,0,0,0,0,703,703,3,700,360,340,nan
Stimme,06B2R,6,Steglitz-Zehlendorf,2R,B,062R,2,79,W,0,0,0,0,0,0,0,0,0,0,06B2Q
Stimme,06B2S,6,Steglitz-Zehlendorf,2S,B,062S,2,79,W,0,0,0,0,0,0,0,0,0,0,06B2Q
Stimme,06B2T,6,Steglitz-Zehlendorf,2T,B,062T,2,79,W,0,0,0,0,605,605,2,603,313,290,nan
Stimme,06B2U,6,Steglitz-Zehlendorf,2U,B,062U,2,79,W,0,0,0,0,0,0,0,0,0,0,06B2T
Stimme,06B2V,6,Steglitz-Zehlendorf,2V,B,062V,2,79,W,0,0,0,0,0,0,0,0,0,0,06B2T
Stimme,06B2W,6,Steglitz-Zehlendorf,2W,B,062W,2,79,W,0,0,0,0,341,341,1,340,176,164,nan
Stimme,06B2X,6,Steglitz-Zehlendorf,2X,B,062X,2,79,W,0,0,0,0,0,0,0,0,0,0,06B2W
Stimme,06B2Y,6,Steglitz-Zehlendorf,2Y,B,062Y,2,79,W,0,0,0,0,359,359,0,359,210,149,nan
Stimme,06B2Z,6,Steglitz-Zehlendorf,2Z,B,062Z,2,79,W,0,0,0,0,0,0,0,0,0,0,06B2Y
Stimme,06B3A,6,Steglitz-Zehlendorf,3A,B,063A,3,79,W,0,0,0,0,836,836,0,836,402,434,nan
Stimme,06B3AA,6,Steglitz-Zehlendorf,3AA,B,063AA,3,79,W,0,0,0,0,0,0,0,0,0,0,06B3A
Stimme,06B3AB,6,Steglitz-Zehlendorf,3AB,B,063AB,3,79,W,0,0,0,0,0,0,0,0,0,0,06B3A
Stimme,06B3AC,6,Steglitz-Zehlendorf,3AC,B,063AC,3,79,W,0,0,0,0,0,0,0,0,0,0,06B3B
Stimme,06B3B,6,Steglitz-Zehlendorf,3B,B,063B,3,79,W,0,0,0,0,677,677,2,675,307,368,nan
Stimme,06B3C,6,Steglitz-Zehlendorf,3C,B,063C,3,79,W,0,0,0,0,0,0,0,0,0,0,06B3B
Stimme,06B3D,6,Steglitz-Zehlendorf,3D,B,063D,3,79,W,0,0,0,0,767,767,5,762,344,418,nan
Stimme,06B3E,6,Steglitz-Zehlendorf,3E,B,063E,3,79,W,0,0,0,0,0,0,0,0,0,0,06B3D
Stimme,06B3F,6,Steglitz-Zehlendorf,3F,B,063F,3,79,W,0,0,0,0,0,0,0,0,0,0,06B3D
Stimme,06B3G,6,Steglitz-Zehlendorf,3G,B,063G,3,79,W,0,0,0,0,943,943,6,937,372,565,nan
Stimme,06B3H,6,Steglitz-Zehlendorf,3H,B,063H,3,79,W,0,0,0,0,0,0,0,0,0,0,06B3G
Stimme,06B3J,6,Steglitz-Zehlendorf,3J,B,063J,3,79,W,0,0,0,0,0,0,0,0,0,0,06B3G
Stimme,06B3K,6,Steglitz-Zehlendorf,3K,B,063K,3,79,W,0,0,0,0,806,806,2,804,340,464,nan
Stimme,06B3L,6,Steglitz-Zehlendorf,3L,B,063L,3,79,W,0,0,0,0,0,0,0,0,0,0,06B3K
Stimme,06B3M,6,Steglitz-Zehlendorf,3M,B,063M,3,79,W,0,0,0,0,0,0,0,0,0,0,06B3K
Stimme,06B3N,6,Steglitz-Zehlendorf,3N,B,063N,3,79,W,0,0,0,0,777,777,3,774,256,518,nan
Stimme,06B3P,6,Steglitz-Zehlendorf,3P,B,063P,3,79,W,0,0,0,0,0,0,0,0,0,0,06B3N
Stimme,06B3Q,6,Steglitz-Zehlendorf,3Q,B,063Q,3,79,W,0,0,0,0,0,0,0,0,0,0,06B3N
Stimme,06B3R,6,Steglitz-Zehlendorf,3R,B,063R,3,79,W,0,0,0,0,674,674,3,671,292,379,nan
Stimme,06B3S,6,Steglitz-Zehlendorf,3S,B,063S,3,79,W,0,0,0,0,0,0,0,0,0,0,06B3R
Stimme,06B3T,6,Steglitz-Zehlendorf,3T,B,063T,3,79,W,0,0,0,0,0,0,0,0,0,0,06B3R
Stimme,06B3U,6,Steglitz-Zehlendorf,3U,B,063U,3,79,W,0,0,0,0,783,783,6,777,319,458,nan
Stimme,06B3V,6,Steglitz-Zehlendorf,3V,B,063V,3,79,W,0,0,0,0,0,0,0,0,0,0,06B3U
Stimme,06B3W,6,Steglitz-Zehlendorf,3W,B,063W,3,79,W,0,0,0,0,0,0,0,0,0,0,06B3U
Stimme,06B3X,6,Steglitz-Zehlendorf,3X,B,063X,3,79,W,0,0,0,0,822,822,2,820,294,526,nan
Stimme,06B3Y,6,Steglitz-Zehlendorf,3Y,B,063Y,3,79,W,0,0,0,0,0,0,0,0,0,0,06B3X
Stimme,06B3Z,6,Steglitz-Zehlendorf,3Z,B,063Z,3,79,W,0,0,0,0,0,0,0,0,0,0,06B3X
Stimme,06B4A,6,Steglitz-Zehlendorf,4A,B,064A,4,79,W,0,0,0,0,696,696,2,694,310,384,nan
Stimme,06B4B,6,Steglitz-Zehlendorf,4B,B,064B,4,79,W,0,0,0,0,0,0,0,0,0,0,06B4A
Stimme,06B4C,6,Steglitz-Zehlendorf,4C,B,064C,4,79,W,0,0,0,0,0,0,0,0,0,0,06B4A
Stimme,06B4D,6,Steglitz-Zehlendorf,4D,B,064D,4,79,W,0,0,0,0,799,799,1,798,301,497,nan
Stimme,06B4E,6,Steglitz-Zehlendorf,4E,B,064E,4,79,W,0,0,0,0,0,0,0,0,0,0,06B4D
Stimme,06B4F,6,Steglitz-Zehlendorf,4F,B,064F,4,79,W,0,0,0,0,0,0,0,0,0,0,06B4D
Stimme,06B4G,6,Steglitz-Zehlendorf,4G,B,064G,4,79,W,0,0,0,0,780,780,0,780,284,496,nan
Stimme,06B4H,6,Steglitz-Zehlendorf,4H,B,064H,4,79,W,0,0,0,0,0,0,0,0,0,0,06B4G
Stimme,06B4J,6,Steglitz-Zehlendorf,4J,B,064J,4,79,W,0,0,0,0,0,0,0,0,0,0,06B4G
Stimme,06B4K,6,Steglitz-Zehlendorf,4K,B,064K,4,79,W,0,0,0,0,678,678,1,677,259,418,nan
Stimme,06B4L,6,Steglitz-Zehlendorf,4L,B,064L,4,79,W,0,0,0,0,0,0,0,0,0,0,06B4K
Stimme,06B4M,6,Steglitz-Zehlendorf,4M,B,064M,4,79,W,0,0,0,0,0,0,0,0,0,0,06B4K
Stimme,06B4N,6,Steglitz-Zehlendorf,4N,B,064N,4,79,W,0,0,0,0,750,750,2,748,274,474,nan
Stimme,06B4P,6,Steglitz-Zehlendorf,4P,B,064P,4,79,W,0,0,0,0,472,472,0,472,202,270,nan
Stimme,06B4Q,6,Steglitz-Zehlendorf,4Q,B,064Q,4,79,W,0,0,0,0,0,0,0,0,0,0,06B4P
Stimme,06B4R,6,Steglitz-Zehlendorf,4R,B,064R,4,79,W,0,0,0,0,0,0,0,0,0,0,06B4N
Stimme,06B4S,6,Steglitz-Zehlendorf,4S,B,064S,4,79,W,0,0,0,0,0,0,0,0,0,0,06B4P
Stimme,06B4T,6,Steglitz-Zehlendorf,4T,B,064T,4,79,W,0,0,0,0,0,0,0,0,0,0,06B4N
Stimme,06B4U,6,Steglitz-Zehlendorf,4U,B,064U,4,79,W,0,0,0,0,644,644,0,644,256,388,nan
Stimme,06B4V,6,Steglitz-Zehlendorf,4V,B,064V,4,79,W,0,0,0,0,0,0,0,0,0,0,06B4U
Stimme,06B4W,6,Steglitz-Zehlendorf,4W,B,064W,4,79,W,0,0,0,0,0,0,0,0,0,0,06B4U
Stimme,06B4X,6,Steglitz-Zehlendorf,4X,B,064X,4,79,W,0,0,0,0,584,584,2,582,234,348,nan
Stimme,06B4Y,6,Steglitz-Zehlendorf,4Y,B,064Y,4,79,W,0,0,0,0,0,0,0,0,0,0,06B4X
Stimme,06B5A,6,Steglitz-Zehlendorf,5A,B,065A,5,79,W,0,0,0,0,466,466,2,464,179,285,nan
Stimme,06B5AA,6,Steglitz-Zehlendorf,5AA,B,065AA,5,79,W,0,0,0,0,0,0,0,0,0,0,06B5A
Stimme,06B5B,6,Steglitz-Zehlendorf,5B,B,065B,5,79,W,0,0,0,0,0,0,0,0,0,0,06B5A
Stimme,06B5C,6,Steglitz-Zehlendorf,5C,B,065C,5,79,W,0,0,0,0,700,700,2,698,274,424,nan
Stimme,06B5D,6,Steglitz-Zehlendorf,5D,B,065D,5,79,W,0,0,0,0,0,0,0,0,0,0,06B5C
Stimme,06B5E,6,Steglitz-Zehlendorf,5E,B,065E,5,79,W,0,0,0,0,0,0,0,0,0,0,06B5C
Stimme,06B5F,6,Steglitz-Zehlendorf,5F,B,065F,5,79,W,0,0,0,0,544,544,2,542,228,314,nan
Stimme,06B5G,6,Steglitz-Zehlendorf,5G,B,065G,5,79,W,0,0,0,0,0,0,0,0,0,0,06B5F
Stimme,06B5H,6,Steglitz-Zehlendorf,5H,B,065H,5,79,W,0,0,0,0,0,0,0,0,0,0,06B5F
Stimme,06B5J,6,Steglitz-Zehlendorf,5J,B,065J,5,79,W,0,0,0,0,654,654,0,654,206,448,nan
Stimme,06B5K,6,Steglitz-Zehlendorf,5K,B,065K,5,79,W,0,0,0,0,0,0,0,0,0,0,06B5J
Stimme,06B5L,6,Steglitz-Zehlendorf,5L,B,065L,5,79,W,0,0,0,0,0,0,0,0,0,0,06B5J
Stimme,06B5M,6,Steglitz-Zehlendorf,5M,B,065M,5,79,W,0,0,0,0,618,618,0,618,209,409,nan
Stimme,06B5N,6,Steglitz-Zehlendorf,5N,B,065N,5,79,W,0,0,0,0,0,0,0,0,0,0,06B5M
Stimme,06B5P,6,Steglitz-Zehlendorf,5P,B,065P,5,79,W,0,0,0,0,0,0,0,0,0,0,06B5M
Stimme,06B5Q,6,Steglitz-Zehlendorf,5Q,B,065Q,5,79,W,0,0,0,0,327,327,0,327,112,215,nan
Stimme,06B5R,6,Steglitz-Zehlendorf,5R,B,065R,5,79,W,0,0,0,0,0,0,0,0,0,0,06B5Q
Stimme,06B5S,6,Steglitz-Zehlendorf,5S,B,065S,5,79,W,0,0,0,0,310,310,0,310,116,194,nan
Stimme,06B5T,6,Steglitz-Zehlendorf,5T,B,065T,5,79,W,0,0,0,0,0,0,0,0,0,0,06B5S
Stimme,06B5U,6,Steglitz-Zehlendorf,5U,B,065U,5,79,W,0,0,0,0,651,651,4,647,261,386,nan
Stimme,06B5V,6,Steglitz-Zehlendorf,5V,B,065V,5,79,W,0,0,0,0,0,0,0,0,0,0,06B5U
Stimme,06B5W,6,Steglitz-Zehlendorf,5W,B,065W,5,79,W,0,0,0,0,0,0,0,0,0,0,06B5U
Stimme,06B5X,6,Steglitz-Zehlendorf,5X,B,065X,5,79,W,0,0,0,0,411,411,1,410,154,256,nan
Stimme,06B5Y,6,Steglitz-Zehlendorf,5Y,B,065Y,5,79,W,0,0,0,0,0,0,0,0,0,0,06B5X
Stimme,06B5Z,6,Steglitz-Zehlendorf,5Z,B,065Z,5,79,W,0,0,0,0,0,0,0,0,0,0,06B5X
Stimme,06B6A,6,Steglitz-Zehlendorf,6A,B,066A,6,79,W,0,0,0,0,829,829,2,827,363,464,nan
Stimme,06B6AA,6,Steglitz-Zehlendorf,6AA,B,066AA,6,79,W,0,0,0,0,0,0,0,0,0,0,06B6A
Stimme,06B6B,6,Steglitz-Zehlendorf,6B,B,066B,6,79,W,0,0,0,0,0,0,0,0,0,0,06B6A
Stimme,06B6C,6,Steglitz-Zehlendorf,6C,B,066C,6,79,W,0,0,0,0,743,743,2,741,335,406,nan
Stimme,06B6D,6,Steglitz-Zehlendorf,6D,B,066D,6,79,W,0,0,0,0,0,0,0,0,0,0,06B6C
Stimme,06B6E,6,Steglitz-Zehlendorf,6E,B,066E,6,79,W,0,0,0,0,0,0,0,0,0,0,06B6C
Stimme,06B6F,6,Steglitz-Zehlendorf,6F,B,066F,6,79,W,0,0,0,0,777,777,3,774,231,543,nan
Stimme,06B6G,6,Steglitz-Zehlendorf,6G,B,066G,6,79,W,0,0,0,0,0,0,0,0,0,0,06B6F
Stimme,06B6H,6,Steglitz-Zehlendorf,6H,B,066H,6,79,W,0,0,0,0,0,0,0,0,0,0,06B6F
Stimme,06B6J,6,Steglitz-Zehlendorf,6J,B,066J,6,79,W,0,0,0,0,860,860,2,858,374,484,nan
Stimme,06B6K,6,Steglitz-Zehlendorf,6K,B,066K,6,79,W,0,0,0,0,0,0,0,0,0,0,06B6J
Stimme,06B6L,6,Steglitz-Zehlendorf,6L,B,066L,6,79,W,0,0,0,0,0,0,0,0,0,0,06B6J
Stimme,06B6M,6,Steglitz-Zehlendorf,6M,B,066M,6,79,W,0,0,0,0,820,820,0,820,377,443,nan
Stimme,06B6N,6,Steglitz-Zehlendorf,6N,B,066N,6,79,W,0,0,0,0,0,0,0,0,0,0,06B6M
Stimme,06B6P,6,Steglitz-Zehlendorf,6P,B,066P,6,79,W,0,0,0,0,0,0,0,0,0,0,06B6M
Stimme,06B6Q,6,Steglitz-Zehlendorf,6Q,B,066Q,6,79,W,0,0,0,0,675,675,0,675,303,372,nan
Stimme,06B6R,6,Steglitz-Zehlendorf,6R,B,066R,6,79,W,0,0,0,0,0,0,0,0,0,0,06B6Q
Stimme,06B6S,6,Steglitz-Zehlendorf,6S,B,066S,6,79,W,0,0,0,0,0,0,0,0,0,0,06B6Q
Stimme,06B6T,6,Steglitz-Zehlendorf,6T,B,066T,6,79,W,0,0,0,0,520,520,0,520,232,288,nan
Stimme,06B6U,6,Steglitz-Zehlendorf,6U,B,066U,6,79,W,0,0,0,0,0,0,0,0,0,0,06B6T
Stimme,06B6V,6,Steglitz-Zehlendorf,6V,B,066V,6,79,W,0,0,0,0,801,801,1,800,380,420,nan
Stimme,06B6W,6,Steglitz-Zehlendorf,6W,B,066W,6,79,W,0,0,0,0,0,0,0,0,0,0,06B6V
Stimme,06B6X,6,Steglitz-Zehlendorf,6X,B,066X,6,79,W,0,0,0,0,0,0,0,0,0,0,06B6V
Stimme,06B6Y,6,Steglitz-Zehlendorf,6Y,B,066Y,6,79,W,0,0,0,0,547,547,2,545,324,221,nan
Stimme,06B6Z,6,Steglitz-Zehlendorf,6Z,B,066Z,6,79,W,0,0,0,0,0,0,0,0,0,0,06B6Y
Stimme,06B7A,6,Steglitz-Zehlendorf,7A,B,067A,7,79,W,0,0,0,0,692,692,0,692,261,431,nan
Stimme,06B7AA,6,Steglitz-Zehlendorf,7AA,B,067AA,7,79,W,0,0,0,0,0,0,0,0,0,0,06B7A
Stimme,06B7B,6,Steglitz-Zehlendorf,7B,B,067B,7,79,W,0,0,0,0,0,0,0,0,0,0,06B7A
Stimme,06B7C,6,Steglitz-Zehlendorf,7C,B,067C,7,79,W,0,0,0,0,737,737,1,736,297,439,nan
Stimme,06B7D,6,Steglitz-Zehlendorf,7D,B,067D,7,79,W,0,0,0,0,0,0,0,0,0,0,06B7C
Stimme,06B7E,6,Steglitz-Zehlendorf,7E,B,067E,7,79,W,0,0,0,0,0,0,0,0,0,0,06B7C
Stimme,06B7F,6,Steglitz-Zehlendorf,7F,B,067F,7,79,W,0,0,0,0,606,606,5,601,240,361,nan
Stimme,06B7G,6,Steglitz-Zehlendorf,7G,B,067G,7,79,W,0,0,0,0,0,0,0,0,0,0,06B7F
Stimme,06B7H,6,Steglitz-Zehlendorf,7H,B,067H,7,79,W,0,0,0,0,715,715,3,712,286,426,nan
Stimme,06B7J,6,Steglitz-Zehlendorf,7J,B,067J,7,79,W,0,0,0,0,0,0,0,0,0,0,06B7H
Stimme,06B7K,6,Steglitz-Zehlendorf,7K,B,067K,7,79,W,0,0,0,0,0,0,0,0,0,0,06B7H
Stimme,06B7L,6,Steglitz-Zehlendorf,7L,B,067L,7,79,W,0,0,0,0,772,772,5,767,374,393,nan
Stimme,06B7M,6,Steglitz-Zehlendorf,7M,B,067M,7,79,W,0,0,0,0,0,0,0,0,0,0,06B7L
Stimme,06B7N,6,Steglitz-Zehlendorf,7N,B,067N,7,79,W,0,0,0,0,0,0,0,0,0,0,06B7L
Stimme,06B7P,6,Steglitz-Zehlendorf,7P,B,067P,7,79,W,0,0,0,0,672,672,2,670,302,368,nan
Stimme,06B7Q,6,Steglitz-Zehlendorf,7Q,B,067Q,7,79,W,0,0,0,0,0,0,0,0,0,0,06B7P
Stimme,06B7R,6,Steglitz-Zehlendorf,7R,B,067R,7,79,W,0,0,0,0,0,0,0,0,0,0,06B7P
Stimme,06B7S,6,Steglitz-Zehlendorf,7S,B,067S,7,79,W,0,0,0,0,810,810,0,810,362,448,nan
Stimme,06B7T,6,Steglitz-Zehlendorf,7T,B,067T,7,79,W,0,0,0,0,0,0,0,0,0,0,06B7S
Stimme,06B7U,6,Steglitz-Zehlendorf,7U,B,067U,7,79,W,0,0,0,0,0,0,0,0,0,0,06B7S
Stimme,06B7V,6,Steglitz-Zehlendorf,7V,B,067V,7,79,W,0,0,0,0,441,441,0,441,157,284,nan
Stimme,06B7W,6,Steglitz-Zehlendorf,7W,B,067W,7,79,W,0,0,0,0,0,0,0,0,0,0,06B7V
Stimme,06B7X,6,Steglitz-Zehlendorf,7X,B,067X,7,79,W,0,0,0,0,871,871,2,869,359,510,nan
Stimme,06B7Y,6,Steglitz-Zehlendorf,7Y,B,067Y,7,79,W,0,0,0,0,0,0,0,0,0,0,06B7X
Stimme,06B7Z,6,Steglitz-Zehlendorf,7Z,B,067Z,7,79,W,0,0,0,0,0,0,0,0,0,0,06B7X
Stimme,07W101,7,Tempelhof-Schöneberg,101,W,071A,1,81,W,1124,980,144,0,147,2,1,146,82,64,nan
Stimme,07W102,7,Tempelhof-Schöneberg,102,W,071A,1,81,W,1192,957,235,0,209,1,0,209,113,96,nan
Stimme,07W103,7,Tempelhof-Schöneberg,103,W,071B,1,81,W,1096,903,193,0,233,1,2,231,125,106,nan
Stimme,07W104,7,Tempelhof-Schöneberg,104,W,071C,1,81,W,1315,1054,261,0,288,3,3,285,185,100,nan
Stimme,07W105,7,Tempelhof-Schöneberg,105,W,071D,1,81,W,1193,905,288,0,273,5,1,272,217,55,nan
Stimme,07W106,7,Tempelhof-Schöneberg,106,W,071E,1,81,W,1136,982,154,0,203,4,1,202,153,49,nan
Stimme,07W107,7,Tempelhof-Schöneberg,107,W,071F,1,81,W,1279,1075,204,0,206,0,2,204,149,55,nan
Stimme,07W108,7,Tempelhof-Schöneberg,108,W,071G,1,81,W,1229,1024,205,0,217,3,1,216,153,63,nan
Stimme,07W109,7,Tempelhof-Schöneberg,109,W,071G,1,81,W,974,784,190,0,221,0,2,219,172,47,nan
Stimme,07W110,7,Tempelhof-Schöneberg,110,W,071H,1,81,W,1232,946,286,0,282,4,2,280,202,78,nan
Stimme,07W111,7,Tempelhof-Schöneberg,111,W,071I,1,81,W,1189,939,250,0,275,1,0,275,192,83,nan
Stimme,07W112,7,Tempelhof-Schöneberg,112,W,071K,1,81,W,1138,827,311,0,307,9,4,303,234,69,nan
Stimme,07W113,7,Tempelhof-Schöneberg,113,W,071L,1,81,W,1183,883,300,0,355,6,4,351,262,89,nan
Stimme,07W114,7,Tempelhof-Schöneberg,114,W,071M,1,81,W,1325,1037,288,0,326,6,2,324,217,107,nan
Stimme,07W115,7,Tempelhof-Schöneberg,115,W,071N,1,81,W,1119,899,220,0,214,1,1,213,133,80,nan
Stimme,07W116,7,Tempelhof-Schöneberg,116,W,071P,1,81,W,1108,850,258,0,229,1,2,227,130,97,nan
Stimme,07W117,7,Tempelhof-Schöneberg,117,W,071R,1,81,W,1119,848,271,0,243,3,1,242,144,98,nan
Stimme,07W118,7,Tempelhof-Schöneberg,118,W,071P,1,81,W,639,469,170,0,137,2,0,137,103,34,nan
Stimme,07W119,7,Tempelhof-Schöneberg,119,W,071E,1,81,W,1129,942,187,0,134,2,0,134,61,73,nan
Stimme,07W120,7,Tempelhof-Schöneberg,120,W,071N,1,81,W,1150,895,255,0,240,5,2,238,154,84,nan
Stimme,07W121,7,Tempelhof-Schöneberg,121,W,071D,1,81,W,1225,992,233,0,204,1,0,204,128,76,nan
Stimme,07W122,7,Tempelhof-Schöneberg,122,W,071S,1,81,W,1299,1002,297,0,268,7,1,267,169,98,nan
Stimme,07W123,7,Tempelhof-Schöneberg,123,W,071T,1,81,W,1099,872,227,0,242,3,0,242,190,52,nan
Stimme,07W124,7,Tempelhof-Schöneberg,124,W,071U,1,81,W,1157,887,270,0,283,12,0,283,208,75,nan
Stimme,07W125,7,Tempelhof-Schöneberg,125,W,071V,1,81,W,1132,943,189,0,225,4,2,223,166,57,nan
Stimme,07W126,7,Tempelhof-Schöneberg,126,W,071F,1,81,W,1168,990,178,0,143,6,2,141,100,41,nan
Stimme,07W127,7,Tempelhof-Schöneberg,127,W,071V,1,81,W,1155,934,221,0,226,2,0,226,186,40,nan
Stimme,07W128,7,Tempelhof-Schöneberg,128,W,071W,1,81,W,1207,971,236,0,244,5,0,244,183,61,nan
Stimme,07W129,7,Tempelhof-Schöneberg,129,W,071W,1,81,W,1239,936,303,0,275,12,0,275,225,50,nan
Stimme,07W201,7,Tempelhof-Schöneberg,201,W,072A,2,81,W,1238,920,318,0,286,4,2,284,172,112,nan
Stimme,07W202,7,Tempelhof-Schöneberg,202,W,072B,2,81,W,1107,833,274,0,145,2,4,141,91,50,nan
Stimme,07W203,7,Tempelhof-Schöneberg,203,W,072C,2,81,W,1094,818,276,0,256,1,2,254,186,68,nan
Stimme,07W204,7,Tempelhof-Schöneberg,204,W,072D,2,81,W,1192,897,295,0,351,4,1,350,256,94,nan
Stimme,07W205,7,Tempelhof-Schöneberg,205,W,072E,2,81,W,1333,1032,301,0,374,11,3,371,303,68,nan
Stimme,07W206,7,Tempelhof-Schöneberg,206,W,072F,2,81,W,1068,829,239,0,271,6,1,270,212,58,nan
Stimme,07W207,7,Tempelhof-Schöneberg,207,W,072G,2,81,W,1244,989,255,0,246,4,1,245,153,92,nan
Stimme,07W208,7,Tempelhof-Schöneberg,208,W,072H,2,81,W,1136,933,203,0,223,4,0,223,161,62,nan
Stimme,07W209,7,Tempelhof-Schöneberg,209,W,072G,2,81,W,994,726,268,0,186,1,0,186,121,65,nan
Stimme,07W210,7,Tempelhof-Schöneberg,210,W,072I,2,81,W,1115,910,205,0,228,4,2,226,148,78,nan
Stimme,07W211,7,Tempelhof-Schöneberg,211,W,072I,2,81,W,1121,875,246,0,264,3,1,263,193,70,nan
Stimme,07W212,7,Tempelhof-Schöneberg,212,W,072K,2,81,W,1180,912,268,0,301,3,2,299,233,66,nan
Stimme,07W213,7,Tempelhof-Schöneberg,213,W,072K,2,81,W,1080,874,206,0,154,2,2,152,86,66,nan
Stimme,07W214,7,Tempelhof-Schöneberg,214,W,072L,2,81,W,1281,960,321,0,320,9,1,319,266,53,nan
Stimme,07W215,7,Tempelhof-Schöneberg,215,W,072M,2,81,W,1124,897,227,0,220,1,2,218,164,54,nan
Stimme,07W216,7,Tempelhof-Schöneberg,216,W,072N,2,81,W,1211,865,346,0,243,4,4,239,197,42,nan
Stimme,07W217,7,Tempelhof-Schöneberg,217,W,072M,2,81,W,1245,974,271,0,277,15,0,277,213,64,nan
Stimme,07W218,7,Tempelhof-Schöneberg,218,W,072N,2,81,W,1133,850,283,0,236,2,2,234,185,49,nan
Stimme,07W219,7,Tempelhof-Schöneberg,219,W,072P,2,81,W,1004,748,256,0,233,2,2,231,200,31,nan
Stimme,07W220,7,Tempelhof-Schöneberg,220,W,072P,2,81,W,1175,902,273,0,292,2,3,289,237,52,nan
Stimme,07W221,7,Tempelhof-Schöneberg,221,W,072R,2,81,W,1006,901,105,0,155,1,1,154,98,56,nan
Stimme,07W222,7,Tempelhof-Schöneberg,222,W,072R,2,81,W,1190,933,257,0,232,2,1,231,103,128,nan
Stimme,07W223,7,Tempelhof-Schöneberg,223,W,072S,2,81,W,1063,854,209,0,147,5,0,147,88,59,nan
Stimme,07W224,7,Tempelhof-Schöneberg,224,W,072S,2,81,W,1590,1257,333,0,273,14,0,273,219,54,nan
Stimme,07W225,7,Tempelhof-Schöneberg,225,W,072T,2,81,W,1267,974,293,0,389,12,2,387,331,56,nan
Stimme,07W226,7,Tempelhof-Schöneberg,226,W,072U,2,81,W,1071,776,295,0,263,13,3,260,198,62,nan
Stimme,07W227,7,Tempelhof-Schöneberg,227,W,072H,2,81,W,1126,952,174,0,194,6,1,193,137,56,nan
Stimme,07W228,7,Tempelhof-Schöneberg,228,W,072V,2,81,W,1141,878,263,0,337,6,5,332,253,79,nan
Stimme,07W301,7,Tempelhof-Schöneberg,301,W,073A,3,81,W,1074,827,247,0,317,11,1,316,216,100,nan
Stimme,07W302,7,Tempelhof-Schöneberg,302,W,073B,3,81,W,1175,920,255,0,306,4,3,303,201,102,nan
Stimme,07W303,7,Tempelhof-Schöneberg,303,W,073C,3,81,W,1189,929,260,0,334,6,4,330,233,97,nan
Stimme,07W304,7,Tempelhof-Schöneberg,304,W,073D,3,81,W,1188,904,284,0,335,5,2,333,225,108,nan
Stimme,07W305,7,Tempelhof-Schöneberg,305,W,073E,3,81,W,1097,815,282,0,286,8,1,285,201,84,nan
Stimme,07W306,7,Tempelhof-Schöneberg,306,W,073F,3,81,W,1088,818,270,0,321,5,5,316,214,102,nan
Stimme,07W307,7,Tempelhof-Schöneberg,307,W,073G,3,81,W,1119,837,282,0,260,3,0,260,175,85,nan
Stimme,07W308,7,Tempelhof-Schöneberg,308,W,073A,3,81,W,1029,775,254,0,291,6,4,287,201,86,nan
Stimme,07W309,7,Tempelhof-Schöneberg,309,W,073H,3,81,W,1098,846,252,0,277,7,1,276,210,66,nan
Stimme,07W310,7,Tempelhof-Schöneberg,310,W,073I,3,81,W,1113,798,315,0,306,6,0,306,116,190,nan
Stimme,07W311,7,Tempelhof-Schöneberg,311,W,073K,3,81,W,1472,1162,310,0,372,1,0,372,254,118,nan
Stimme,07W312,7,Tempelhof-Schöneberg,312,W,073L,3,81,W,1126,825,301,0,321,5,5,316,209,107,nan
Stimme,07W313,7,Tempelhof-Schöneberg,313,W,073I,3,81,W,989,787,202,0,210,5,2,208,134,74,nan
Stimme,07W314,7,Tempelhof-Schöneberg,314,W,073M,3,81,W,1189,934,255,0,339,3,3,336,234,102,nan
Stimme,07W315,7,Tempelhof-Schöneberg,315,W,073N,3,81,W,1116,816,300,0,272,5,1,271,172,99,nan
Stimme,07W316,7,Tempelhof-Schöneberg,316,W,073D,3,81,W,1138,851,287,0,238,11,2,236,163,73,nan
Stimme,07W317,7,Tempelhof-Schöneberg,317,W,073P,3,81,W,1180,917,263,0,247,4,0,247,172,75,nan
Stimme,07W318,7,Tempelhof-Schöneberg,318,W,073R,3,81,W,1157,898,259,0,352,3,9,343,217,126,nan
Stimme,07W319,7,Tempelhof-Schöneberg,319,W,073S,3,81,W,1179,837,342,0,285,6,1,284,189,95,nan
Stimme,07W320,7,Tempelhof-Schöneberg,320,W,073M,3,81,W,1074,774,300,0,271,8,4,267,188,79,nan
Stimme,07W321,7,Tempelhof-Schöneberg,321,W,073T,3,81,W,1187,863,324,0,289,3,1,288,186,102,nan
Stimme,07W322,7,Tempelhof-Schöneberg,322,W,073U,3,81,W,1090,873,217,0,223,5,2,221,139,82,nan
Stimme,07W323,7,Tempelhof-Schöneberg,323,W,073U,3,81,W,1227,919,308,0,342,10,2,340,241,99,nan
Stimme,07W324,7,Tempelhof-Schöneberg,324,W,073V,3,81,W,1124,988,136,0,198,3,0,198,106,92,nan
Stimme,07W325,7,Tempelhof-Schöneberg,325,W,073V,3,81,W,1046,831,215,0,236,2,1,235,161,74,nan
Stimme,07W326,7,Tempelhof-Schöneberg,326,W,073W,3,81,W,1216,999,217,0,172,7,1,171,94,77,nan
Stimme,07W327,7,Tempelhof-Schöneberg,327,W,073W,3,81,W,1526,1274,252,0,353,3,1,352,194,158,nan
Stimme,07W328,7,Tempelhof-Schöneberg,328,W,073X,3,81,W,1220,927,293,0,177,0,0,177,66,111,nan
Stimme,07W329,7,Tempelhof-Schöneberg,329,W,073Y,3,81,W,1256,903,353,0,207,5,1,206,88,118,nan
Stimme,07W401,7,Tempelhof-Schöneberg,401,W,074A,4,81,W,1211,895,316,0,349,10,2,347,234,113,nan
Stimme,07W402,7,Tempelhof-Schöneberg,402,W,074B,4,81,W,1071,818,253,0,217,5,0,217,127,90,nan
Stimme,07W403,7,Tempelhof-Schöneberg,403,W,074B,4,81,W,1188,963,225,0,176,2,2,174,81,93,nan
Stimme,07W404,7,Tempelhof-Schöneberg,404,W,074C,4,81,W,1215,969,246,0,206,3,4,202,115,87,nan
Stimme,07W405,7,Tempelhof-Schöneberg,405,W,074C,4,81,W,1152,805,347,0,344,5,1,343,257,86,nan
Stimme,07W406,7,Tempelhof-Schöneberg,406,W,074D,4,81,W,1175,848,327,0,301,3,2,299,198,101,nan
Stimme,07W407,7,Tempelhof-Schöneberg,407,W,074E,4,81,W,1141,810,331,0,254,5,0,254,160,94,nan
Stimme,07W408,7,Tempelhof-Schöneberg,408,W,074F,4,81,W,1133,932,201,0,188,1,3,185,78,107,nan
Stimme,07W409,7,Tempelhof-Schöneberg,409,W,074F,4,81,W,1270,1004,266,0,198,0,1,197,100,97,nan
Stimme,07W410,7,Tempelhof-Schöneberg,410,W,074G,4,81,W,1025,821,204,0,151,1,2,149,83,66,nan
Stimme,07W411,7,Tempelhof-Schöneberg,411,W,074G,4,81,W,1106,839,267,0,135,2,1,134,66,68,nan
Stimme,07W412,7,Tempelhof-Schöneberg,412,W,074H,4,81,W,1044,853,191,0,202,3,1,201,96,105,nan
Stimme,07W413,7,Tempelhof-Schöneberg,413,W,074H,4,81,W,1220,1007,213,0,185,1,1,184,97,87,nan
Stimme,07W414,7,Tempelhof-Schöneberg,414,W,074I,4,81,W,1061,812,249,0,165,1,0,165,76,89,nan
Stimme,07W415,7,Tempelhof-Schöneberg,415,W,074I,4,81,W,1111,810,301,0,149,1,0,149,60,89,nan
Stimme,07W416,7,Tempelhof-Schöneberg,416,W,074K,4,81,W,1216,983,233,0,247,4,0,247,160,87,nan
Stimme,07W417,7,Tempelhof-Schöneberg,417,W,074L,4,81,W,1103,821,282,0,227,2,2,225,131,94,nan
Stimme,07W418,7,Tempelhof-Schöneberg,418,W,074M,4,81,W,1113,797,316,0,260,7,5,255,171,84,nan
Stimme,07W419,7,Tempelhof-Schöneberg,419,W,074N,4,81,W,1104,823,281,0,291,3,2,289,196,93,nan
Stimme,07W420,7,Tempelhof-Schöneberg,420,W,074P,4,81,W,1108,860,248,0,254,2,1,253,177,76,nan
Stimme,07W421,7,Tempelhof-Schöneberg,421,W,074P,4,81,W,1084,853,231,0,259,8,1,258,163,95,nan
Stimme,07W422,7,Tempelhof-Schöneberg,422,W,074R,4,81,W,1206,1003,203,0,266,3,4,262,158,104,nan
Stimme,07W423,7,Tempelhof-Schöneberg,423,W,074S,4,81,W,1269,1062,207,0,274,3,0,274,180,94,nan
Stimme,07W424,7,Tempelhof-Schöneberg,424,W,074T,4,81,W,1282,1094,188,0,180,1,1,179,109,70,nan
Stimme,07W425,7,Tempelhof-Schöneberg,425,W,074T,4,81,W,1148,954,194,0,189,2,1,188,90,98,nan
Stimme,07W426,7,Tempelhof-Schöneberg,426,W,074U,4,81,W,1171,933,238,0,229,1,1,228,121,107,nan
Stimme,07W427,7,Tempelhof-Schöneberg,427,W,074V,4,81,W,1173,955,218,0,221,2,1,220,112,108,nan
Stimme,07W428,7,Tempelhof-Schöneberg,428,W,074S,4,81,W,1158,879,279,0,236,4,0,236,148,88,nan
Stimme,07W501,7,Tempelhof-Schöneberg,501,W,075A,5,81,W,1136,941,195,0,187,1,0,187,82,105,nan
Stimme,07W502,7,Tempelhof-Schöneberg,502,W,075A,5,81,W,1240,1000,240,0,200,0,3,197,78,119,nan
Stimme,07W503,7,Tempelhof-Schöneberg,503,W,075B,5,81,W,1156,944,212,0,168,1,0,168,65,103,nan
Stimme,07W504,7,Tempelhof-Schöneberg,504,W,075B,5,81,W,1180,952,228,0,216,2,0,216,95,121,nan
Stimme,07W505,7,Tempelhof-Schöneberg,505,W,075C,5,81,W,1299,1118,181,0,165,2,2,163,49,114,nan
Stimme,07W506,7,Tempelhof-Schöneberg,506,W,075D,5,81,W,1114,953,161,0,118,2,0,118,57,61,nan
Stimme,07W507,7,Tempelhof-Schöneberg,507,W,075E,5,81,W,1202,979,223,0,213,7,0,213,116,97,nan
Stimme,07W508,7,Tempelhof-Schöneberg,508,W,075F,5,81,W,1228,1004,224,0,233,1,0,233,98,135,nan
Stimme,07W509,7,Tempelhof-Schöneberg,509,W,075C,5,81,W,1184,965,219,0,175,2,0,175,83,92,nan
Stimme,07W510,7,Tempelhof-Schöneberg,510,W,075G,5,81,W,1138,953,185,0,158,0,0,158,71,87,nan
Stimme,07W511,7,Tempelhof-Schöneberg,511,W,075H,5,81,W,1225,1016,209,0,221,0,0,221,96,125,nan
Stimme,07W512,7,Tempelhof-Schöneberg,512,W,075H,5,81,W,1032,911,121,0,186,1,0,186,48,138,nan
Stimme,07W513,7,Tempelhof-Schöneberg,513,W,075G,5,81,W,1079,962,117,0,157,0,0,157,51,106,nan
Stimme,07W514,7,Tempelhof-Schöneberg,514,W,075D,5,81,W,1184,911,273,0,136,1,0,136,69,67,nan
Stimme,07W515,7,Tempelhof-Schöneberg,515,W,075I,5,81,W,1244,970,274,0,194,3,0,194,77,117,nan
Stimme,07W516,7,Tempelhof-Schöneberg,516,W,075K,5,81,W,1149,979,170,0,215,2,2,213,89,124,nan
Stimme,07W517,7,Tempelhof-Schöneberg,517,W,075L,5,81,W,1283,1041,242,0,215,1,0,215,87,128,nan
Stimme,07W518,7,Tempelhof-Schöneberg,518,W,075K,5,81,W,1081,855,226,0,200,4,0,200,62,138,nan
Stimme,07W519,7,Tempelhof-Schöneberg,519,W,075M,5,81,W,1078,918,160,0,200,4,1,199,109,90,nan
Stimme,07W520,7,Tempelhof-Schöneberg,520,W,075M,5,81,W,987,853,134,0,146,1,0,146,94,52,nan
Stimme,07W521,7,Tempelhof-Schöneberg,521,W,075N,5,81,W,1225,999,226,0,260,4,3,257,71,186,nan
Stimme,07W522,7,Tempelhof-Schöneberg,522,W,075P,5,81,W,1226,995,231,0,241,1,0,241,82,159,nan
Stimme,07W523,7,Tempelhof-Schöneberg,523,W,075R,5,81,W,1418,1167,251,0,254,3,1,253,77,176,nan
Stimme,07W524,7,Tempelhof-Schöneberg,524,W,075R,5,81,W,1056,854,202,0,210,2,3,207,80,127,nan
Stimme,07W525,7,Tempelhof-Schöneberg,525,W,075S,5,81,W,1128,837,291,0,180,2,1,179,54,125,nan
Stimme,07W526,7,Tempelhof-Schöneberg,526,W,075S,5,81,W,1071,780,291,0,202,6,0,202,69,133,nan
Stimme,07W527,7,Tempelhof-Schöneberg,527,W,075T,5,81,W,1187,1035,152,0,339,3,6,333,133,200,nan
Stimme,07W528,7,Tempelhof-Schöneberg,528,W,075T,5,81,W,974,698,276,0,194,2,2,192,68,124,nan
Stimme,07W601,7,Tempelhof-Schöneberg,601,W,076A,6,81,W,1142,925,217,0,156,2,0,156,48,108,nan
Stimme,07W602,7,Tempelhof-Schöneberg,602,W,076B,6,81,W,1075,875,200,0,238,2,1,237,85,152,nan
Stimme,07W603,7,Tempelhof-Schöneberg,603,W,076C,6,81,W,1265,1091,174,0,243,4,2,241,64,177,nan
Stimme,07W604,7,Tempelhof-Schöneberg,604,W,076C,6,81,W,979,888,91,0,195,2,1,194,59,135,nan
Stimme,07W605,7,Tempelhof-Schöneberg,605,W,076D,6,81,W,1239,1046,193,0,226,4,0,226,62,164,nan
Stimme,07W606,7,Tempelhof-Schöneberg,606,W,076E,6,81,W,1224,967,257,0,177,4,3,174,47,127,nan
Stimme,07W607,7,Tempelhof-Schöneberg,607,W,076F,6,81,W,1095,903,192,0,160,1,0,160,44,116,nan
Stimme,07W608,7,Tempelhof-Schöneberg,608,W,076F,6,81,W,1163,987,176,0,123,2,0,123,26,97,nan
Stimme,07W609,7,Tempelhof-Schöneberg,609,W,076G,6,81,W,1217,1077,140,0,189,0,1,188,49,139,nan
Stimme,07W610,7,Tempelhof-Schöneberg,610,W,076G,6,81,W,1147,1006,141,0,189,1,0,189,49,140,nan
Stimme,07W611,7,Tempelhof-Schöneberg,611,W,076H,6,81,W,1079,961,118,0,110,1,0,110,27,83,nan
Stimme,07W612,7,Tempelhof-Schöneberg,612,W,076B,6,81,W,1228,933,295,0,232,1,1,231,78,153,nan
Stimme,07W613,7,Tempelhof-Schöneberg,613,W,076I,6,81,W,1129,921,208,0,276,2,6,270,94,176,nan
Stimme,07W614,7,Tempelhof-Schöneberg,614,W,076H,6,81,W,1171,1049,122,0,124,0,0,124,38,86,nan
Stimme,07W615,7,Tempelhof-Schöneberg,615,W,076K,6,81,W,1206,869,337,0,354,2,2,352,120,232,nan
Stimme,07W616,7,Tempelhof-Schöneberg,616,W,076L,6,81,W,1183,938,245,0,213,1,0,213,66,147,nan
Stimme,07W617,7,Tempelhof-Schöneberg,617,W,076M,6,81,W,1213,898,315,0,271,2,2,269,77,192,nan
Stimme,07W618,7,Tempelhof-Schöneberg,618,W,076N,6,81,W,1115,969,146,0,155,0,1,154,46,108,nan
Stimme,07W619,7,Tempelhof-Schöneberg,619,W,076N,6,81,W,1181,967,214,0,170,2,0,170,46,124,nan
Stimme,07W620,7,Tempelhof-Schöneberg,620,W,076P,6,81,W,1156,877,279,0,260,0,1,259,94,165,nan
Stimme,07W621,7,Tempelhof-Schöneberg,621,W,076R,6,81,W,1112,770,342,0,235,0,2,233,61,172,nan
Stimme,07W622,7,Tempelhof-Schöneberg,622,W,076S,6,81,W,996,855,141,0,140,0,1,139,30,109,nan
Stimme,07W623,7,Tempelhof-Schöneberg,623,W,076S,6,81,W,1204,1017,187,0,212,1,0,212,45,167,nan
Stimme,07W624,7,Tempelhof-Schöneberg,624,W,076T,6,81,W,1079,844,235,0,183,1,0,183,62,121,nan
Stimme,07W625,7,Tempelhof-Schöneberg,625,W,076A,6,81,W,1053,804,249,0,284,1,3,281,58,223,nan
Stimme,07W626,7,Tempelhof-Schöneberg,626,W,076U,6,81,W,1157,908,249,0,238,4,1,237,74,163,nan
Stimme,07W627,7,Tempelhof-Schöneberg,627,W,076U,6,81,W,577,414,163,0,140,0,0,140,53,87,nan
Stimme,07W628,7,Tempelhof-Schöneberg,628,W,076R,6,81,W,1082,774,308,0,255,5,2,253,66,187,nan
Stimme,07W701,7,Tempelhof-Schöneberg,701,W,077A,7,81,W,1167,874,293,0,244,1,2,242,65,177,nan
Stimme,07W702,7,Tempelhof-Schöneberg,702,W,077B,7,81,W,1085,846,239,0,271,3,2,269,68,201,nan
Stimme,07W703,7,Tempelhof-Schöneberg,703,W,077C,7,81,W,1118,843,275,0,207,2,2,205,72,133,nan
Stimme,07W704,7,Tempelhof-Schöneberg,704,W,077D,7,81,W,1131,876,255,0,306,0,3,303,91,212,nan
Stimme,07W705,7,Tempelhof-Schöneberg,705,W,077D,7,81,W,1326,1095,231,0,293,2,2,291,122,169,nan
Stimme,07W706,7,Tempelhof-Schöneberg,706,W,077E,7,81,W,1285,1157,128,0,165,6,2,163,47,116,nan
Stimme,07W707,7,Tempelhof-Schöneberg,707,W,077E,7,81,W,1219,1053,166,0,184,2,0,184,44,140,nan
Stimme,07W708,7,Tempelhof-Schöneberg,708,W,077F,7,81,W,1146,941,205,0,169,1,0,169,61,108,nan
Stimme,07W709,7,Tempelhof-Schöneberg,709,W,077F,7,81,W,1222,1011,211,0,258,2,2,256,79,177,nan
Stimme,07W710,7,Tempelhof-Schöneberg,710,W,077G,7,81,W,1143,912,231,0,343,2,2,341,76,265,nan
Stimme,07W711,7,Tempelhof-Schöneberg,711,W,077H,7,81,W,1144,869,275,0,199,5,2,197,75,122,nan
Stimme,07W712,7,Tempelhof-Schöneberg,712,W,077I,7,81,W,1126,872,254,0,303,2,3,300,101,199,nan
Stimme,07W713,7,Tempelhof-Schöneberg,713,W,077K,7,81,W,1280,925,355,0,292,0,2,290,95,195,nan
Stimme,07W714,7,Tempelhof-Schöneberg,714,W,077L,7,81,W,1152,1032,120,0,226,1,1,225,45,180,nan
Stimme,07W715,7,Tempelhof-Schöneberg,715,W,077M,7,81,W,1161,908,253,0,333,4,4,329,75,254,nan
Stimme,07W716,7,Tempelhof-Schöneberg,716,W,077N,7,81,W,1187,899,288,0,294,3,1,293,80,213,nan
Stimme,07W717,7,Tempelhof-Schöneberg,717,W,077P,7,81,W,1143,847,296,0,207,6,1,206,48,158,nan
Stimme,07W718,7,Tempelhof-Schöneberg,718,W,077P,7,81,W,1095,945,150,0,207,0,1,206,51,155,nan
Stimme,07W719,7,Tempelhof-Schöneberg,719,W,077R,7,81,W,1200,912,288,0,230,5,1,229,62,167,nan
Stimme,07W720,7,Tempelhof-Schöneberg,720,W,077R,7,81,W,1137,921,216,0,226,1,1,225,58,167,nan
Stimme,07W721,7,Tempelhof-Schöneberg,721,W,077S,7,81,W,1114,887,227,0,271,3,2,269,65,204,nan
Stimme,07W722,7,Tempelhof-Schöneberg,722,W,077T,7,81,W,1149,948,201,0,204,0,0,204,57,147,nan
Stimme,07W723,7,Tempelhof-Schöneberg,723,W,077T,7,81,W,1184,1033,151,0,195,3,2,193,58,135,nan
Stimme,07W724,7,Tempelhof-Schöneberg,724,W,077S,7,81,W,1134,1010,124,0,167,1,0,167,38,129,nan
Stimme,07W725,7,Tempelhof-Schöneberg,725,W,077U,7,81,W,1064,926,138,0,132,1,0,132,31,101,nan
Stimme,07W726,7,Tempelhof-Schöneberg,726,W,077U,7,81,W,1148,877,271,0,236,1,0,236,85,151,nan
Stimme,07W727,7,Tempelhof-Schöneberg,727,W,077V,7,81,W,961,711,250,0,199,2,0,199,54,145,nan
Stimme,07W728,7,Tempelhof-Schöneberg,728,W,077V,7,81,W,924,644,280,0,193,3,1,192,54,138,nan
Stimme,07B1A,7,Tempelhof-Schöneberg,1A,B,071A,1,81,W,0,0,0,0,744,744,2,742,422,320,nan
Stimme,07B1B,7,Tempelhof-Schöneberg,1B,B,071B,1,81,W,0,0,0,0,0,0,0,0,0,0,07B1A
Stimme,07B1C,7,Tempelhof-Schöneberg,1C,B,071C,1,81,W,0,0,0,0,698,698,4,694,437,257,nan
Stimme,07B1D,7,Tempelhof-Schöneberg,1D,B,071D,1,81,W,0,0,0,0,0,0,0,0,0,0,07B1C
Stimme,07B1E,7,Tempelhof-Schöneberg,1E,B,071E,1,81,W,0,0,0,0,616,616,0,616,383,233,nan
Stimme,07B1F,7,Tempelhof-Schöneberg,1F,B,071F,1,81,W,0,0,0,0,0,0,0,0,0,0,07B1E
Stimme,07B1G,7,Tempelhof-Schöneberg,1G,B,071G,1,81,W,0,0,0,0,592,592,3,589,405,184,nan
Stimme,07B1H,7,Tempelhof-Schöneberg,1H,B,071H,1,81,W,0,0,0,0,0,0,0,0,0,0,07B1G
Stimme,07B1I,7,Tempelhof-Schöneberg,1I,B,071I,1,81,W,0,0,0,0,997,997,2,995,666,329,nan
Stimme,07B1K,7,Tempelhof-Schöneberg,1K,B,071K,1,81,W,0,0,0,0,0,0,0,0,0,0,07B1I
Stimme,07B1L,7,Tempelhof-Schöneberg,1L,B,071L,1,81,W,0,0,0,0,0,0,0,0,0,0,07B1I
Stimme,07B1M,7,Tempelhof-Schöneberg,1M,B,071M,1,81,W,0,0,0,0,0,0,0,0,0,0,07B1I
Stimme,07B1N,7,Tempelhof-Schöneberg,1N,B,071N,1,81,W,0,0,0,0,1038,1038,4,1034,596,438,nan
Stimme,07B1P,7,Tempelhof-Schöneberg,1P,B,071P,1,81,W,0,0,0,0,0,0,0,0,0,0,07B1N
Stimme,07B1R,7,Tempelhof-Schöneberg,1R,B,071R,1,81,W,0,0,0,0,0,0,0,0,0,0,07B1N
Stimme,07B1S,7,Tempelhof-Schöneberg,1S,B,071S,1,81,W,0,0,0,0,0,0,0,0,0,0,07B1A
Stimme,07B1T,7,Tempelhof-Schöneberg,1T,B,071T,1,81,W,0,0,0,0,433,433,4,429,304,125,nan
Stimme,07B1U,7,Tempelhof-Schöneberg,1U,B,071U,1,81,W,0,0,0,0,0,0,0,0,0,0,07B1T
Stimme,07B1V,7,Tempelhof-Schöneberg,1V,B,071V,1,81,W,0,0,0,0,0,0,0,0,0,0,07B1T
Stimme,07B1W,7,Tempelhof-Schöneberg,1W,B,071W,1,81,W,0,0,0,0,811,811,2,809,611,198,nan
Stimme,07B2A,7,Tempelhof-Schöneberg,2A,B,072A,2,81,W,0,0,0,0,1002,1002,3,999,587,412,nan
Stimme,07B2B,7,Tempelhof-Schöneberg,2B,B,072B,2,81,W,0,0,0,0,0,0,0,0,0,0,07B2A
Stimme,07B2C,7,Tempelhof-Schöneberg,2C,B,072C,2,81,W,0,0,0,0,695,695,2,693,461,232,nan
Stimme,07B2D,7,Tempelhof-Schöneberg,2D,B,072D,2,81,W,0,0,0,0,0,0,0,0,0,0,07B2C
Stimme,07B2E,7,Tempelhof-Schöneberg,2E,B,072E,2,81,W,0,0,0,0,0,0,0,0,0,0,07B2H
Stimme,07B2F,7,Tempelhof-Schöneberg,2F,B,072F,2,81,W,0,0,0,0,0,0,0,0,0,0,07B2C
Stimme,07B2G,7,Tempelhof-Schöneberg,2G,B,072G,2,81,W,0,0,0,0,0,0,0,0,0,0,07B2A
Stimme,07B2H,7,Tempelhof-Schöneberg,2H,B,072H,2,81,W,0,0,0,0,593,593,0,593,441,152,nan
Stimme,07B2I,7,Tempelhof-Schöneberg,2I,B,072I,2,81,W,0,0,0,0,808,808,1,807,578,229,nan
Stimme,07B2K,7,Tempelhof-Schöneberg,2K,B,072K,2,81,W,0,0,0,0,0,0,0,0,0,0,07B2I
Stimme,07B2L,7,Tempelhof-Schöneberg,2L,B,072L,2,81,W,0,0,0,0,990,990,7,983,743,240,nan
Stimme,07B2M,7,Tempelhof-Schöneberg,2M,B,072M,2,81,W,0,0,0,0,442,442,1,441,336,105,nan
Stimme,07B2N,7,Tempelhof-Schöneberg,2N,B,072N,2,81,W,0,0,0,0,1004,1004,2,1002,777,225,nan
Stimme,07B2P,7,Tempelhof-Schöneberg,2P,B,072P,2,81,W,0,0,0,0,0,0,0,0,0,0,07B2N
Stimme,07B2R,7,Tempelhof-Schöneberg,2R,B,072R,2,81,W,0,0,0,0,749,749,0,749,429,320,nan
Stimme,07B2S,7,Tempelhof-Schöneberg,2S,B,072S,2,81,W,0,0,0,0,0,0,0,0,0,0,07B2R
Stimme,07B2T,7,Tempelhof-Schöneberg,2T,B,072T,2,81,W,0,0,0,0,0,0,0,0,0,0,07B2L
Stimme,07B2U,7,Tempelhof-Schöneberg,2U,B,072U,2,81,W,0,0,0,0,0,0,0,0,0,0,07B2L
Stimme,07B2V,7,Tempelhof-Schöneberg,2V,B,072V,2,81,W,0,0,0,0,0,0,0,0,0,0,07B2L
Stimme,07B3A,7,Tempelhof-Schöneberg,3A,B,073A,3,81,W,0,0,0,0,903,903,3,900,556,344,nan
Stimme,07B3B,7,Tempelhof-Schöneberg,3B,B,073B,3,81,W,0,0,0,0,0,0,0,0,0,0,07B3A
Stimme,07B3C,7,Tempelhof-Schöneberg,3C,B,073C,3,81,W,0,0,0,0,683,683,3,680,425,255,nan
Stimme,07B3D,7,Tempelhof-Schöneberg,3D,B,073D,3,81,W,0,0,0,0,0,0,0,0,0,0,07B3R
Stimme,07B3E,7,Tempelhof-Schöneberg,3E,B,073E,3,81,W,0,0,0,0,0,0,0,0,0,0,07B3C
Stimme,07B3F,7,Tempelhof-Schöneberg,3F,B,073F,3,81,W,0,0,0,0,0,0,0,0,0,0,07B3C
Stimme,07B3G,7,Tempelhof-Schöneberg,3G,B,073G,3,81,W,0,0,0,0,0,0,0,0,0,0,07B3A
Stimme,07B3H,7,Tempelhof-Schöneberg,3H,B,073H,3,81,W,0,0,0,0,661,661,3,658,390,268,nan
Stimme,07B3I,7,Tempelhof-Schöneberg,3I,B,073I,3,81,W,0,0,0,0,0,0,0,0,0,0,07B3H
Stimme,07B3K,7,Tempelhof-Schöneberg,3K,B,073K,3,81,W,0,0,0,0,0,0,0,0,0,0,07B3L
Stimme,07B3L,7,Tempelhof-Schöneberg,3L,B,073L,3,81,W,0,0,0,0,520,520,4,516,325,191,nan
Stimme,07B3M,7,Tempelhof-Schöneberg,3M,B,073M,3,81,W,0,0,0,0,1072,1072,2,1070,680,390,nan
Stimme,07B3N,7,Tempelhof-Schöneberg,3N,B,073N,3,81,W,0,0,0,0,0,0,0,0,0,0,07B3M
Stimme,07B3P,7,Tempelhof-Schöneberg,3P,B,073P,3,81,W,0,0,0,0,0,0,0,0,0,0,07B3R
Stimme,07B3R,7,Tempelhof-Schöneberg,3R,B,073R,3,81,W,0,0,0,0,935,935,1,934,590,344,nan
Stimme,07B3S,7,Tempelhof-Schöneberg,3S,B,073S,3,81,W,0,0,0,0,0,0,0,0,0,0,07B3M
Stimme,07B3T,7,Tempelhof-Schöneberg,3T,B,073T,3,81,W,0,0,0,0,0,0,0,0,0,0,07B3U
Stimme,07B3U,7,Tempelhof-Schöneberg,3U,B,073U,3,81,W,0,0,0,0,729,729,2,727,479,248,nan
Stimme,07B3V,7,Tempelhof-Schöneberg,3V,B,073V,3,81,W,0,0,0,0,302,302,2,300,203,97,nan
Stimme,07B3W,7,Tempelhof-Schöneberg,3W,B,073W,3,81,W,0,0,0,0,979,979,1,978,485,493,nan
Stimme,07B3X,7,Tempelhof-Schöneberg,3X,B,073X,3,81,W,0,0,0,0,0,0,0,0,0,0,07B3W
Stimme,07B3Y,7,Tempelhof-Schöneberg,3Y,B,073Y,3,81,W,0,0,0,0,0,0,0,0,0,0,07B3W
Stimme,07B4A,7,Tempelhof-Schöneberg,4A,B,074A,4,81,W,0,0,0,0,863,863,3,860,524,336,nan
Stimme,07B4B,7,Tempelhof-Schöneberg,4B,B,074B,4,81,W,0,0,0,0,943,943,4,939,557,382,nan
Stimme,07B4C,7,Tempelhof-Schöneberg,4C,B,074C,4,81,W,0,0,0,0,0,0,0,0,0,0,07B4B
Stimme,07B4D,7,Tempelhof-Schöneberg,4D,B,074D,4,81,W,0,0,0,0,0,0,0,0,0,0,07B4A
Stimme,07B4E,7,Tempelhof-Schöneberg,4E,B,074E,4,81,W,0,0,0,0,0,0,0,0,0,0,07B4A
Stimme,07B4F,7,Tempelhof-Schöneberg,4F,B,074F,4,81,W,0,0,0,0,642,642,2,640,332,308,nan
Stimme,07B4G,7,Tempelhof-Schöneberg,4G,B,074G,4,81,W,0,0,0,0,789,789,1,788,378,410,nan
Stimme,07B4H,7,Tempelhof-Schöneberg,4H,B,074H,4,81,W,0,0,0,0,0,0,0,0,0,0,07B4G
Stimme,07B4I,7,Tempelhof-Schöneberg,4I,B,074I,4,81,W,0,0,0,0,688,688,2,686,360,326,nan
Stimme,07B4K,7,Tempelhof-Schöneberg,4K,B,074K,4,81,W,0,0,0,0,0,0,0,0,0,0,07B4I
Stimme,07B4L,7,Tempelhof-Schöneberg,4L,B,074L,4,81,W,0,0,0,0,0,0,0,0,0,0,07B4F
Stimme,07B4M,7,Tempelhof-Schöneberg,4M,B,074M,4,81,W,0,0,0,0,0,0,0,0,0,0,07B4P
Stimme,07B4N,7,Tempelhof-Schöneberg,4N,B,074N,4,81,W,0,0,0,0,0,0,0,0,0,0,07B4P
Stimme,07B4P,7,Tempelhof-Schöneberg,4P,B,074P,4,81,W,0,0,0,0,946,946,3,943,549,394,nan
Stimme,07B4R,7,Tempelhof-Schöneberg,4R,B,074R,4,81,W,0,0,0,0,178,178,1,177,117,60,nan
Stimme,07B4S,7,Tempelhof-Schöneberg,4S,B,074S,4,81,W,0,0,0,0,0,0,0,0,0,0,07B4R
Stimme,07B4T,7,Tempelhof-Schöneberg,4T,B,074T,4,81,W,0,0,0,0,524,524,3,521,289,232,nan
Stimme,07B4U,7,Tempelhof-Schöneberg,4U,B,074U,4,81,W,0,0,0,0,0,0,0,0,0,0,07B4T
Stimme,07B4V,7,Tempelhof-Schöneberg,4V,B,074V,4,81,W,0,0,0,0,629,629,1,628,371,257,nan
Stimme,07B5A,7,Tempelhof-Schöneberg,5A,B,075A,5,81,W,0,0,0,0,740,740,2,738,307,431,nan
Stimme,07B5B,7,Tempelhof-Schöneberg,5B,B,075B,5,81,W,0,0,0,0,0,0,0,0,0,0,07B5A
Stimme,07B5C,7,Tempelhof-Schöneberg,5C,B,075C,5,81,W,0,0,0,0,542,542,4,538,236,302,nan
Stimme,07B5D,7,Tempelhof-Schöneberg,5D,B,075D,5,81,W,0,0,0,0,549,549,0,549,243,306,nan
Stimme,07B5E,7,Tempelhof-Schöneberg,5E,B,075E,5,81,W,0,0,0,0,0,0,0,0,0,0,07B5D
Stimme,07B5F,7,Tempelhof-Schöneberg,5F,B,075F,5,81,W,0,0,0,0,0,0,0,0,0,0,07B5C
Stimme,07B5G,7,Tempelhof-Schöneberg,5G,B,075G,5,81,W,0,0,0,0,555,555,3,552,224,328,nan
Stimme,07B5H,7,Tempelhof-Schöneberg,5H,B,075H,5,81,W,0,0,0,0,0,0,0,0,0,0,07B5G
Stimme,07B5I,7,Tempelhof-Schöneberg,5I,B,075I,5,81,W,0,0,0,0,0,0,0,0,0,0,07B5K
Stimme,07B5K,7,Tempelhof-Schöneberg,5K,B,075K,5,81,W,0,0,0,0,805,805,4,801,324,477,nan
Stimme,07B5L,7,Tempelhof-Schöneberg,5L,B,075L,5,81,W,0,0,0,0,0,0,0,0,0,0,07B5K
Stimme,07B5M,7,Tempelhof-Schöneberg,5M,B,075M,5,81,W,0,0,0,0,440,440,0,440,229,211,nan
Stimme,07B5N,7,Tempelhof-Schöneberg,5N,B,075N,5,81,W,0,0,0,0,0,0,0,0,0,0,07B5M
Stimme,07B5P,7,Tempelhof-Schöneberg,5P,B,075P,5,81,W,0,0,0,0,0,0,0,0,0,0,07B5R
Stimme,07B5R,7,Tempelhof-Schöneberg,5R,B,075R,5,81,W,0,0,0,0,579,579,0,579,173,406,nan
Stimme,07B5S,7,Tempelhof-Schöneberg,5S,B,075S,5,81,W,0,0,0,0,899,899,0,899,275,624,nan
Stimme,07B5T,7,Tempelhof-Schöneberg,5T,B,075T,5,81,W,0,0,0,0,0,0,0,0,0,0,07B5S
Stimme,07B6A,7,Tempelhof-Schöneberg,6A,B,076A,6,81,W,0,0,0,0,781,781,2,779,283,496,nan
Stimme,07B6B,7,Tempelhof-Schöneberg,6B,B,076B,6,81,W,0,0,0,0,883,883,6,877,268,609,nan
Stimme,07B6C,7,Tempelhof-Schöneberg,6C,B,076C,6,81,W,0,0,0,0,387,387,0,387,116,271,nan
Stimme,07B6D,7,Tempelhof-Schöneberg,6D,B,076D,6,81,W,0,0,0,0,0,0,0,0,0,0,07B6C
Stimme,07B6E,7,Tempelhof-Schöneberg,6E,B,076E,6,81,W,0,0,0,0,0,0,0,0,0,0,07B6F
Stimme,07B6F,7,Tempelhof-Schöneberg,6F,B,076F,6,81,W,0,0,0,0,542,542,0,542,147,395,nan
Stimme,07B6G,7,Tempelhof-Schöneberg,6G,B,076G,6,81,W,0,0,0,0,433,433,2,431,144,287,nan
Stimme,07B6H,7,Tempelhof-Schöneberg,6H,B,076H,6,81,W,0,0,0,0,0,0,0,0,0,0,07B6G
Stimme,07B6I,7,Tempelhof-Schöneberg,6I,B,076I,6,81,W,0,0,0,0,0,0,0,0,0,0,07B6B
Stimme,07B6K,7,Tempelhof-Schöneberg,6K,B,076K,6,81,W,0,0,0,0,0,0,0,0,0,0,07B6R
Stimme,07B6L,7,Tempelhof-Schöneberg,6L,B,076L,6,81,W,0,0,0,0,0,0,0,0,0,0,07B6R
Stimme,07B6M,7,Tempelhof-Schöneberg,6M,B,076M,6,81,W,0,0,0,0,0,0,0,0,0,0,07B6B
Stimme,07B6N,7,Tempelhof-Schöneberg,6N,B,076N,6,81,W,0,0,0,0,556,556,1,555,141,414,nan
Stimme,07B6P,7,Tempelhof-Schöneberg,6P,B,076P,6,81,W,0,0,0,0,0,0,0,0,0,0,07B6N
Stimme,07B6R,7,Tempelhof-Schöneberg,6R,B,076R,6,81,W,0,0,0,0,1101,1101,1,1100,301,799,nan
Stimme,07B6S,7,Tempelhof-Schöneberg,6S,B,076S,6,81,W,0,0,0,0,509,509,2,507,158,349,nan
Stimme,07B6T,7,Tempelhof-Schöneberg,6T,B,076T,6,81,W,0,0,0,0,0,0,0,0,0,0,07B6S
Stimme,07B6U,7,Tempelhof-Schöneberg,6U,B,076U,6,81,W,0,0,0,0,0,0,0,0,0,0,07B6A
Stimme,07B7A,7,Tempelhof-Schöneberg,7A,B,077A,7,81,W,0,0,0,0,682,682,0,682,185,497,nan
Stimme,07B7B,7,Tempelhof-Schöneberg,7B,B,077B,7,81,W,0,0,0,0,0,0,0,0,0,0,07B7A
Stimme,07B7C,7,Tempelhof-Schöneberg,7C,B,077C,7,81,W,0,0,0,0,0,0,0,0,0,0,07B7D
Stimme,07B7D,7,Tempelhof-Schöneberg,7D,B,077D,7,81,W,0,0,0,0,675,675,0,675,195,480,nan
Stimme,07B7E,7,Tempelhof-Schöneberg,7E,B,077E,7,81,W,0,0,0,0,257,257,0,257,77,180,nan
Stimme,07B7F,7,Tempelhof-Schöneberg,7F,B,077F,7,81,W,0,0,0,0,707,707,2,705,186,519,nan
Stimme,07B7G,7,Tempelhof-Schöneberg,7G,B,077G,7,81,W,0,0,0,0,702,702,1,701,238,463,nan
Stimme,07B7H,7,Tempelhof-Schöneberg,7H,B,077H,7,81,W,0,0,0,0,0,0,0,0,0,0,07B7G
Stimme,07B7I,7,Tempelhof-Schöneberg,7I,B,077I,7,81,W,0,0,0,0,0,0,0,0,0,0,07B7G
Stimme,07B7K,7,Tempelhof-Schöneberg,7K,B,077K,7,81,W,0,0,0,0,0,0,0,0,0,0,07B7F
Stimme,07B7L,7,Tempelhof-Schöneberg,7L,B,077L,7,81,W,0,0,0,0,0,0,0,0,0,0,07B7V
Stimme,07B7M,7,Tempelhof-Schöneberg,7M,B,077M,7,81,W,0,0,0,0,0,0,0,0,0,0,07B7A
Stimme,07B7N,7,Tempelhof-Schöneberg,7N,B,077N,7,81,W,0,0,0,0,0,0,0,0,0,0,07B7P
Stimme,07B7P,7,Tempelhof-Schöneberg,7P,B,077P,7,81,W,0,0,0,0,643,643,0,643,156,487,nan
Stimme,07B7R,7,Tempelhof-Schöneberg,7R,B,077R,7,81,W,0,0,0,0,738,738,2,736,189,547,nan
Stimme,07B7S,7,Tempelhof-Schöneberg,7S,B,077S,7,81,W,0,0,0,0,0,0,0,0,0,0,07B7R
Stimme,07B7T,7,Tempelhof-Schöneberg,7T,B,077T,7,81,W,0,0,0,0,326,326,1,325,80,245,nan
Stimme,07B7U,7,Tempelhof-Schöneberg,7U,B,077U,7,81,W,0,0,0,0,365,365,2,363,82,281,nan
Stimme,07B7V,7,Tempelhof-Schöneberg,7V,B,077V,7,81,W,0,0,0,0,584,584,0,584,139,445,nan
Stimme,08W101,8,Neukölln,101,W,081A,1,82,W,1001,756,245,0,218,12,0,218,177,41,nan
Stimme,08W102,8,Neukölln,102,W,081AA,1,82,W,1074,797,277,0,235,5,1,234,197,37,nan
Stimme,08W103,8,Neukölln,103,W,081AB,1,82,W,1028,768,260,0,250,13,0,250,226,24,nan
Stimme,08W104,8,Neukölln,104,W,081AC,1,82,W,991,751,240,0,236,8,0,236,204,32,nan
Stimme,08W105,8,Neukölln,105,W,081B,1,82,W,1020,797,223,0,243,6,1,242,195,47,nan
Stimme,08W106,8,Neukölln,106,W,081C,1,82,W,1025,776,249,0,250,5,0,250,211,39,nan
Stimme,08W107,8,Neukölln,107,W,081D,1,82,W,1049,770,279,0,275,0,0,275,234,41,nan
Stimme,08W108,8,Neukölln,108,W,081E,1,82,W,1000,825,175,0,211,6,1,210,188,22,nan
Stimme,08W109,8,Neukölln,109,W,081F,1,82,W,1019,811,208,0,222,12,0,222,194,28,nan
Stimme,08W110,8,Neukölln,110,W,081G,1,82,W,993,757,236,0,197,8,1,196,162,34,nan
Stimme,08W111,8,Neukölln,111,W,081H,1,82,W,962,754,208,0,205,7,0,205,166,39,nan
Stimme,08W112,8,Neukölln,112,W,081I,1,82,W,1135,926,209,0,191,5,0,191,157,34,nan
Stimme,08W113,8,Neukölln,113,W,081J,1,82,W,1051,832,219,0,243,7,1,242,212,30,nan
Stimme,08W114,8,Neukölln,114,W,081K,1,82,W,989,767,222,0,203,3,5,198,173,25,nan
Stimme,08W115,8,Neukölln,115,W,081L,1,82,W,973,778,195,0,230,2,3,227,188,39,nan
Stimme,08W116,8,Neukölln,116,W,081M,1,82,W,1132,864,268,0,223,6,0,223,194,29,nan
Stimme,08W117,8,Neukölln,117,W,081N,1,82,W,1066,808,258,0,257,9,0,257,214,43,nan
Stimme,08W118,8,Neukölln,118,W,081P,1,82,W,984,787,197,0,247,6,0,247,186,61,nan
Stimme,08W119,8,Neukölln,119,W,081Q,1,82,W,1045,757,288,0,229,8,0,229,194,35,nan
Stimme,08W120,8,Neukölln,120,W,081R,1,82,W,1043,793,250,0,231,5,0,231,197,34,nan
Stimme,08W121,8,Neukölln,121,W,081S,1,82,W,1086,863,223,0,192,5,0,192,161,31,nan
Stimme,08W122,8,Neukölln,122,W,081T,1,82,W,878,688,190,0,182,7,0,182,145,37,nan
Stimme,08W123,8,Neukölln,123,W,081U,1,82,W,1051,824,227,0,181,1,2,179,111,68,nan
Stimme,08W124,8,Neukölln,124,W,081T,1,82,W,918,696,222,0,219,9,0,219,192,27,nan
Stimme,08W125,8,Neukölln,125,W,081V,1,82,W,1066,796,270,0,202,7,2,200,160,40,nan
Stimme,08W126,8,Neukölln,126,W,081W,1,82,W,934,709,225,0,207,6,2,205,165,40,nan
Stimme,08W127,8,Neukölln,127,W,081X,1,82,W,1127,905,222,0,174,7,0,174,131,43,nan
Stimme,08W128,8,Neukölln,128,W,081Y,1,82,W,911,775,136,0,147,5,0,147,117,30,nan
Stimme,08W129,8,Neukölln,129,W,081Z,1,82,W,991,750,241,0,233,3,2,231,189,42,nan
Stimme,08W130,8,Neukölln,130,W,081Z,1,82,W,995,823,172,0,203,2,0,203,149,54,nan
Stimme,08W131,8,Neukölln,131,W,081Y,1,82,W,801,689,112,0,98,2,0,98,73,25,nan
Stimme,08W201,8,Neukölln,201,W,082A,2,82,W,1209,945,264,0,261,8,0,261,219,42,nan
Stimme,08W202,8,Neukölln,202,W,082AA,2,82,W,1063,849,214,0,247,6,0,247,219,28,nan
Stimme,08W203,8,Neukölln,203,W,082AB,2,82,W,896,726,170,0,188,4,1,187,143,44,nan
Stimme,08W204,8,Neukölln,204,W,082B,2,82,W,981,743,238,0,243,7,1,242,198,44,nan
Stimme,08W205,8,Neukölln,205,W,082C,2,82,W,1004,798,206,0,212,7,1,211,189,22,nan
Stimme,08W206,8,Neukölln,206,W,082D,2,82,W,1032,824,208,0,186,5,0,186,170,16,nan
Stimme,08W207,8,Neukölln,207,W,082E,2,82,W,965,764,201,0,180,5,2,178,152,26,nan
Stimme,08W208,8,Neukölln,208,W,082F,2,82,W,972,732,240,0,169,5,0,169,156,13,nan
Stimme,08W209,8,Neukölln,209,W,082G,2,82,W,952,750,202,0,183,2,0,183,151,32,nan
Stimme,08W210,8,Neukölln,210,W,082H,2,82,W,1027,837,190,0,175,5,1,174,126,48,nan
Stimme,08W211,8,Neukölln,211,W,082H,2,82,W,1060,841,219,0,201,8,1,200,158,42,nan
Stimme,08W212,8,Neukölln,212,W,082I,2,82,W,1067,832,235,0,214,5,2,212,191,21,nan
Stimme,08W213,8,Neukölln,213,W,082J,2,82,W,1067,821,246,0,223,4,1,222,186,36,nan
Stimme,08W214,8,Neukölln,214,W,082K,2,82,W,1024,770,254,0,226,6,0,226,200,26,nan
Stimme,08W215,8,Neukölln,215,W,082L,2,82,W,1008,777,231,0,246,8,2,244,206,38,nan
Stimme,08W216,8,Neukölln,216,W,082M,2,82,W,1019,798,221,0,280,10,1,279,234,45,nan
Stimme,08W217,8,Neukölln,217,W,082N,2,82,W,1078,851,227,0,237,6,1,236,198,38,nan
Stimme,08W218,8,Neukölln,218,W,082P,2,82,W,1020,805,215,0,219,10,0,219,180,39,nan
Stimme,08W219,8,Neukölln,219,W,082Q,2,82,W,998,805,193,0,235,6,0,235,187,48,nan
Stimme,08W220,8,Neukölln,220,W,082R,2,82,W,1069,849,220,0,209,9,0,209,175,34,nan
Stimme,08W221,8,Neukölln,221,W,082S,2,82,W,1037,814,223,0,209,12,0,209,176,33,nan
Stimme,08W222,8,Neukölln,222,W,082T,2,82,W,1021,799,222,0,158,5,1,157,136,21,nan
Stimme,08W223,8,Neukölln,223,W,082U,2,82,W,1028,946,82,0,119,2,1,118,61,57,nan
Stimme,08W224,8,Neukölln,224,W,082U,2,82,W,1099,942,157,0,164,4,1,163,119,44,nan
Stimme,08W225,8,Neukölln,225,W,082V,2,82,W,992,786,206,0,179,2,0,179,141,38,nan
Stimme,08W226,8,Neukölln,226,W,082W,2,82,W,949,780,169,0,228,1,1,227,198,29,nan
Stimme,08W227,8,Neukölln,227,W,082X,2,82,W,976,763,213,0,248,9,2,246,198,48,nan
Stimme,08W228,8,Neukölln,228,W,082V,2,82,W,883,708,175,0,188,5,1,187,147,40,nan
Stimme,08W229,8,Neukölln,229,W,082Y,2,82,W,1084,865,219,0,164,5,0,164,145,19,nan
Stimme,08W230,8,Neukölln,230,W,082Z,2,82,W,923,707,216,0,179,5,0,179,148,31,nan
Stimme,08W231,8,Neukölln,231,W,082Z,2,82,W,849,712,137,0,204,2,1,203,170,33,nan
Stimme,08W301,8,Neukölln,301,W,083A,3,82,W,887,674,213,0,220,4,2,218,189,29,nan
Stimme,08W302,8,Neukölln,302,W,083B,3,82,W,901,684,217,0,214,7,2,212,170,42,nan
Stimme,08W303,8,Neukölln,303,W,083C,3,82,W,993,775,218,0,199,9,0,199,158,41,nan
Stimme,08W304,8,Neukölln,304,W,083D,3,82,W,975,750,225,0,236,9,1,235,191,44,nan
Stimme,08W305,8,Neukölln,305,W,083E,3,82,W,990,814,176,0,189,7,0,189,161,28,nan
Stimme,08W306,8,Neukölln,306,W,083A,3,82,W,891,703,188,0,219,5,2,217,186,31,nan
Stimme,08W307,8,Neukölln,307,W,083E,3,82,W,956,781,175,0,182,4,0,182,163,19,nan
Stimme,08W308,8,Neukölln,308,W,083F,3,82,W,977,792,185,0,254,5,0,254,216,38,nan
Stimme,08W309,8,Neukölln,309,W,083G,3,82,W,1143,1054,89,0,117,1,0,117,53,64,nan
Stimme,08W310,8,Neukölln,310,W,083G,3,82,W,947,903,44,0,81,0,0,81,29,52,nan
Stimme,08W311,8,Neukölln,311,W,083G,3,82,W,941,761,180,0,227,5,1,226,124,102,nan
Stimme,08W312,8,Neukölln,312,W,083H,3,82,W,1252,1171,81,0,110,0,1,109,51,58,nan
Stimme,08W313,8,Neukölln,313,W,083H,3,82,W,1218,1122,96,0,88,0,1,87,18,69,nan
Stimme,08W314,8,Neukölln,314,W,083H,3,82,W,1206,1139,67,0,74,1,2,72,25,47,nan
Stimme,08W315,8,Neukölln,315,W,083I,3,82,W,1268,1045,223,0,105,2,0,105,74,31,nan
Stimme,08W316,8,Neukölln,316,W,083I,3,82,W,987,844,143,0,139,0,2,137,54,83,nan
Stimme,08W317,8,Neukölln,317,W,083J,3,82,W,898,722,176,0,161,0,0,161,62,99,nan
Stimme,08W318,8,Neukölln,318,W,083J,3,82,W,976,799,177,0,155,2,0,155,90,65,nan
Stimme,08W319,8,Neukölln,319,W,083K,3,82,W,1054,896,158,0,159,1,2,157,61,96,nan
Stimme,08W320,8,Neukölln,320,W,083K,3,82,W,1161,1035,126,0,156,4,0,156,91,65,nan
Stimme,08W321,8,Neukölln,321,W,083L,3,82,W,1257,1104,153,0,108,0,0,108,21,87,nan
Stimme,08W322,8,Neukölln,322,W,083M,3,82,W,1297,1153,144,0,115,1,0,115,39,76,nan
Stimme,08W323,8,Neukölln,323,W,083N,3,82,W,921,711,210,0,107,0,0,107,47,60,nan
Stimme,08W324,8,Neukölln,324,W,083P,3,82,W,1204,973,231,0,146,0,0,146,76,70,nan
Stimme,08W325,8,Neukölln,325,W,083P,3,82,W,970,850,120,0,173,2,1,172,99,73,nan
Stimme,08W326,8,Neukölln,326,W,083Q,3,82,W,1071,886,185,0,162,4,0,162,126,36,nan
Stimme,08W327,8,Neukölln,327,W,083R,3,82,W,1681,1352,329,0,311,13,1,310,251,59,nan
Stimme,08W328,8,Neukölln,328,W,083S,3,82,W,929,762,167,0,158,4,0,158,125,33,nan
Stimme,08W329,8,Neukölln,329,W,083S,3,82,W,813,692,121,0,105,3,1,104,72,32,nan
Stimme,08W330,8,Neukölln,330,W,083Q,3,82,W,1039,842,197,0,184,3,0,184,134,50,nan
Stimme,08W331,8,Neukölln,331,W,083N,3,82,W,968,779,189,0,143,2,0,143,97,46,nan
Stimme,08W401,8,Neukölln,401,W,084A,4,82,W,1062,861,201,0,176,1,2,174,47,127,nan
Stimme,08W402,8,Neukölln,402,W,084B,4,82,W,1048,859,189,0,167,4,0,167,58,109,nan
Stimme,08W403,8,Neukölln,403,W,084B,4,82,W,1123,1001,122,0,164,0,1,163,63,100,nan
Stimme,08W404,8,Neukölln,404,W,084C,4,82,W,1078,827,251,0,161,6,0,161,60,101,nan
Stimme,08W405,8,Neukölln,405,W,084D,4,82,W,1113,935,178,0,130,0,2,128,30,98,nan
Stimme,08W406,8,Neukölln,406,W,084E,4,82,W,1180,930,250,0,176,0,2,174,48,126,nan
Stimme,08W407,8,Neukölln,407,W,084F,4,82,W,1163,921,242,0,145,1,2,143,57,86,nan
Stimme,08W408,8,Neukölln,408,W,084G,4,82,W,877,704,173,0,154,1,2,152,44,108,nan
Stimme,08W409,8,Neukölln,409,W,084G,4,82,W,960,760,200,0,211,2,1,210,40,170,nan
Stimme,08W410,8,Neukölln,410,W,084H,4,82,W,1000,746,254,0,215,3,1,214,38,176,nan
Stimme,08W411,8,Neukölln,411,W,084I,4,82,W,1004,729,275,0,212,7,3,209,33,176,nan
Stimme,08W412,8,Neukölln,412,W,084J,4,82,W,1051,789,262,0,144,1,0,144,47,97,nan
Stimme,08W413,8,Neukölln,413,W,084K,4,82,W,1076,905,171,0,139,1,2,137,55,82,nan
Stimme,08W414,8,Neukölln,414,W,084L,4,82,W,966,796,170,0,121,5,0,121,32,89,nan
Stimme,08W415,8,Neukölln,415,W,084M,4,82,W,1289,1167,122,0,108,1,0,108,27,81,nan
Stimme,08W416,8,Neukölln,416,W,084N,4,82,W,1098,926,172,0,167,4,0,167,46,121,nan
Stimme,08W417,8,Neukölln,417,W,084P,4,82,W,1044,917,127,0,112,0,0,112,16,96,nan
Stimme,08W418,8,Neukölln,418,W,084Q,4,82,W,1063,864,199,0,124,0,2,122,35,87,nan
Stimme,08W419,8,Neukölln,419,W,084R,4,82,W,1172,1006,166,0,158,1,2,156,30,126,nan
Stimme,08W420,8,Neukölln,420,W,084S,4,82,W,1041,886,155,0,125,1,1,124,26,98,nan
Stimme,08W421,8,Neukölln,421,W,084T,4,82,W,1072,1004,68,0,77,1,1,76,23,53,nan
Stimme,08W422,8,Neukölln,422,W,084U,4,82,W,1052,959,93,0,111,0,0,111,32,79,nan
Stimme,08W423,8,Neukölln,423,W,084T,4,82,W,899,786,113,0,116,0,0,116,38,78,nan
Stimme,08W424,8,Neukölln,424,W,084V,4,82,W,964,843,121,0,109,0,1,108,31,77,nan
Stimme,08W425,8,Neukölln,425,W,084V,4,82,W,1084,956,128,0,86,2,0,86,31,55,nan
Stimme,08W426,8,Neukölln,426,W,084W,4,82,W,865,748,117,0,108,2,0,108,28,80,nan
Stimme,08W427,8,Neukölln,427,W,084X,4,82,W,1018,893,125,0,115,1,0,115,38,77,nan
Stimme,08W428,8,Neukölln,428,W,084Y,4,82,W,1066,908,158,0,150,0,3,147,35,112,nan
Stimme,08W429,8,Neukölln,429,W,084Z,4,82,W,859,762,97,0,143,0,0,143,28,115,nan
Stimme,08W430,8,Neukölln,430,W,084Z,4,82,W,907,779,128,0,137,2,3,134,21,113,nan
Stimme,08W431,8,Neukölln,431,W,084W,4,82,W,1195,1085,110,0,89,0,0,89,31,58,nan
Stimme,08W501,8,Neukölln,501,W,085A,5,82,W,1060,901,159,0,135,3,0,135,56,79,nan
Stimme,08W502,8,Neukölln,502,W,085AA,5,82,W,1020,824,196,0,227,3,2,225,120,105,nan
Stimme,08W503,8,Neukölln,503,W,085AB,5,82,W,839,639,200,0,189,3,0,189,103,86,nan
Stimme,08W504,8,Neukölln,504,W,085AC,5,82,W,927,705,222,0,209,2,0,209,115,94,nan
Stimme,08W505,8,Neukölln,505,W,085B,5,82,W,991,817,174,0,203,1,2,201,89,112,nan
Stimme,08W506,8,Neukölln,506,W,085C,5,82,W,934,747,187,0,206,1,1,205,109,96,nan
Stimme,08W507,8,Neukölln,507,W,085D,5,82,W,1028,854,174,0,131,1,0,131,37,94,nan
Stimme,08W508,8,Neukölln,508,W,085E,5,82,W,1211,1042,169,0,139,0,0,139,97,42,nan
Stimme,08W509,8,Neukölln,509,W,085F,5,82,W,1188,833,355,0,211,9,2,209,78,131,nan
Stimme,08W510,8,Neukölln,510,W,085G,5,82,W,1000,728,272,0,171,4,1,170,55,115,nan
Stimme,08W511,8,Neukölln,511,W,085H,5,82,W,950,756,194,0,93,3,0,93,25,68,nan
Stimme,08W512,8,Neukölln,512,W,085D,5,82,W,1037,877,160,0,235,2,0,235,59,176,nan
Stimme,08W513,8,Neukölln,513,W,085I,5,82,W,1002,777,225,0,203,0,0,203,41,162,nan
Stimme,08W514,8,Neukölln,514,W,085J,5,82,W,875,643,232,0,150,1,1,149,28,121,nan
Stimme,08W515,8,Neukölln,515,W,085K,5,82,W,925,698,227,0,188,3,0,188,65,123,nan
Stimme,08W516,8,Neukölln,516,W,085L,5,82,W,1004,903,101,0,157,4,0,157,36,121,nan
Stimme,08W517,8,Neukölln,517,W,085L,5,82,W,826,665,161,0,141,0,0,141,19,122,nan
Stimme,08W518,8,Neukölln,518,W,085M,5,82,W,890,701,189,0,210,1,0,210,54,156,nan
Stimme,08W519,8,Neukölln,519,W,085N,5,82,W,992,766,226,0,181,2,1,180,42,138,nan
Stimme,08W520,8,Neukölln,520,W,085P,5,82,W,925,698,227,0,175,2,0,175,46,129,nan
Stimme,08W521,8,Neukölln,521,W,085Q,5,82,W,928,679,249,0,230,1,2,228,38,190,nan
Stimme,08W522,8,Neukölln,522,W,085R,5,82,W,862,671,191,0,210,0,1,209,54,155,nan
Stimme,08W523,8,Neukölln,523,W,085S,5,82,W,956,778,178,0,193,0,1,192,47,145,nan
Stimme,08W524,8,Neukölln,524,W,085T,5,82,W,896,791,105,0,124,1,0,124,28,96,nan
Stimme,08W525,8,Neukölln,525,W,085T,5,82,W,891,742,149,0,148,0,3,145,28,117,nan
Stimme,08W526,8,Neukölln,526,W,085U,5,82,W,943,759,184,0,226,0,0,226,45,181,nan
Stimme,08W527,8,Neukölln,527,W,085R,5,82,W,1023,857,166,0,116,0,0,116,28,88,nan
Stimme,08W528,8,Neukölln,528,W,085V,5,82,W,889,690,199,0,112,2,2,110,24,86,nan
Stimme,08W529,8,Neukölln,529,W,085W,5,82,W,967,811,156,0,158,0,0,158,40,118,nan
Stimme,08W530,8,Neukölln,530,W,085W,5,82,W,854,689,165,0,135,2,0,135,27,108,nan
Stimme,08W531,8,Neukölln,531,W,085X,5,82,W,1025,912,113,0,99,0,0,99,26,73,nan
Stimme,08W532,8,Neukölln,532,W,085Y,5,82,W,914,763,151,0,125,1,0,125,26,99,nan
Stimme,08W533,8,Neukölln,533,W,085Z,5,82,W,835,729,106,0,123,0,0,123,27,96,nan
Stimme,08W534,8,Neukölln,534,W,085X,5,82,W,1033,838,195,0,143,0,0,143,37,106,nan
Stimme,08W601,8,Neukölln,601,W,086A,6,82,W,896,669,227,0,201,3,4,197,48,149,nan
Stimme,08W602,8,Neukölln,602,W,086AA,6,82,W,873,672,201,0,209,1,0,209,48,161,nan
Stimme,08W603,8,Neukölln,603,W,086B,6,82,W,911,704,207,0,181,1,0,181,42,139,nan
Stimme,08W604,8,Neukölln,604,W,086C,6,82,W,888,710,178,0,202,0,1,201,44,157,nan
Stimme,08W605,8,Neukölln,605,W,086D,6,82,W,845,637,208,0,178,0,0,178,35,143,nan
Stimme,08W606,8,Neukölln,606,W,086E,6,82,W,899,715,184,0,172,0,1,171,41,130,nan
Stimme,08W607,8,Neukölln,607,W,086F,6,82,W,879,699,180,0,162,4,0,162,28,134,nan
Stimme,08W608,8,Neukölln,608,W,086G,6,82,W,914,731,183,0,210,2,1,209,46,163,nan
Stimme,08W609,8,Neukölln,609,W,086H,6,82,W,975,864,111,0,130,3,1,129,45,84,nan
Stimme,08W610,8,Neukölln,610,W,086I,6,82,W,882,714,168,0,209,1,0,209,49,160,nan
Stimme,08W611,8,Neukölln,611,W,086D,6,82,W,819,654,165,0,143,1,0,143,41,102,nan
Stimme,08W612,8,Neukölln,612,W,086J,6,82,W,920,737,183,0,165,0,2,163,35,128,nan
Stimme,08W613,8,Neukölln,613,W,086J,6,82,W,878,741,137,0,146,0,0,146,32,114,nan
Stimme,08W614,8,Neukölln,614,W,086K,6,82,W,856,635,221,0,156,0,1,155,32,123,nan
Stimme,08W615,8,Neukölln,615,W,086L,6,82,W,870,743,127,0,165,3,1,164,35,129,nan
Stimme,08W616,8,Neukölln,616,W,086K,6,82,W,817,730,87,0,122,7,0,122,31,91,nan
Stimme,08W617,8,Neukölln,617,W,086L,6,82,W,846,733,113,0,193,4,0,193,36,157,nan
Stimme,08W618,8,Neukölln,618,W,086M,6,82,W,895,725,170,0,216,3,3,213,48,165,nan
Stimme,08W619,8,Neukölln,619,W,086M,6,82,W,848,617,231,0,199,8,0,199,39,160,nan
Stimme,08W620,8,Neukölln,620,W,086N,6,82,W,792,662,130,0,195,0,3,192,29,163,nan
Stimme,08W621,8,Neukölln,621,W,086N,6,82,W,892,762,130,0,153,3,1,152,116,36,nan
Stimme,08W622,8,Neukölln,622,W,086P,6,82,W,890,688,202,0,158,0,0,158,33,125,nan
Stimme,08W623,8,Neukölln,623,W,086P,6,82,W,946,862,84,0,143,3,0,143,46,97,nan
Stimme,08W624,8,Neukölln,624,W,086E,6,82,W,833,679,154,0,179,3,0,179,56,123,nan
Stimme,08W625,8,Neukölln,625,W,086Q,6,82,W,988,832,156,0,164,3,0,164,41,123,nan
Stimme,08W626,8,Neukölln,626,W,086R,6,82,W,880,620,260,0,170,0,0,170,34,136,nan
Stimme,08W627,8,Neukölln,627,W,086S,6,82,W,856,649,207,0,151,2,0,151,32,119,nan
Stimme,08W628,8,Neukölln,628,W,086T,6,82,W,825,648,177,0,213,0,0,213,56,157,nan
Stimme,08W629,8,Neukölln,629,W,086U,6,82,W,827,638,189,0,210,2,0,210,41,169,nan
Stimme,08W630,8,Neukölln,630,W,086V,6,82,W,805,607,198,0,202,3,2,200,43,157,nan
Stimme,08W631,8,Neukölln,631,W,086W,6,82,W,897,653,244,0,197,0,2,195,53,142,nan
Stimme,08W632,8,Neukölln,632,W,086X,6,82,W,1113,830,283,0,234,3,0,234,52,182,nan
Stimme,08W633,8,Neukölln,633,W,086Y,6,82,W,1271,1098,173,0,167,1,0,167,56,111,nan
Stimme,08W634,8,Neukölln,634,W,086Y,6,82,W,1034,932,102,0,100,0,0,100,30,70,nan
Stimme,08W635,8,Neukölln,635,W,086Z,6,82,W,984,896,88,0,101,0,0,101,17,84,nan
Stimme,08W636,8,Neukölln,636,W,086Z,6,82,W,917,833,84,0,80,0,1,79,17,62,nan
Stimme,08B1A,8,Neukölln,1A,B,081A,1,82,W,0,0,0,0,582,582,1,581,480,101,nan
Stimme,08B1AA,8,Neukölln,1AA,B,081AA,1,82,W,0,0,0,0,0,0,0,0,0,0,08B1H
Stimme,08B1AB,8,Neukölln,1AB,B,081AB,1,82,W,0,0,0,0,0,0,0,0,0,0,08B1Z
Stimme,08B1AC,8,Neukölln,1AC,B,081AC,1,82,W,0,0,0,0,0,0,0,0,0,0,08B1E
Stimme,08B1B,8,Neukölln,1B,B,081B,1,82,W,0,0,0,0,584,584,0,584,518,66,nan
Stimme,08B1C,8,Neukölln,1C,B,081C,1,82,W,0,0,0,0,610,610,2,608,476,132,nan
Stimme,08B1D,8,Neukölln,1D,B,081D,1,82,W,0,0,0,0,631,631,1,630,528,102,nan
Stimme,08B1E,8,Neukölln,1E,B,081E,1,82,W,0,0,0,0,533,533,9,524,454,70,nan
Stimme,08B1F,8,Neukölln,1F,B,081F,1,82,W,0,0,0,0,0,0,0,0,0,0,08B1E
Stimme,08B1G,8,Neukölln,1G,B,081G,1,82,W,0,0,0,0,623,623,2,621,525,96,nan
Stimme,08B1H,8,Neukölln,1H,B,081H,1,82,W,0,0,0,0,601,601,0,601,452,149,nan
Stimme,08B1I,8,Neukölln,1I,B,081I,1,82,W,0,0,0,0,0,0,0,0,0,0,08B1A
Stimme,08B1J,8,Neukölln,1J,B,081J,1,82,W,0,0,0,0,0,0,0,0,0,0,08B1G
Stimme,08B1K,8,Neukölln,1K,B,081K,1,82,W,0,0,0,0,0,0,0,0,0,0,08B1B
Stimme,08B1L,8,Neukölln,1L,B,081L,1,82,W,0,0,0,0,0,0,0,0,0,0,08B1C
Stimme,08B1M,8,Neukölln,1M,B,081M,1,82,W,0,0,0,0,0,0,0,0,0,0,08B1B
Stimme,08B1N,8,Neukölln,1N,B,081N,1,82,W,0,0,0,0,0,0,0,0,0,0,08B1D
Stimme,08B1P,8,Neukölln,1P,B,081P,1,82,W,0,0,0,0,0,0,0,0,0,0,08B1D
Stimme,08B1Q,8,Neukölln,1Q,B,081Q,1,82,W,0,0,0,0,0,0,0,0,0,0,08B1G
Stimme,08B1R,8,Neukölln,1R,B,081R,1,82,W,0,0,0,0,0,0,0,0,0,0,08B1A
Stimme,08B1S,8,Neukölln,1S,B,081S,1,82,W,0,0,0,0,0,0,0,0,0,0,08B1X
Stimme,08B1T,8,Neukölln,1T,B,081T,1,82,W,0,0,0,0,527,527,3,524,429,95,nan
Stimme,08B1U,8,Neukölln,1U,B,081U,1,82,W,0,0,0,0,0,0,0,0,0,0,08B1H
Stimme,08B1V,8,Neukölln,1V,B,081V,1,82,W,0,0,0,0,0,0,0,0,0,0,08B1C
Stimme,08B1W,8,Neukölln,1W,B,081W,1,82,W,0,0,0,0,0,0,0,0,0,0,08B1T
Stimme,08B1X,8,Neukölln,1X,B,081X,1,82,W,0,0,0,0,573,573,1,572,452,120,nan
Stimme,08B1Y,8,Neukölln,1Y,B,081Y,1,82,W,0,0,0,0,0,0,0,0,0,0,08B1X
Stimme,08B1Z,8,Neukölln,1Z,B,081Z,1,82,W,0,0,0,0,576,576,0,576,491,85,nan
Stimme,08B2A,8,Neukölln,2A,B,082A,2,82,W,0,0,0,0,556,556,0,556,462,94,nan
Stimme,08B2AA,8,Neukölln,2AA,B,082AA,2,82,W,0,0,0,0,0,0,0,0,0,0,08B2K
Stimme,08B2AB,8,Neukölln,2AB,B,082AB,2,82,W,0,0,0,0,0,0,0,0,0,0,08B2F
Stimme,08B2B,8,Neukölln,2B,B,082B,2,82,W,0,0,0,0,498,498,8,490,427,63,nan
Stimme,08B2C,8,Neukölln,2C,B,082C,2,82,W,0,0,0,0,0,0,0,0,0,0,08B2S
Stimme,08B2D,8,Neukölln,2D,B,082D,2,82,W,0,0,0,0,576,576,10,566,492,74,nan
Stimme,08B2E,8,Neukölln,2E,B,082E,2,82,W,0,0,0,0,500,500,0,500,430,70,nan
Stimme,08B2F,8,Neukölln,2F,B,082F,2,82,W,0,0,0,0,506,506,1,505,420,85,nan
Stimme,08B2G,8,Neukölln,2G,B,082G,2,82,W,0,0,0,0,0,0,0,0,0,0,08B2X
Stimme,08B2H,8,Neukölln,2H,B,082H,2,82,W,0,0,0,0,0,0,0,0,0,0,08B2A
Stimme,08B2I,8,Neukölln,2I,B,082I,2,82,W,0,0,0,0,0,0,0,0,0,0,08B2K
Stimme,08B2J,8,Neukölln,2J,B,082J,2,82,W,0,0,0,0,593,593,1,592,506,86,nan
Stimme,08B2K,8,Neukölln,2K,B,082K,2,82,W,0,0,0,0,604,604,2,602,514,88,nan
Stimme,08B2L,8,Neukölln,2L,B,082L,2,82,W,0,0,0,0,0,0,0,0,0,0,08B2D
Stimme,08B2M,8,Neukölln,2M,B,082M,2,82,W,0,0,0,0,0,0,0,0,0,0,08B2D
Stimme,08B2N,8,Neukölln,2N,B,082N,2,82,W,0,0,0,0,0,0,0,0,0,0,08B2J
Stimme,08B2P,8,Neukölln,2P,B,082P,2,82,W,0,0,0,0,0,0,0,0,0,0,08B2S
Stimme,08B2Q,8,Neukölln,2Q,B,082Q,2,82,W,0,0,0,0,0,0,0,0,0,0,08B2F
Stimme,08B2R,8,Neukölln,2R,B,082R,2,82,W,0,0,0,0,0,0,0,0,0,0,08B2J
Stimme,08B2S,8,Neukölln,2S,B,082S,2,82,W,0,0,0,0,533,533,2,531,451,80,nan
Stimme,08B2T,8,Neukölln,2T,B,082T,2,82,W,0,0,0,0,0,0,0,0,0,0,08B2U
Stimme,08B2U,8,Neukölln,2U,B,082U,2,82,W,0,0,0,0,571,571,1,570,457,113,nan
Stimme,08B2V,8,Neukölln,2V,B,082V,2,82,W,0,0,0,0,0,0,0,0,0,0,08B2E
Stimme,08B2W,8,Neukölln,2W,B,082W,2,82,W,0,0,0,0,0,0,0,0,0,0,08B2X
Stimme,08B2X,8,Neukölln,2X,B,082X,2,82,W,0,0,0,0,505,505,0,505,433,72,nan
Stimme,08B2Y,8,Neukölln,2Y,B,082Y,2,82,W,0,0,0,0,0,0,0,0,0,0,08B2U
Stimme,08B2Z,8,Neukölln,2Z,B,082Z,2,82,W,0,0,0,0,0,0,0,0,0,0,08B2B
Stimme,08B3A,8,Neukölln,3A,B,083A,3,82,W,0,0,0,0,528,528,1,527,438,89,nan
Stimme,08B3B,8,Neukölln,3B,B,083B,3,82,W,0,0,0,0,0,0,0,0,0,0,08B3E
Stimme,08B3C,8,Neukölln,3C,B,083C,3,82,W,0,0,0,0,0,0,0,0,0,0,08B3A
Stimme,08B3D,8,Neukölln,3D,B,083D,3,82,W,0,0,0,0,0,0,0,0,0,0,08B3G
Stimme,08B3E,8,Neukölln,3E,B,083E,3,82,W,0,0,0,0,465,465,2,463,385,78,nan
Stimme,08B3F,8,Neukölln,3F,B,083F,3,82,W,0,0,0,0,0,0,0,0,0,0,08B3P
Stimme,08B3G,8,Neukölln,3G,B,083G,3,82,W,0,0,0,0,448,448,0,448,280,168,nan
Stimme,08B3H,8,Neukölln,3H,B,083H,3,82,W,0,0,0,0,0,0,0,0,0,0,08B3I
Stimme,08B3I,8,Neukölln,3I,B,083I,3,82,W,0,0,0,0,502,502,1,501,255,246,nan
Stimme,08B3J,8,Neukölln,3J,B,083J,3,82,W,0,0,0,0,541,541,0,541,265,276,nan
Stimme,08B3K,8,Neukölln,3K,B,083K,3,82,W,0,0,0,0,0,0,0,0,0,0,08B3J
Stimme,08B3L,8,Neukölln,3L,B,083L,3,82,W,0,0,0,0,0,0,0,0,0,0,08B3N
Stimme,08B3M,8,Neukölln,3M,B,083M,3,82,W,0,0,0,0,0,0,0,0,0,0,08B3Q
Stimme,08B3N,8,Neukölln,3N,B,083N,3,82,W,0,0,0,0,470,470,1,469,209,260,nan
Stimme,08B3P,8,Neukölln,3P,B,083P,3,82,W,0,0,0,0,471,471,2,469,352,117,nan
Stimme,08B3Q,8,Neukölln,3Q,B,083Q,3,82,W,0,0,0,0,438,438,0,438,302,136,nan
Stimme,08B3R,8,Neukölln,3R,B,083R,3,82,W,0,0,0,0,515,515,0,515,413,102,nan
Stimme,08B3S,8,Neukölln,3S,B,083S,3,82,W,0,0,0,0,0,0,0,0,0,0,08B3R
Stimme,08B4A,8,Neukölln,4A,B,084A,4,82,W,0,0,0,0,365,365,1,364,114,250,nan
Stimme,08B4B,8,Neukölln,4B,B,084B,4,82,W,0,0,0,0,375,375,0,375,134,241,nan
Stimme,08B4C,8,Neukölln,4C,B,084C,4,82,W,0,0,0,0,523,523,0,523,147,376,nan
Stimme,08B4D,8,Neukölln,4D,B,084D,4,82,W,0,0,0,0,0,0,0,0,0,0,08B4H
Stimme,08B4E,8,Neukölln,4E,B,084E,4,82,W,0,0,0,0,360,360,0,360,112,248,nan
Stimme,08B4F,8,Neukölln,4F,B,084F,4,82,W,0,0,0,0,421,421,0,421,106,315,nan
Stimme,08B4G,8,Neukölln,4G,B,084G,4,82,W,0,0,0,0,513,513,0,513,132,381,nan
Stimme,08B4H,8,Neukölln,4H,B,084H,4,82,W,0,0,0,0,468,468,4,464,123,341,nan
Stimme,08B4I,8,Neukölln,4I,B,084I,4,82,W,0,0,0,0,498,498,1,497,110,387,nan
Stimme,08B4J,8,Neukölln,4J,B,084J,4,82,W,0,0,0,0,499,499,0,499,135,364,nan
Stimme,08B4K,8,Neukölln,4K,B,084K,4,82,W,0,0,0,0,0,0,0,0,0,0,08B4V
Stimme,08B4L,8,Neukölln,4L,B,084L,4,82,W,0,0,0,0,0,0,0,0,0,0,08B4F
Stimme,08B4M,8,Neukölln,4M,B,084M,4,82,W,0,0,0,0,0,0,0,0,0,0,08B4H
Stimme,08B4N,8,Neukölln,4N,B,084N,4,82,W,0,0,0,0,0,0,0,0,0,0,08B4I
Stimme,08B4P,8,Neukölln,4P,B,084P,4,82,W,0,0,0,0,0,0,0,0,0,0,08B4B
Stimme,08B4Q,8,Neukölln,4Q,B,084Q,4,82,W,0,0,0,0,0,0,0,0,0,0,08B4C
Stimme,08B4R,8,Neukölln,4R,B,084R,4,82,W,0,0,0,0,0,0,0,0,0,0,08B4J
Stimme,08B4S,8,Neukölln,4S,B,084S,4,82,W,0,0,0,0,0,0,0,0,0,0,08B4J
Stimme,08B4T,8,Neukölln,4T,B,084T,4,82,W,0,0,0,0,0,0,0,0,0,0,08B4E
Stimme,08B4U,8,Neukölln,4U,B,084U,4,82,W,0,0,0,0,0,0,0,0,0,0,08B4F
Stimme,08B4V,8,Neukölln,4V,B,084V,4,82,W,0,0,0,0,336,336,0,336,92,244,nan
Stimme,08B4W,8,Neukölln,4W,B,084W,4,82,W,0,0,0,0,0,0,0,0,0,0,08B4G
Stimme,08B4X,8,Neukölln,4X,B,084X,4,82,W,0,0,0,0,0,0,0,0,0,0,08B4I
Stimme,08B4Y,8,Neukölln,4Y,B,084Y,4,82,W,0,0,0,0,0,0,0,0,0,0,08B4C
Stimme,08B4Z,8,Neukölln,4Z,B,084Z,4,82,W,0,0,0,0,0,0,0,0,0,0,08B4A
Stimme,08B5A,8,Neukölln,5A,B,085A,5,82,W,0,0,0,0,479,479,2,477,197,280,nan
Stimme,08B5AA,8,Neukölln,5AA,B,085AA,5,82,W,0,0,0,0,0,0,0,0,0,0,08B5E
Stimme,08B5AB,8,Neukölln,5AB,B,085AB,5,82,W,0,0,0,0,0,0,0,0,0,0,08B5A
Stimme,08B5AC,8,Neukölln,5AC,B,085AC,5,82,W,0,0,0,0,0,0,0,0,0,0,08B5Z
Stimme,08B5B,8,Neukölln,5B,B,085B,5,82,W,0,0,0,0,0,0,0,0,0,0,08B5U
Stimme,08B5C,8,Neukölln,5C,B,085C,5,82,W,0,0,0,0,495,495,17,478,160,318,nan
Stimme,08B5D,8,Neukölln,5D,B,085D,5,82,W,0,0,0,0,0,0,0,0,0,0,08B5K
Stimme,08B5E,8,Neukölln,5E,B,085E,5,82,W,0,0,0,0,483,483,3,480,165,315,nan
Stimme,08B5F,8,Neukölln,5F,B,085F,5,82,W,0,0,0,0,0,0,0,0,0,0,08B5Q
Stimme,08B5G,8,Neukölln,5G,B,085G,5,82,W,0,0,0,0,0,0,0,0,0,0,08B5I
Stimme,08B5H,8,Neukölln,5H,B,085H,5,82,W,0,0,0,0,0,0,0,0,0,0,08B5Z
Stimme,08B5I,8,Neukölln,5I,B,085I,5,82,W,0,0,0,0,557,557,3,554,120,434,nan
Stimme,08B5J,8,Neukölln,5J,B,085J,5,82,W,0,0,0,0,471,471,1,470,111,359,nan
Stimme,08B5K,8,Neukölln,5K,B,085K,5,82,W,0,0,0,0,485,485,0,485,146,339,nan
Stimme,08B5L,8,Neukölln,5L,B,085L,5,82,W,0,0,0,0,0,0,0,0,0,0,08B5T
Stimme,08B5M,8,Neukölln,5M,B,085M,5,82,W,0,0,0,0,0,0,0,0,0,0,08B5A
Stimme,08B5N,8,Neukölln,5N,B,085N,5,82,W,0,0,0,0,491,491,0,491,122,369,nan
Stimme,08B5P,8,Neukölln,5P,B,085P,5,82,W,0,0,0,0,0,0,0,0,0,0,08B5S
Stimme,08B5Q,8,Neukölln,5Q,B,085Q,5,82,W,0,0,0,0,524,524,0,524,151,373,nan
Stimme,08B5R,8,Neukölln,5R,B,085R,5,82,W,0,0,0,0,0,0,0,0,0,0,08B5C
Stimme,08B5S,8,Neukölln,5S,B,085S,5,82,W,0,0,0,0,355,355,0,355,86,269,nan
Stimme,08B5T,8,Neukölln,5T,B,085T,5,82,W,0,0,0,0,443,443,0,443,139,304,nan
Stimme,08B5U,8,Neukölln,5U,B,085U,5,82,W,0,0,0,0,304,304,1,303,99,204,nan
Stimme,08B5V,8,Neukölln,5V,B,085V,5,82,W,0,0,0,0,0,0,0,0,0,0,08B5E
Stimme,08B5W,8,Neukölln,5W,B,085W,5,82,W,0,0,0,0,0,0,0,0,0,0,08B5N
Stimme,08B5X,8,Neukölln,5X,B,085X,5,82,W,0,0,0,0,0,0,0,0,0,0,08B5J
Stimme,08B5Y,8,Neukölln,5Y,B,085Y,5,82,W,0,0,0,0,0,0,0,0,0,0,08B5I
Stimme,08B5Z,8,Neukölln,5Z,B,085Z,5,82,W,0,0,0,0,444,444,3,441,147,294,nan
Stimme,08B6A,8,Neukölln,6A,B,086A,6,82,W,0,0,0,0,452,452,4,448,120,328,nan
Stimme,08B6AA,8,Neukölln,6AA,B,086AA,6,82,W,0,0,0,0,0,0,0,0,0,0,08B6N
Stimme,08B6B,8,Neukölln,6B,B,086B,6,82,W,0,0,0,0,451,451,2,449,99,350,nan
Stimme,08B6C,8,Neukölln,6C,B,086C,6,82,W,0,0,0,0,0,0,0,0,0,0,08B6M
Stimme,08B6D,8,Neukölln,6D,B,086D,6,82,W,0,0,0,0,512,512,12,500,115,385,nan
Stimme,08B6E,8,Neukölln,6E,B,086E,6,82,W,0,0,0,0,479,479,0,479,96,383,nan
Stimme,08B6F,8,Neukölln,6F,B,086F,6,82,W,0,0,0,0,0,0,0,0,0,0,08B6P
Stimme,08B6G,8,Neukölln,6G,B,086G,6,82,W,0,0,0,0,430,430,1,429,103,326,nan
Stimme,08B6H,8,Neukölln,6H,B,086H,6,82,W,0,0,0,0,0,0,0,0,0,0,08B6G
Stimme,08B6I,8,Neukölln,6I,B,086I,6,82,W,0,0,0,0,0,0,0,0,0,0,08B6T
Stimme,08B6J,8,Neukölln,6J,B,086J,6,82,W,0,0,0,0,502,502,1,501,126,375,nan
Stimme,08B6K,8,Neukölln,6K,B,086K,6,82,W,0,0,0,0,0,0,0,0,0,0,08B6B
Stimme,08B6L,8,Neukölln,6L,B,086L,6,82,W,0,0,0,0,0,0,0,0,0,0,08B6X
Stimme,08B6M,8,Neukölln,6M,B,086M,6,82,W,0,0,0,0,502,502,1,501,90,411,nan
Stimme,08B6N,8,Neukölln,6N,B,086N,6,82,W,0,0,0,0,380,380,0,380,87,293,nan
Stimme,08B6P,8,Neukölln,6P,B,086P,6,82,W,0,0,0,0,416,416,0,416,117,299,nan
Stimme,08B6Q,8,Neukölln,6Q,B,086Q,6,82,W,0,0,0,0,0,0,0,0,0,0,08B6T
Stimme,08B6R,8,Neukölln,6R,B,086R,6,82,W,0,0,0,0,0,0,0,0,0,0,08B6Z
Stimme,08B6S,8,Neukölln,6S,B,086S,6,82,W,0,0,0,0,0,0,0,0,0,0,08B6E
Stimme,08B6T,8,Neukölln,6T,B,086T,6,82,W,0,0,0,0,426,426,0,426,95,331,nan
Stimme,08B6U,8,Neukölln,6U,B,086U,6,82,W,0,0,0,0,0,0,0,0,0,0,08B6D
Stimme,08B6V,8,Neukölln,6V,B,086V,6,82,W,0,0,0,0,0,0,0,0,0,0,08B6G
Stimme,08B6W,8,Neukölln,6W,B,086W,6,82,W,0,0,0,0,0,0,0,0,0,0,08B6J
Stimme,08B6X,8,Neukölln,6X,B,086X,6,82,W,0,0,0,0,436,436,2,434,137,297,nan
Stimme,08B6Y,8,Neukölln,6Y,B,086Y,6,82,W,0,0,0,0,0,0,0,0,0,0,08B6A
Stimme,08B6Z,8,Neukölln,6Z,B,086Z,6,82,W,0,0,0,0,371,371,1,370,80,290,nan
Stimme,09W101,9,Treptow-Köpenick,101,W,091A,1,84,O,644,468,176,0,211,9,1,210,178,32,nan
Stimme,09W102,9,Treptow-Köpenick,102,W,091B,1,84,O,801,647,154,0,183,7,0,183,122,61,nan
Stimme,09W103,9,Treptow-Köpenick,103,W,091A,1,84,O,842,647,195,0,187,5,1,186,138,48,nan
Stimme,09W104,9,Treptow-Köpenick,104,W,091A,1,84,O,739,507,232,0,170,11,0,170,134,36,nan
Stimme,09W105,9,Treptow-Köpenick,105,W,091B,1,84,O,617,460,157,0,152,6,0,152,109,43,nan
Stimme,09W106,9,Treptow-Köpenick,106,W,091C,1,84,O,784,570,214,0,190,3,0,190,159,31,nan
Stimme,09W107,9,Treptow-Köpenick,107,W,091D,1,84,O,699,549,150,0,161,3,0,161,123,38,nan
Stimme,09W108,9,Treptow-Köpenick,108,W,091D,1,84,O,821,628,193,0,193,3,2,191,152,39,nan
Stimme,09W109,9,Treptow-Köpenick,109,W,091E,1,84,O,782,600,182,0,212,3,1,211,164,47,nan
Stimme,09W110,9,Treptow-Köpenick,110,W,091C,1,84,O,835,621,214,0,164,11,1,163,111,52,nan
Stimme,09W111,9,Treptow-Köpenick,111,W,091E,1,84,O,603,475,128,0,139,3,0,139,123,16,nan
Stimme,09W112,9,Treptow-Köpenick,112,W,091F,1,84,O,834,578,256,0,176,4,0,176,140,36,nan
Stimme,09W113,9,Treptow-Köpenick,113,W,091F,1,84,O,930,699,231,0,238,3,0,238,182,56,nan
Stimme,09W114,9,Treptow-Köpenick,114,W,091G,1,84,O,748,606,142,0,166,4,3,163,113,50,nan
Stimme,09W115,9,Treptow-Köpenick,115,W,091G,1,84,O,534,458,76,0,62,9,1,61,21,40,nan
Stimme,09W116,9,Treptow-Köpenick,116,W,091H,1,84,O,777,658,119,0,102,0,0,102,48,54,nan
Stimme,09W117,9,Treptow-Köpenick,117,W,091H,1,84,O,725,607,118,0,96,1,0,96,49,47,nan
Stimme,09W118,9,Treptow-Köpenick,118,W,091L,1,84,O,930,815,115,0,148,0,2,146,84,62,nan
Stimme,09W119,9,Treptow-Köpenick,119,W,091I,1,84,O,904,767,137,0,202,1,0,202,106,96,nan
Stimme,09W120,9,Treptow-Köpenick,120,W,091I,1,84,O,718,596,122,0,140,2,0,140,84,56,nan
Stimme,09W121,9,Treptow-Köpenick,121,W,091S,1,84,O,876,682,194,0,178,1,0,178,136,42,nan
Stimme,09W122,9,Treptow-Köpenick,122,W,091S,1,84,O,792,595,197,0,149,2,0,149,105,44,nan
Stimme,09W123,9,Treptow-Köpenick,123,W,091J,1,84,O,926,800,126,0,140,0,0,140,70,70,nan
Stimme,09W124,9,Treptow-Köpenick,124,W,091J,1,84,O,875,751,124,0,103,2,0,103,46,57,nan
Stimme,09W125,9,Treptow-Köpenick,125,W,091K,1,84,O,929,797,132,0,167,0,1,166,72,94,nan
Stimme,09W126,9,Treptow-Köpenick,126,W,091M,1,84,O,876,723,153,0,203,4,0,203,134,69,nan
Stimme,09W127,9,Treptow-Köpenick,127,W,091N,1,84,O,978,790,188,0,180,5,0,180,100,80,nan
Stimme,09W128,9,Treptow-Köpenick,128,W,091K,1,84,O,932,809,123,0,179,0,0,179,73,106,nan
Stimme,09W129,9,Treptow-Köpenick,129,W,091Q,1,84,O,858,689,169,0,187,2,0,187,112,75,nan
Stimme,09W130,9,Treptow-Köpenick,130,W,091N,1,84,O,931,781,150,0,242,1,0,242,134,108,nan
Stimme,09W131,9,Treptow-Köpenick,131,W,091Q,1,84,O,1015,827,188,0,163,4,0,163,100,63,nan
Stimme,09W132,9,Treptow-Köpenick,132,W,091R,1,84,O,859,644,215,0,170,1,0,170,65,105,nan
Stimme,09W133,9,Treptow-Köpenick,133,W,091R,1,84,O,981,712,269,0,156,3,0,156,50,106,nan
Stimme,09W134,9,Treptow-Köpenick,134,W,091M,1,84,O,766,604,162,0,172,4,1,171,115,56,nan
Stimme,09W135,9,Treptow-Köpenick,135,W,091P,1,84,O,758,647,111,0,121,0,0,121,59,62,nan
Stimme,09W136,9,Treptow-Köpenick,136,W,091P,1,84,O,808,690,118,0,159,0,0,159,90,69,nan
Stimme,09W137,9,Treptow-Köpenick,137,W,091L,1,84,O,774,664,110,0,135,0,0,135,62,73,nan
Stimme,09W138,9,Treptow-Köpenick,138,W,091T,1,84,O,666,587,79,0,105,2,1,104,68,36,nan
Stimme,09W139,9,Treptow-Köpenick,139,W,091U,1,84,O,982,779,203,0,225,2,1,224,140,84,nan
Stimme,09W140,9,Treptow-Köpenick,140,W,091U,1,84,O,1045,844,201,0,214,2,2,212,139,73,nan
Stimme,09W141,9,Treptow-Köpenick,141,W,091T,1,84,O,597,485,112,0,105,0,0,105,42,63,nan
Stimme,09W142,9,Treptow-Köpenick,142,W,091V,1,84,O,840,723,117,0,120,1,0,120,53,67,nan
Stimme,09W143,9,Treptow-Köpenick,143,W,091V,1,84,O,979,828,151,0,192,0,0,192,106,86,nan
Stimme,09W201,9,Treptow-Köpenick,201,W,092A,2,84,O,907,656,251,0,131,0,1,130,67,63,nan
Stimme,09W202,9,Treptow-Köpenick,202,W,092I,2,84,O,890,705,185,0,169,1,1,168,71,97,nan
Stimme,09W203,9,Treptow-Köpenick,203,W,092F,2,84,O,782,660,122,0,98,0,0,98,45,53,nan
Stimme,09W204,9,Treptow-Köpenick,204,W,092F,2,84,O,910,770,140,0,192,1,0,192,113,79,nan
Stimme,09W205,9,Treptow-Köpenick,205,W,092A,2,84,O,888,704,184,0,212,3,0,212,63,149,nan
Stimme,09W206,9,Treptow-Köpenick,206,W,092B,2,84,O,809,711,98,0,144,1,1,143,43,100,nan
Stimme,09W207,9,Treptow-Köpenick,207,W,092B,2,84,O,889,770,119,0,176,3,0,176,36,140,nan
Stimme,09W208,9,Treptow-Köpenick,208,W,092D,2,84,O,790,706,84,0,135,0,3,132,46,86,nan
Stimme,09W209,9,Treptow-Köpenick,209,W,092D,2,84,O,809,696,113,0,149,2,0,149,61,88,nan
Stimme,09W210,9,Treptow-Köpenick,210,W,092C,2,84,O,705,575,130,0,134,2,0,134,31,103,nan
Stimme,09W211,9,Treptow-Köpenick,211,W,092H,2,84,O,1161,801,360,0,245,6,0,245,149,96,nan
Stimme,09W212,9,Treptow-Köpenick,212,W,092C,2,84,O,943,728,215,0,195,0,1,194,48,146,nan
Stimme,09W213,9,Treptow-Köpenick,213,W,092I,2,84,O,982,832,150,0,212,3,1,211,86,125,nan
Stimme,09W214,9,Treptow-Köpenick,214,W,092H,2,84,O,685,600,85,0,149,0,0,149,61,88,nan
Stimme,09W215,9,Treptow-Köpenick,215,W,092G,2,84,O,727,608,119,0,184,3,1,183,77,106,nan
Stimme,09W216,9,Treptow-Köpenick,216,W,092G,2,84,O,861,696,165,0,220,0,0,220,113,107,nan
Stimme,09W217,9,Treptow-Köpenick,217,W,092E,2,84,O,999,796,203,0,232,3,0,232,105,127,nan
Stimme,09W218,9,Treptow-Köpenick,218,W,092E,2,84,O,1032,839,193,0,169,1,1,168,89,79,nan
Stimme,09W219,9,Treptow-Köpenick,219,W,092S,2,84,O,629,568,61,0,97,3,0,97,71,26,nan
Stimme,09W220,9,Treptow-Köpenick,220,W,092V,2,84,O,871,745,126,0,145,1,0,145,77,68,nan
Stimme,09W221,9,Treptow-Köpenick,221,W,092V,2,84,O,653,532,121,0,110,1,0,110,84,26,nan
Stimme,09W222,9,Treptow-Köpenick,222,W,092U,2,84,O,615,512,103,0,97,3,0,97,57,40,nan
Stimme,09W223,9,Treptow-Köpenick,223,W,092N,2,84,O,818,664,154,0,154,1,0,154,68,86,nan
Stimme,09W224,9,Treptow-Köpenick,224,W,092U,2,84,O,931,801,130,0,209,4,0,209,102,107,nan
Stimme,09W225,9,Treptow-Köpenick,225,W,092T,2,84,O,770,644,126,0,153,0,0,153,101,52,nan
Stimme,09W226,9,Treptow-Köpenick,226,W,092T,2,84,O,827,667,160,0,196,2,0,196,103,93,nan
Stimme,09W227,9,Treptow-Köpenick,227,W,092S,2,84,O,856,701,155,0,159,1,1,158,111,47,nan
Stimme,09W228,9,Treptow-Köpenick,228,W,092R,2,84,O,809,670,139,0,137,0,0,137,83,54,nan
Stimme,09W229,9,Treptow-Köpenick,229,W,092R,2,84,O,816,665,151,0,129,4,0,129,80,49,nan
Stimme,09W230,9,Treptow-Köpenick,230,W,092P,2,84,O,863,728,135,0,199,1,0,199,119,80,nan
Stimme,09W231,9,Treptow-Köpenick,231,W,092Q,2,84,O,764,628,136,0,127,3,1,126,71,55,nan
Stimme,09W232,9,Treptow-Köpenick,232,W,092Q,2,84,O,1012,887,125,0,162,1,0,162,60,102,nan
Stimme,09W233,9,Treptow-Köpenick,233,W,092P,2,84,O,1045,888,157,0,176,0,0,176,106,70,nan
Stimme,09W234,9,Treptow-Köpenick,234,W,092N,2,84,O,1032,833,199,0,130,2,0,130,71,59,nan
Stimme,09W235,9,Treptow-Köpenick,235,W,092J,2,84,O,898,748,150,0,198,5,0,198,118,80,nan
Stimme,09W236,9,Treptow-Köpenick,236,W,092J,2,84,O,925,799,126,0,143,2,1,142,73,69,nan
Stimme,09W237,9,Treptow-Köpenick,237,W,092K,2,84,O,859,667,192,0,176,3,1,175,89,86,nan
Stimme,09W238,9,Treptow-Köpenick,238,W,092K,2,84,O,990,871,119,0,163,0,0,163,60,103,nan
Stimme,09W239,9,Treptow-Köpenick,239,W,092L,2,84,O,900,673,227,0,232,5,0,232,93,139,nan
Stimme,09W240,9,Treptow-Köpenick,240,W,092L,2,84,O,785,669,116,0,93,0,0,93,31,62,nan
Stimme,09W241,9,Treptow-Köpenick,241,W,092M,2,84,O,1039,831,208,0,155,0,0,155,69,86,nan
Stimme,09W301,9,Treptow-Köpenick,301,W,093A,3,84,O,996,811,185,0,313,0,0,313,89,224,nan
Stimme,09W302,9,Treptow-Köpenick,302,W,093C,3,84,O,856,718,138,0,143,5,2,141,63,78,nan
Stimme,09W303,9,Treptow-Köpenick,303,W,093B,3,84,O,1068,900,168,0,182,0,2,180,91,89,nan
Stimme,09W304,9,Treptow-Köpenick,304,W,093D,3,84,O,880,709,171,0,164,0,0,164,45,119,nan
Stimme,09W305,9,Treptow-Köpenick,305,W,093D,3,84,O,802,651,151,0,186,0,0,186,63,123,nan
Stimme,09W306,9,Treptow-Köpenick,306,W,093F,3,84,O,872,733,139,0,176,3,1,175,85,90,nan
Stimme,09W307,9,Treptow-Köpenick,307,W,093G,3,84,O,747,610,137,0,126,0,0,126,64,62,nan
Stimme,09W308,9,Treptow-Köpenick,308,W,093F,3,84,O,892,757,135,0,215,0,2,213,100,113,nan
Stimme,09W309,9,Treptow-Köpenick,309,W,093G,3,84,O,940,802,138,0,195,3,2,193,95,98,nan
Stimme,09W310,9,Treptow-Köpenick,310,W,093E,3,84,O,904,790,114,0,153,0,0,153,67,86,nan
Stimme,09W311,9,Treptow-Köpenick,311,W,093B,3,84,O,872,750,122,0,166,0,1,165,67,98,nan
Stimme,09W312,9,Treptow-Köpenick,312,W,093C,3,84,O,843,690,153,0,165,4,0,165,76,89,nan
Stimme,09W313,9,Treptow-Köpenick,313,W,093A,3,84,O,767,661,106,0,113,1,1,112,34,78,nan
Stimme,09W314,9,Treptow-Köpenick,314,W,093E,3,84,O,693,602,91,0,107,2,1,106,51,55,nan
Stimme,09W315,9,Treptow-Köpenick,315,W,093H,3,84,O,783,580,203,0,148,1,0,148,84,64,nan
Stimme,09W316,9,Treptow-Köpenick,316,W,093H,3,84,O,1065,838,227,0,202,2,0,202,106,96,nan
Stimme,09W317,9,Treptow-Köpenick,317,W,093I,3,84,O,903,745,158,0,139,3,0,139,38,101,nan
Stimme,09W318,9,Treptow-Köpenick,318,W,093I,3,84,O,760,556,204,0,152,2,0,152,44,108,nan
Stimme,09W319,9,Treptow-Köpenick,319,W,093K,3,84,O,907,725,182,0,207,2,0,207,43,164,nan
Stimme,09W320,9,Treptow-Köpenick,320,W,093L,3,84,O,924,748,176,0,180,0,0,180,45,135,nan
Stimme,09W321,9,Treptow-Köpenick,321,W,093J,3,84,O,747,578,169,0,167,4,1,166,49,117,nan
Stimme,09W322,9,Treptow-Köpenick,322,W,093K,3,84,O,916,723,193,0,194,1,1,193,67,126,nan
Stimme,09W323,9,Treptow-Köpenick,323,W,093J,3,84,O,841,674,167,0,204,0,0,204,59,145,nan
Stimme,09W324,9,Treptow-Köpenick,324,W,093L,3,84,O,857,639,218,0,213,2,0,213,60,153,nan
Stimme,09W325,9,Treptow-Köpenick,325,W,093M,3,84,O,857,688,169,0,256,3,0,256,68,188,nan
Stimme,09W326,9,Treptow-Köpenick,326,W,093M,3,84,O,1087,815,272,0,249,6,0,249,71,178,nan
Stimme,09W327,9,Treptow-Köpenick,327,W,093Q,3,84,O,873,758,115,0,219,3,1,218,44,174,nan
Stimme,09W328,9,Treptow-Köpenick,328,W,093N,3,84,O,805,609,196,0,170,4,0,170,48,122,nan
Stimme,09W329,9,Treptow-Köpenick,329,W,093N,3,84,O,734,622,112,0,121,9,0,121,21,100,nan
Stimme,09W330,9,Treptow-Köpenick,330,W,093P,3,84,O,743,680,63,0,101,4,0,101,14,87,nan
Stimme,09W331,9,Treptow-Köpenick,331,W,093Q,3,84,O,798,716,82,0,69,0,0,69,15,54,nan
Stimme,09W332,9,Treptow-Köpenick,332,W,093P,3,84,O,1084,944,140,0,76,0,1,75,20,55,nan
Stimme,09W333,9,Treptow-Köpenick,333,W,093R,3,84,O,807,693,114,0,170,0,0,170,25,145,nan
Stimme,09W334,9,Treptow-Köpenick,334,W,093S,3,84,O,767,616,151,0,126,5,0,126,25,101,nan
Stimme,09W335,9,Treptow-Köpenick,335,W,093S,3,84,O,858,695,163,0,238,2,0,238,45,193,nan
Stimme,09W336,9,Treptow-Köpenick,336,W,093T,3,84,O,1053,835,218,0,197,5,0,197,34,163,nan
Stimme,09W337,9,Treptow-Köpenick,337,W,093R,3,84,O,880,694,186,0,190,0,1,189,32,157,nan
Stimme,09W338,9,Treptow-Köpenick,338,W,093V,3,84,O,744,688,56,0,114,2,1,113,23,90,nan
Stimme,09W339,9,Treptow-Köpenick,339,W,093U,3,84,O,887,833,54,0,69,0,0,69,12,57,nan
Stimme,09W340,9,Treptow-Köpenick,340,W,093U,3,84,O,798,754,44,0,88,0,0,88,14,74,nan
Stimme,09W341,9,Treptow-Köpenick,341,W,093V,3,84,O,887,781,106,0,135,0,0,135,26,109,nan
Stimme,09W401,9,Treptow-Köpenick,401,W,094A,4,84,O,1071,887,184,0,246,0,0,246,64,182,nan
Stimme,09W402,9,Treptow-Köpenick,402,W,094C,4,84,O,1189,958,231,0,280,5,0,280,96,184,nan
Stimme,09W403,9,Treptow-Köpenick,403,W,094B,4,84,O,1018,771,247,0,218,2,0,218,35,183,nan
Stimme,09W404,9,Treptow-Köpenick,404,W,094B,4,84,O,837,632,205,0,151,1,0,151,39,112,nan
Stimme,09W405,9,Treptow-Köpenick,405,W,094A,4,84,O,810,626,184,0,166,0,0,166,33,133,nan
Stimme,09W406,9,Treptow-Köpenick,406,W,094D,4,84,O,793,589,204,0,198,1,0,198,46,152,nan
Stimme,09W407,9,Treptow-Köpenick,407,W,094C,4,84,O,866,704,162,0,227,1,0,227,58,169,nan
Stimme,09W408,9,Treptow-Köpenick,408,W,094D,4,84,O,857,669,188,0,166,1,0,166,39,127,nan
Stimme,09W409,9,Treptow-Köpenick,409,W,094E,4,84,O,792,643,149,0,216,2,0,216,63,153,nan
Stimme,09W410,9,Treptow-Köpenick,410,W,094G,4,84,O,715,558,157,0,158,5,0,158,48,110,nan
Stimme,09W411,9,Treptow-Köpenick,411,W,094G,4,84,O,399,325,74,0,143,2,0,143,32,111,nan
Stimme,09W412,9,Treptow-Köpenick,412,W,094F,4,84,O,882,702,180,0,242,1,1,241,71,170,nan
Stimme,09W413,9,Treptow-Köpenick,413,W,094I,4,84,O,772,645,127,0,274,0,0,274,68,206,nan
Stimme,09W414,9,Treptow-Köpenick,414,W,094F,4,84,O,754,607,147,0,138,1,1,137,48,89,nan
Stimme,09W415,9,Treptow-Köpenick,415,W,094H,4,84,O,922,744,178,0,196,1,1,195,66,129,nan
Stimme,09W416,9,Treptow-Köpenick,416,W,094H,4,84,O,895,694,201,0,224,2,0,224,82,142,nan
Stimme,09W417,9,Treptow-Köpenick,417,W,094I,4,84,O,1465,1167,298,0,254,6,0,254,94,160,nan
Stimme,09W418,9,Treptow-Köpenick,418,W,094K,4,84,O,1451,1161,290,0,306,6,0,306,166,140,nan
Stimme,09W419,9,Treptow-Köpenick,419,W,094J,4,84,O,829,710,119,0,160,1,1,159,45,114,nan
Stimme,09W420,9,Treptow-Köpenick,420,W,094L,4,84,O,802,695,107,0,121,0,0,121,48,73,nan
Stimme,09W421,9,Treptow-Köpenick,421,W,094K,4,84,O,754,608,146,0,119,2,0,119,52,67,nan
Stimme,09W422,9,Treptow-Köpenick,422,W,094U,4,84,O,764,668,96,0,157,1,0,157,85,72,nan
Stimme,09W423,9,Treptow-Köpenick,423,W,094M,4,84,O,846,742,104,0,173,2,0,173,80,93,nan
Stimme,09W424,9,Treptow-Köpenick,424,W,094N,4,84,O,887,760,127,0,99,0,0,99,41,58,nan
Stimme,09W425,9,Treptow-Köpenick,425,W,094M,4,84,O,917,807,110,0,145,4,1,144,35,109,nan
Stimme,09W426,9,Treptow-Köpenick,426,W,094P,4,84,O,897,785,112,0,187,5,0,187,100,87,nan
Stimme,09W427,9,Treptow-Köpenick,427,W,094P,4,84,O,760,657,103,0,173,0,0,173,101,72,nan
Stimme,09W428,9,Treptow-Köpenick,428,W,094T,4,84,O,906,727,179,0,168,3,0,168,89,79,nan
Stimme,09W429,9,Treptow-Köpenick,429,W,094T,4,84,O,975,763,212,0,175,2,0,175,85,90,nan
Stimme,09W430,9,Treptow-Köpenick,430,W,094Q,4,84,O,879,655,224,0,140,2,0,140,68,72,nan
Stimme,09W431,9,Treptow-Köpenick,431,W,094N,4,84,O,1240,1043,197,0,236,6,0,236,110,126,nan
Stimme,09W432,9,Treptow-Köpenick,432,W,094U,4,84,O,865,713,152,0,200,1,0,200,113,87,nan
Stimme,09W433,9,Treptow-Köpenick,433,W,094Q,4,84,O,897,724,173,0,190,2,0,190,93,97,nan
Stimme,09W434,9,Treptow-Köpenick,434,W,094S,4,84,O,1041,832,209,0,138,0,0,138,55,83,nan
Stimme,09W435,9,Treptow-Köpenick,435,W,094R,4,84,O,867,672,195,0,129,1,0,129,65,64,nan
Stimme,09W436,9,Treptow-Köpenick,436,W,094R,4,84,O,946,759,187,0,230,3,2,228,116,112,nan
Stimme,09W437,9,Treptow-Köpenick,437,W,094S,4,84,O,895,744,151,0,186,5,0,186,99,87,nan
Stimme,09W438,9,Treptow-Köpenick,438,W,094E,4,84,O,1036,816,220,0,255,2,0,255,72,183,nan
Stimme,09W439,9,Treptow-Köpenick,439,W,094J,4,84,O,983,818,165,0,238,2,2,236,100,136,nan
Stimme,09W440,9,Treptow-Köpenick,440,W,094L,4,84,O,836,754,82,0,80,3,0,80,22,58,nan
Stimme,09W501,9,Treptow-Köpenick,501,W,095A,5,84,O,889,763,126,0,230,5,1,229,139,90,nan
Stimme,09W502,9,Treptow-Köpenick,502,W,095A,5,84,O,853,717,136,0,154,0,1,153,38,115,nan
Stimme,09W503,9,Treptow-Köpenick,503,W,095M,5,84,O,888,753,135,0,161,1,1,160,61,99,nan
Stimme,09W504,9,Treptow-Köpenick,504,W,095N,5,84,O,906,794,112,0,165,1,1,164,48,116,nan
Stimme,09W505,9,Treptow-Köpenick,505,W,095M,5,84,O,932,799,133,0,133,2,0,133,40,93,nan
Stimme,09W506,9,Treptow-Köpenick,506,W,095K,5,84,O,893,737,156,0,145,1,0,145,34,111,nan
Stimme,09W507,9,Treptow-Köpenick,507,W,095N,5,84,O,761,631,130,0,157,0,2,155,49,106,nan
Stimme,09W508,9,Treptow-Köpenick,508,W,095I,5,84,O,803,677,126,0,162,0,1,161,63,98,nan
Stimme,09W509,9,Treptow-Köpenick,509,W,095L,5,84,O,1040,951,89,0,184,0,2,182,47,135,nan
Stimme,09W510,9,Treptow-Köpenick,510,W,095L,5,84,O,858,732,126,0,153,0,2,151,50,101,nan
Stimme,09W511,9,Treptow-Köpenick,511,W,095B,5,84,O,889,732,157,0,154,7,0,154,68,86,nan
Stimme,09W512,9,Treptow-Köpenick,512,W,095B,5,84,O,859,786,73,0,144,2,1,143,43,100,nan
Stimme,09W513,9,Treptow-Köpenick,513,W,095C,5,84,O,813,652,161,0,125,1,0,125,50,75,nan
Stimme,09W514,9,Treptow-Köpenick,514,W,095P,5,84,O,770,650,120,0,105,0,0,105,55,50,nan
Stimme,09W515,9,Treptow-Köpenick,515,W,095P,5,84,O,848,719,129,0,168,1,0,168,70,98,nan
Stimme,09W516,9,Treptow-Köpenick,516,W,095J,5,84,O,951,776,175,0,228,1,0,228,49,179,nan
Stimme,09W517,9,Treptow-Köpenick,517,W,095Q,5,84,O,900,768,132,0,186,4,2,184,66,118,nan
Stimme,09W518,9,Treptow-Köpenick,518,W,095Q,5,84,O,950,750,200,0,261,2,2,259,55,204,nan
Stimme,09W519,9,Treptow-Köpenick,519,W,095J,5,84,O,928,707,221,0,193,0,1,192,72,120,nan
Stimme,09W520,9,Treptow-Köpenick,520,W,095R,5,84,O,1096,930,166,0,163,0,1,162,49,113,nan
Stimme,09W521,9,Treptow-Köpenick,521,W,095D,5,84,O,869,751,118,0,148,0,0,148,33,115,nan
Stimme,09W522,9,Treptow-Köpenick,522,W,095C,5,84,O,902,737,165,0,166,0,0,166,45,121,nan
Stimme,09W523,9,Treptow-Köpenick,523,W,095D,5,84,O,951,832,119,0,140,2,1,139,43,96,nan
Stimme,09W524,9,Treptow-Köpenick,524,W,095E,5,84,O,762,635,127,0,182,0,1,181,56,125,nan
Stimme,09W525,9,Treptow-Köpenick,525,W,095E,5,84,O,931,697,234,0,206,2,0,206,71,135,nan
Stimme,09W526,9,Treptow-Köpenick,526,W,095F,5,84,O,882,724,158,0,188,0,0,188,49,139,nan
Stimme,09W527,9,Treptow-Köpenick,527,W,095F,5,84,O,895,708,187,0,213,0,2,211,64,147,nan
Stimme,09W528,9,Treptow-Köpenick,528,W,095H,5,84,O,967,818,149,0,280,0,1,279,55,224,nan
Stimme,09W529,9,Treptow-Köpenick,529,W,095G,5,84,O,915,735,180,0,247,2,1,246,53,193,nan
Stimme,09W530,9,Treptow-Köpenick,530,W,095G,5,84,O,901,760,141,0,233,0,0,233,42,191,nan
Stimme,09W531,9,Treptow-Köpenick,531,W,095H,5,84,O,1055,820,235,0,254,0,1,253,41,212,nan
Stimme,09W532,9,Treptow-Köpenick,532,W,095I,5,84,O,829,741,88,0,169,0,0,169,47,122,nan
Stimme,09W533,9,Treptow-Köpenick,533,W,095K,5,84,O,798,706,92,0,127,0,0,127,28,99,nan
Stimme,09W601,9,Treptow-Köpenick,601,W,096A,6,84,O,830,641,189,0,185,0,0,185,130,55,nan
Stimme,09W602,9,Treptow-Köpenick,602,W,096B,6,84,O,836,647,189,0,213,2,0,213,56,157,nan
Stimme,09W603,9,Treptow-Köpenick,603,W,096A,6,84,O,927,700,227,0,248,3,1,247,92,155,nan
Stimme,09W604,9,Treptow-Köpenick,604,W,096E,6,84,O,768,640,128,0,178,4,0,178,68,110,nan
Stimme,09W605,9,Treptow-Köpenick,605,W,096E,6,84,O,877,769,108,0,173,3,0,173,100,73,nan
Stimme,09W606,9,Treptow-Köpenick,606,W,096D,6,84,O,981,840,141,0,230,1,0,230,93,137,nan
Stimme,09W607,9,Treptow-Köpenick,607,W,096D,6,84,O,757,641,116,0,112,0,0,112,31,81,nan
Stimme,09W608,9,Treptow-Köpenick,608,W,096B,6,84,O,1016,843,173,0,225,0,0,225,72,153,nan
Stimme,09W609,9,Treptow-Köpenick,609,W,096C,6,84,O,808,668,140,0,121,1,0,121,41,80,nan
Stimme,09W610,9,Treptow-Köpenick,610,W,096C,6,84,O,930,727,203,0,205,3,0,205,105,100,nan
Stimme,09W611,9,Treptow-Köpenick,611,W,096F,6,84,O,1048,885,163,0,340,0,1,339,142,197,nan
Stimme,09W612,9,Treptow-Köpenick,612,W,096F,6,84,O,834,655,179,0,225,3,0,225,95,130,nan
Stimme,09W613,9,Treptow-Köpenick,613,W,096G,6,84,O,947,769,178,0,217,2,0,217,109,108,nan
Stimme,09W614,9,Treptow-Köpenick,614,W,096H,6,84,O,1047,850,197,0,191,7,1,190,81,109,nan
Stimme,09W615,9,Treptow-Köpenick,615,W,096K,6,84,O,826,735,91,0,161,2,0,161,71,90,nan
Stimme,09W616,9,Treptow-Köpenick,616,W,096H,6,84,O,861,684,177,0,199,0,1,198,112,86,nan
Stimme,09W617,9,Treptow-Köpenick,617,W,096J,6,84,O,991,813,178,0,197,5,1,196,88,108,nan
Stimme,09W618,9,Treptow-Köpenick,618,W,096I,6,84,O,971,796,175,0,254,6,0,254,106,148,nan
Stimme,09W619,9,Treptow-Köpenick,619,W,096I,6,84,O,875,671,204,0,165,3,1,164,70,94,nan
Stimme,09W620,9,Treptow-Köpenick,620,W,096J,6,84,O,1039,853,186,0,239,2,0,239,113,126,nan
Stimme,09W621,9,Treptow-Köpenick,621,W,096K,6,84,O,885,723,162,0,162,1,0,162,88,74,nan
Stimme,09W622,9,Treptow-Köpenick,622,W,096G,6,84,O,935,725,210,0,277,8,1,276,163,113,nan
Stimme,09W623,9,Treptow-Köpenick,623,W,096M,6,84,O,977,772,205,0,255,14,1,254,132,122,nan
Stimme,09W624,9,Treptow-Köpenick,624,W,096M,6,84,O,987,805,182,0,224,8,1,223,105,118,nan
Stimme,09W625,9,Treptow-Köpenick,625,W,096L,6,84,O,852,650,202,0,217,3,0,217,122,95,nan
Stimme,09W626,9,Treptow-Köpenick,626,W,096L,6,84,O,937,761,176,0,282,6,0,282,156,126,nan
Stimme,09W627,9,Treptow-Köpenick,627,W,096N,6,84,O,962,811,151,0,194,0,0,194,105,89,nan
Stimme,09W628,9,Treptow-Köpenick,628,W,096N,6,84,O,824,653,171,0,250,6,2,248,120,128,nan
Stimme,09W629,9,Treptow-Köpenick,629,W,096P,6,84,O,1046,828,218,0,218,4,2,216,81,135,nan
Stimme,09W630,9,Treptow-Köpenick,630,W,096Q,6,84,O,899,689,210,0,237,3,0,237,64,173,nan
Stimme,09W631,9,Treptow-Köpenick,631,W,096P,6,84,O,811,605,206,0,207,1,0,207,67,140,nan
Stimme,09W632,9,Treptow-Köpenick,632,W,096Q,6,84,O,881,685,196,0,233,0,0,233,71,162,nan
Stimme,09W633,9,Treptow-Köpenick,633,W,096S,6,84,O,953,777,176,0,268,2,0,268,97,171,nan
Stimme,09W634,9,Treptow-Köpenick,634,W,096S,6,84,O,1002,837,165,0,214,2,0,214,68,146,nan
Stimme,09W635,9,Treptow-Köpenick,635,W,096R,6,84,O,1460,1204,256,0,384,4,0,384,119,265,nan
Stimme,09W636,9,Treptow-Köpenick,636,W,096R,6,84,O,994,800,194,0,262,5,0,262,82,180,nan
Stimme,09B1A,9,Treptow-Köpenick,1A,B,091A,1,84,O,0,0,0,0,515,515,9,506,399,107,nan
Stimme,09B1B,9,Treptow-Köpenick,1B,B,091B,1,84,O,0,0,0,0,275,275,1,274,208,66,nan
Stimme,09B1C,9,Treptow-Köpenick,1C,B,091C,1,84,O,0,0,0,0,364,364,0,364,277,87,nan
Stimme,09B1D,9,Treptow-Köpenick,1D,B,091D,1,84,O,0,0,0,0,299,299,0,299,230,69,nan
Stimme,09B1E,9,Treptow-Köpenick,1E,B,091E,1,84,O,0,0,0,0,275,275,2,273,220,53,nan
Stimme,09B1F,9,Treptow-Köpenick,1F,B,091F,1,84,O,0,0,0,0,416,416,0,416,297,119,nan
Stimme,09B1G,9,Treptow-Köpenick,1G,B,091G,1,84,O,0,0,0,0,187,187,1,186,101,85,nan
Stimme,09B1H,9,Treptow-Köpenick,1H,B,091H,1,84,O,0,0,0,0,210,210,1,209,100,109,nan
Stimme,09B1I,9,Treptow-Köpenick,1I,B,091I,1,84,O,0,0,0,0,222,222,0,222,125,97,nan
Stimme,09B1J,9,Treptow-Köpenick,1J,B,091J,1,84,O,0,0,0,0,220,220,1,219,115,104,nan
Stimme,09B1K,9,Treptow-Köpenick,1K,B,091K,1,84,O,0,0,0,0,230,230,0,230,101,129,nan
Stimme,09B1L,9,Treptow-Köpenick,1L,B,091L,1,84,O,0,0,0,0,199,199,3,196,105,91,nan
Stimme,09B1M,9,Treptow-Köpenick,1M,B,091M,1,84,O,0,0,0,0,271,271,0,271,199,72,nan
Stimme,09B1N,9,Treptow-Köpenick,1N,B,091N,1,84,O,0,0,0,0,294,294,0,294,168,126,nan
Stimme,09B1P,9,Treptow-Köpenick,1P,B,091P,1,84,O,0,0,0,0,208,208,1,207,115,92,nan
Stimme,09B1Q,9,Treptow-Köpenick,1Q,B,091Q,1,84,O,0,0,0,0,309,309,1,308,181,127,nan
Stimme,09B1R,9,Treptow-Köpenick,1R,B,091R,1,84,O,0,0,0,0,444,444,8,436,112,324,nan
Stimme,09B1S,9,Treptow-Köpenick,1S,B,091S,1,84,O,0,0,0,0,346,346,0,346,257,89,nan
Stimme,09B1T,9,Treptow-Köpenick,1T,B,091T,1,84,O,0,0,0,0,161,161,0,161,79,82,nan
Stimme,09B1U,9,Treptow-Köpenick,1U,B,091U,1,84,O,0,0,0,0,345,345,0,345,217,128,nan
Stimme,09B1V,9,Treptow-Köpenick,1V,B,091V,1,84,O,0,0,0,0,243,243,0,243,123,120,nan
Stimme,09B2A,9,Treptow-Köpenick,2A,B,092A,2,84,O,0,0,0,0,373,373,0,373,158,215,nan
Stimme,09B2B,9,Treptow-Köpenick,2B,B,092B,2,84,O,0,0,0,0,194,194,1,193,66,127,nan
Stimme,09B2C,9,Treptow-Köpenick,2C,B,092C,2,84,O,0,0,0,0,307,307,1,306,85,221,nan
Stimme,09B2D,9,Treptow-Köpenick,2D,B,092D,2,84,O,0,0,0,0,162,162,2,160,73,87,nan
Stimme,09B2E,9,Treptow-Köpenick,2E,B,092E,2,84,O,0,0,0,0,325,325,0,325,147,178,nan
Stimme,09B2F,9,Treptow-Köpenick,2F,B,092F,2,84,O,0,0,0,0,231,231,0,231,109,122,nan
Stimme,09B2G,9,Treptow-Köpenick,2G,B,092G,2,84,O,0,0,0,0,249,249,0,249,122,127,nan
Stimme,09B2H,9,Treptow-Köpenick,2H,B,092H,2,84,O,0,0,0,0,388,388,0,388,153,235,nan
Stimme,09B2I,9,Treptow-Köpenick,2I,B,092I,2,84,O,0,0,0,0,284,284,7,277,119,158,nan
Stimme,09B2J,9,Treptow-Köpenick,2J,B,092J,2,84,O,0,0,0,0,245,245,1,244,134,110,nan
Stimme,09B2K,9,Treptow-Köpenick,2K,B,092K,2,84,O,0,0,0,0,266,266,2,264,135,129,nan
Stimme,09B2L,9,Treptow-Köpenick,2L,B,092L,2,84,O,0,0,0,0,313,313,0,313,110,203,nan
Stimme,09B2M,9,Treptow-Köpenick,2M,B,092M,2,84,O,0,0,0,0,186,186,1,185,87,98,nan
Stimme,09B2N,9,Treptow-Köpenick,2N,B,092N,2,84,O,0,0,0,0,311,311,1,310,151,159,nan
Stimme,09B2P,9,Treptow-Köpenick,2P,B,092P,2,84,O,0,0,0,0,261,261,3,258,163,95,nan
Stimme,09B2Q,9,Treptow-Köpenick,2Q,B,092Q,2,84,O,0,0,0,0,227,227,3,224,114,110,nan
Stimme,09B2R,9,Treptow-Köpenick,2R,B,092R,2,84,O,0,0,0,0,248,248,0,248,162,86,nan
Stimme,09B2S,9,Treptow-Köpenick,2S,B,092S,2,84,O,0,0,0,0,174,174,0,174,112,62,nan
Stimme,09B2T,9,Treptow-Köpenick,2T,B,092T,2,84,O,0,0,0,0,261,261,0,261,162,99,nan
Stimme,09B2U,9,Treptow-Köpenick,2U,B,092U,2,84,O,0,0,0,0,198,198,2,196,125,71,nan
Stimme,09B2V,9,Treptow-Köpenick,2V,B,092V,2,84,O,0,0,0,0,211,211,0,211,137,74,nan
Stimme,09B3A,9,Treptow-Köpenick,3A,B,093A,3,84,O,0,0,0,0,262,262,0,262,89,173,nan
Stimme,09B3B,9,Treptow-Köpenick,3B,B,093B,3,84,O,0,0,0,0,254,254,3,251,131,120,nan
Stimme,09B3C,9,Treptow-Köpenick,3C,B,093C,3,84,O,0,0,0,0,251,251,0,251,115,136,nan
Stimme,09B3D,9,Treptow-Köpenick,3D,B,093D,3,84,O,0,0,0,0,296,296,1,295,111,184,nan
Stimme,09B3E,9,Treptow-Köpenick,3E,B,093E,3,84,O,0,0,0,0,184,184,0,184,95,89,nan
Stimme,09B3F,9,Treptow-Köpenick,3F,B,093F,3,84,O,0,0,0,0,243,243,1,242,108,134,nan
Stimme,09B3G,9,Treptow-Köpenick,3G,B,093G,3,84,O,0,0,0,0,239,239,0,239,132,107,nan
Stimme,09B3H,9,Treptow-Köpenick,3H,B,093H,3,84,O,0,0,0,0,385,385,1,384,217,167,nan
Stimme,09B3I,9,Treptow-Köpenick,3I,B,093I,3,84,O,0,0,0,0,318,318,0,318,94,224,nan
Stimme,09B3J,9,Treptow-Köpenick,3J,B,093J,3,84,O,0,0,0,0,284,284,0,284,85,199,nan
Stimme,09B3K,9,Treptow-Köpenick,3K,B,093K,3,84,O,0,0,0,0,335,335,0,335,104,231,nan
Stimme,09B3L,9,Treptow-Köpenick,3L,B,093L,3,84,O,0,0,0,0,353,353,0,353,99,254,nan
Stimme,09B3M,9,Treptow-Köpenick,3M,B,093M,3,84,O,0,0,0,0,388,388,2,386,110,276,nan
Stimme,09B3N,9,Treptow-Köpenick,3N,B,093N,3,84,O,0,0,0,0,281,281,1,280,82,198,nan
Stimme,09B3P,9,Treptow-Köpenick,3P,B,093P,3,84,O,0,0,0,0,173,173,0,173,52,121,nan
Stimme,09B3Q,9,Treptow-Köpenick,3Q,B,093Q,3,84,O,0,0,0,0,181,181,4,177,47,130,nan
Stimme,09B3R,9,Treptow-Köpenick,3R,B,093R,3,84,O,0,0,0,0,269,269,5,264,37,227,nan
Stimme,09B3S,9,Treptow-Köpenick,3S,B,093S,3,84,O,0,0,0,0,286,286,4,282,81,201,nan
Stimme,09B3T,9,Treptow-Köpenick,3T,B,093T,3,84,O,0,0,0,0,187,187,1,186,38,148,nan
Stimme,09B3U,9,Treptow-Köpenick,3U,B,093U,3,84,O,0,0,0,0,74,74,0,74,27,47,nan
Stimme,09B3V,9,Treptow-Köpenick,3V,B,093V,3,84,O,0,0,0,0,144,144,0,144,28,116,nan
Stimme,09B4A,9,Treptow-Köpenick,4A,B,094A,4,84,O,0,0,0,0,328,328,0,328,70,258,nan
Stimme,09B4B,9,Treptow-Köpenick,4B,B,094B,4,84,O,0,0,0,0,399,399,3,396,70,326,nan
Stimme,09B4C,9,Treptow-Köpenick,4C,B,094C,4,84,O,0,0,0,0,356,356,0,356,95,261,nan
Stimme,09B4D,9,Treptow-Köpenick,4D,B,094D,4,84,O,0,0,0,0,350,350,2,348,90,258,nan
Stimme,09B4E,9,Treptow-Köpenick,4E,B,094E,4,84,O,0,0,0,0,333,333,3,330,100,230,nan
Stimme,09B4F,9,Treptow-Köpenick,4F,B,094F,4,84,O,0,0,0,0,300,300,0,300,117,183,nan
Stimme,09B4G,9,Treptow-Köpenick,4G,B,094G,4,84,O,0,0,0,0,193,193,1,192,60,132,nan
Stimme,09B4H,9,Treptow-Köpenick,4H,B,094H,4,84,O,0,0,0,0,333,333,1,332,157,175,nan
Stimme,09B4I,9,Treptow-Köpenick,4I,B,094I,4,84,O,0,0,0,0,363,363,2,361,149,212,nan
Stimme,09B4J,9,Treptow-Köpenick,4J,B,094J,4,84,O,0,0,0,0,244,244,0,244,106,138,nan
Stimme,09B4K,9,Treptow-Köpenick,4K,B,094K,4,84,O,0,0,0,0,362,362,0,362,179,183,nan
Stimme,09B4L,9,Treptow-Köpenick,4L,B,094L,4,84,O,0,0,0,0,165,165,0,165,72,93,nan
Stimme,09B4M,9,Treptow-Köpenick,4M,B,094M,4,84,O,0,0,0,0,173,173,2,171,86,85,nan
Stimme,09B4N,9,Treptow-Köpenick,4N,B,094N,4,84,O,0,0,0,0,269,269,0,269,127,142,nan
Stimme,09B4P,9,Treptow-Köpenick,4P,B,094P,4,84,O,0,0,0,0,194,194,1,193,123,70,nan
Stimme,09B4Q,9,Treptow-Köpenick,4Q,B,094Q,4,84,O,0,0,0,0,355,355,2,353,182,171,nan
Stimme,09B4R,9,Treptow-Köpenick,4R,B,094R,4,84,O,0,0,0,0,343,343,7,336,142,194,nan
Stimme,09B4S,9,Treptow-Köpenick,4S,B,094S,4,84,O,0,0,0,0,319,319,7,312,159,153,nan
Stimme,09B4T,9,Treptow-Köpenick,4T,B,094T,4,84,O,0,0,0,0,341,341,1,340,195,145,nan
Stimme,09B4U,9,Treptow-Köpenick,4U,B,094U,4,84,O,0,0,0,0,209,209,0,209,119,90,nan
Stimme,09B5A,9,Treptow-Köpenick,5A,B,095A,5,84,O,0,0,0,0,221,221,0,221,129,92,nan
Stimme,09B5B,9,Treptow-Köpenick,5B,B,095B,5,84,O,0,0,0,0,198,198,4,194,87,107,nan
Stimme,09B5C,9,Treptow-Köpenick,5C,B,095C,5,84,O,0,0,0,0,288,288,0,288,121,167,nan
Stimme,09B5D,9,Treptow-Köpenick,5D,B,095D,5,84,O,0,0,0,0,205,205,0,205,66,139,nan
Stimme,09B5E,9,Treptow-Köpenick,5E,B,095E,5,84,O,0,0,0,0,322,322,0,322,105,217,nan
Stimme,09B5F,9,Treptow-Köpenick,5F,B,095F,5,84,O,0,0,0,0,304,304,0,304,84,220,nan
Stimme,09B5G,9,Treptow-Köpenick,5G,B,095G,5,84,O,0,0,0,0,284,284,0,284,74,210,nan
Stimme,09B5H,9,Treptow-Köpenick,5H,B,095H,5,84,O,0,0,0,0,351,351,1,350,87,263,nan
Stimme,09B5I,9,Treptow-Köpenick,5I,B,095I,5,84,O,0,0,0,0,176,176,0,176,67,109,nan
Stimme,09B5J,9,Treptow-Köpenick,5J,B,095J,5,84,O,0,0,0,0,364,364,9,355,98,257,nan
Stimme,09B5K,9,Treptow-Köpenick,5K,B,095K,5,84,O,0,0,0,0,220,220,0,220,69,151,nan
Stimme,09B5L,9,Treptow-Köpenick,5L,B,095L,5,84,O,0,0,0,0,189,189,1,188,68,120,nan
Stimme,09B5M,9,Treptow-Köpenick,5M,B,095M,5,84,O,0,0,0,0,228,228,0,228,105,123,nan
Stimme,09B5N,9,Treptow-Köpenick,5N,B,095N,5,84,O,0,0,0,0,213,213,4,209,70,139,nan
Stimme,09B5P,9,Treptow-Köpenick,5P,B,095P,5,84,O,0,0,0,0,206,206,3,203,87,116,nan
Stimme,09B5Q,9,Treptow-Köpenick,5Q,B,095Q,5,84,O,0,0,0,0,287,287,0,287,191,96,nan
Stimme,09B5R,9,Treptow-Köpenick,5R,B,095R,5,84,O,0,0,0,0,144,144,0,144,45,99,nan
Stimme,09B6A,9,Treptow-Köpenick,6A,B,096A,6,84,O,0,0,0,0,370,370,0,370,138,232,nan
Stimme,09B6B,9,Treptow-Köpenick,6B,B,096B,6,84,O,0,0,0,0,323,323,1,322,108,214,nan
Stimme,09B6C,9,Treptow-Köpenick,6C,B,096C,6,84,O,0,0,0,0,293,293,0,293,148,145,nan
Stimme,09B6D,9,Treptow-Köpenick,6D,B,096D,6,84,O,0,0,0,0,227,227,0,227,95,132,nan
Stimme,09B6E,9,Treptow-Köpenick,6E,B,096E,6,84,O,0,0,0,0,204,204,0,204,99,105,nan
Stimme,09B6F,9,Treptow-Köpenick,6F,B,096F,6,84,O,0,0,0,0,287,287,0,287,136,151,nan
Stimme,09B6G,9,Treptow-Köpenick,6G,B,096G,6,84,O,0,0,0,0,337,337,0,337,169,168,nan
Stimme,09B6H,9,Treptow-Köpenick,6H,B,096H,6,84,O,0,0,0,0,318,318,0,318,165,153,nan
Stimme,09B6I,9,Treptow-Köpenick,6I,B,096I,6,84,O,0,0,0,0,334,334,2,332,138,194,nan
Stimme,09B6J,9,Treptow-Köpenick,6J,B,096J,6,84,O,0,0,0,0,321,321,0,321,148,173,nan
Stimme,09B6K,9,Treptow-Köpenick,6K,B,096K,6,84,O,0,0,0,0,221,221,0,221,91,130,nan
Stimme,09B6L,9,Treptow-Köpenick,6L,B,096L,6,84,O,0,0,0,0,327,327,0,327,184,143,nan
Stimme,09B6M,9,Treptow-Köpenick,6M,B,096M,6,84,O,0,0,0,0,335,335,0,335,186,149,nan
Stimme,09B6N,9,Treptow-Köpenick,6N,B,096N,6,84,O,0,0,0,0,260,260,1,259,112,147,nan
Stimme,09B6P,9,Treptow-Köpenick,6P,B,096P,6,84,O,0,0,0,0,375,375,0,375,113,262,nan
Stimme,09B6Q,9,Treptow-Köpenick,6Q,B,096Q,6,84,O,0,0,0,0,354,354,0,354,123,231,nan
Stimme,09B6R,9,Treptow-Köpenick,6R,B,096R,6,84,O,0,0,0,0,397,397,1,396,127,269,nan
Stimme,09B6S,9,Treptow-Köpenick,6S,B,096S,6,84,O,0,0,0,0,287,287,0,287,101,186,nan
Stimme,10W101,10,Marzahn-Hellersdorf,101,W,101A,1,85,O,1348,1267,81,0,148,0,0,148,28,120,nan
Stimme,10W102,10,Marzahn-Hellersdorf,102,W,101A,1,85,O,1344,1211,133,0,194,0,0,194,56,138,nan
Stimme,10W103,10,Marzahn-Hellersdorf,103,W,101B,1,85,O,1172,1061,111,0,133,3,2,131,47,84,nan
Stimme,10W104,10,Marzahn-Hellersdorf,104,W,101B,1,85,O,1321,1206,115,0,179,2,0,179,40,139,nan
Stimme,10W105,10,Marzahn-Hellersdorf,105,W,101C,1,85,O,1198,1107,91,0,186,1,1,185,40,145,nan
Stimme,10W106,10,Marzahn-Hellersdorf,106,W,101C,1,85,O,1219,1131,88,0,151,0,1,150,38,112,nan
Stimme,10W107,10,Marzahn-Hellersdorf,107,W,101D,1,85,O,1288,1117,171,0,156,0,0,156,33,123,nan
Stimme,10W108,10,Marzahn-Hellersdorf,108,W,101D,1,85,O,1301,1222,79,0,119,0,1,118,25,93,nan
Stimme,10W109,10,Marzahn-Hellersdorf,109,W,101E,1,85,O,1353,1191,162,0,163,0,0,163,40,123,nan
Stimme,10W110,10,Marzahn-Hellersdorf,110,W,101E,1,85,O,1344,1191,153,0,149,4,0,149,50,99,nan
Stimme,10W111,10,Marzahn-Hellersdorf,111,W,101F,1,85,O,1135,1019,116,0,139,1,0,139,31,108,nan
Stimme,10W112,10,Marzahn-Hellersdorf,112,W,101F,1,85,O,1062,962,100,0,119,0,0,119,30,89,nan
Stimme,10W113,10,Marzahn-Hellersdorf,113,W,101F,1,85,O,1148,1043,105,0,154,3,2,152,31,121,nan
Stimme,10W114,10,Marzahn-Hellersdorf,114,W,101G,1,85,O,1582,1436,146,0,145,0,1,144,38,106,nan
Stimme,10W115,10,Marzahn-Hellersdorf,115,W,101G,1,85,O,1271,1137,134,0,170,0,0,170,34,136,nan
Stimme,10W116,10,Marzahn-Hellersdorf,116,W,101H,1,85,O,1125,1072,53,0,132,0,0,132,30,102,nan
Stimme,10W117,10,Marzahn-Hellersdorf,117,W,101H,1,85,O,1267,1161,106,0,156,0,1,155,40,115,nan
Stimme,10W118,10,Marzahn-Hellersdorf,118,W,101J,1,85,O,1247,1120,127,0,258,0,0,258,52,206,nan
Stimme,10W119,10,Marzahn-Hellersdorf,119,W,101J,1,85,O,1238,1060,178,0,245,0,0,245,44,201,nan
Stimme,10W120,10,Marzahn-Hellersdorf,120,W,101K,1,85,O,1149,1059,90,0,110,0,0,110,31,79,nan
Stimme,10W121,10,Marzahn-Hellersdorf,121,W,101K,1,85,O,1275,1129,146,0,189,1,2,187,51,136,nan
Stimme,10W122,10,Marzahn-Hellersdorf,122,W,101L,1,85,O,1235,1063,172,0,181,0,0,181,41,140,nan
Stimme,10W123,10,Marzahn-Hellersdorf,123,W,101L,1,85,O,1223,1107,116,0,156,1,0,156,35,121,nan
Stimme,10W124,10,Marzahn-Hellersdorf,124,W,101M,1,85,O,1163,1073,90,0,121,0,0,121,34,87,nan
Stimme,10W125,10,Marzahn-Hellersdorf,125,W,101M,1,85,O,1185,1085,100,0,100,0,0,100,18,82,nan
Stimme,10W201,10,Marzahn-Hellersdorf,201,W,102A,2,85,O,1623,1426,197,0,238,2,0,238,72,166,nan
Stimme,10W202,10,Marzahn-Hellersdorf,202,W,102A,2,85,O,1300,1154,146,0,149,2,1,148,56,92,nan
Stimme,10W203,10,Marzahn-Hellersdorf,203,W,102B,2,85,O,1184,1053,131,0,163,0,1,162,42,120,nan
Stimme,10W204,10,Marzahn-Hellersdorf,204,W,102B,2,85,O,1153,982,171,0,142,0,0,142,29,113,nan
Stimme,10W205,10,Marzahn-Hellersdorf,205,W,102C,2,85,O,1140,1015,125,0,134,0,0,134,36,98,nan
Stimme,10W206,10,Marzahn-Hellersdorf,206,W,102D,2,85,O,1148,1012,136,0,150,2,0,150,42,108,nan
Stimme,10W207,10,Marzahn-Hellersdorf,207,W,102D,2,85,O,1215,1055,160,0,169,0,0,169,47,122,nan
Stimme,10W208,10,Marzahn-Hellersdorf,208,W,102E,2,85,O,1299,1113,186,0,201,3,1,200,47,153,nan
Stimme,10W209,10,Marzahn-Hellersdorf,209,W,102F,2,85,O,1338,1141,197,0,185,1,0,185,36,149,nan
Stimme,10W210,10,Marzahn-Hellersdorf,210,W,102G,2,85,O,1367,1166,201,0,194,2,0,194,40,154,nan
Stimme,10W211,10,Marzahn-Hellersdorf,211,W,102H,2,85,O,1362,1187,175,0,242,0,0,242,60,182,nan
Stimme,10W212,10,Marzahn-Hellersdorf,212,W,102H,2,85,O,1310,1201,109,0,148,0,1,147,42,105,nan
Stimme,10W213,10,Marzahn-Hellersdorf,213,W,102J,2,85,O,1315,1184,131,0,168,0,0,168,45,123,nan
Stimme,10W214,10,Marzahn-Hellersdorf,214,W,102K,2,85,O,1335,1218,117,0,160,1,1,159,33,126,nan
Stimme,10W215,10,Marzahn-Hellersdorf,215,W,102K,2,85,O,1319,1191,128,0,172,0,0,172,46,126,nan
Stimme,10W216,10,Marzahn-Hellersdorf,216,W,102L,2,85,O,1100,1001,99,0,157,0,0,157,54,103,nan
Stimme,10W217,10,Marzahn-Hellersdorf,217,W,102L,2,85,O,1231,1027,204,0,210,0,0,210,50,160,nan
Stimme,10W218,10,Marzahn-Hellersdorf,218,W,102M,2,85,O,1156,966,190,0,216,0,1,215,66,149,nan
Stimme,10W219,10,Marzahn-Hellersdorf,219,W,102N,2,85,O,1124,940,184,0,221,1,0,221,66,155,nan
Stimme,10W220,10,Marzahn-Hellersdorf,220,W,102P,2,85,O,1163,1045,118,0,212,2,0,212,66,146,nan
Stimme,10W221,10,Marzahn-Hellersdorf,221,W,102Q,2,85,O,1127,936,191,0,215,1,0,215,54,161,nan
Stimme,10W222,10,Marzahn-Hellersdorf,222,W,102R,2,85,O,1128,946,182,0,169,1,1,168,36,132,nan
Stimme,10W223,10,Marzahn-Hellersdorf,223,W,102R,2,85,O,1123,1030,93,0,160,0,0,160,49,111,nan
Stimme,10W224,10,Marzahn-Hellersdorf,224,W,102S,2,85,O,1067,952,115,0,156,3,0,156,28,128,nan
Stimme,10W225,10,Marzahn-Hellersdorf,225,W,102S,2,85,O,1197,1013,184,0,190,0,0,190,48,142,nan
Stimme,10W226,10,Marzahn-Hellersdorf,226,W,102T,2,85,O,1160,1045,115,0,156,0,1,155,37,118,nan
Stimme,10W227,10,Marzahn-Hellersdorf,227,W,102T,2,85,O,1141,978,163,0,119,0,1,118,30,88,nan
Stimme,10W301,10,Marzahn-Hellersdorf,301,W,103A,3,85,O,1475,1340,135,0,145,1,0,145,30,115,nan
Stimme,10W302,10,Marzahn-Hellersdorf,302,W,103A,3,85,O,1438,1343,95,0,151,2,0,151,40,111,nan
Stimme,10W303,10,Marzahn-Hellersdorf,303,W,103B,3,85,O,1496,1390,106,0,136,1,1,135,28,107,nan
Stimme,10W304,10,Marzahn-Hellersdorf,304,W,103C,3,85,O,1232,1137,95,0,60,0,2,58,12,46,nan
Stimme,10W305,10,Marzahn-Hellersdorf,305,W,103C,3,85,O,1369,1247,122,0,138,0,1,137,40,97,nan
Stimme,10W306,10,Marzahn-Hellersdorf,306,W,103D,3,85,O,1138,1034,104,0,93,0,0,93,32,61,nan
Stimme,10W307,10,Marzahn-Hellersdorf,307,W,103D,3,85,O,950,867,83,0,144,0,0,144,49,95,nan
Stimme,10W308,10,Marzahn-Hellersdorf,308,W,103E,3,85,O,1323,1177,146,0,184,0,0,184,47,137,nan
Stimme,10W309,10,Marzahn-Hellersdorf,309,W,103E,3,85,O,1363,1199,164,0,158,0,0,158,31,127,nan
Stimme,10W310,10,Marzahn-Hellersdorf,310,W,103F,3,85,O,1389,1272,117,0,186,0,0,186,47,139,nan
Stimme,10W311,10,Marzahn-Hellersdorf,311,W,103F,3,85,O,1315,1193,122,0,167,0,0,167,58,109,nan
Stimme,10W312,10,Marzahn-Hellersdorf,312,W,103B,3,85,O,1058,982,76,0,85,0,0,85,29,56,nan
Stimme,10W313,10,Marzahn-Hellersdorf,313,W,103G,3,85,O,1115,1008,107,0,131,0,1,130,38,92,nan
Stimme,10W314,10,Marzahn-Hellersdorf,314,W,103G,3,85,O,983,914,69,0,114,1,0,114,40,74,nan
Stimme,10W315,10,Marzahn-Hellersdorf,315,W,103H,3,85,O,1209,1067,142,0,178,0,0,178,44,134,nan
Stimme,10W316,10,Marzahn-Hellersdorf,316,W,103H,3,85,O,1245,1128,117,0,162,2,0,162,32,130,nan
Stimme,10W317,10,Marzahn-Hellersdorf,317,W,103J,3,85,O,1213,1111,102,0,125,0,1,124,33,91,nan
Stimme,10W318,10,Marzahn-Hellersdorf,318,W,103J,3,85,O,1179,1087,92,0,124,0,0,124,34,90,nan
Stimme,10W319,10,Marzahn-Hellersdorf,319,W,103K,3,85,O,1074,996,78,0,82,0,0,82,20,62,nan
Stimme,10W320,10,Marzahn-Hellersdorf,320,W,103L,3,85,O,1088,982,106,0,119,1,1,118,29,89,nan
Stimme,10W321,10,Marzahn-Hellersdorf,321,W,103L,3,85,O,1382,1179,203,0,179,0,0,179,55,124,nan
Stimme,10W322,10,Marzahn-Hellersdorf,322,W,103M,3,85,O,1348,1172,176,0,157,0,0,157,33,124,nan
Stimme,10W323,10,Marzahn-Hellersdorf,323,W,103M,3,85,O,1199,1024,175,0,130,0,1,129,30,99,nan
Stimme,10W324,10,Marzahn-Hellersdorf,324,W,103N,3,85,O,1347,1162,185,0,182,0,0,182,41,141,nan
Stimme,10W325,10,Marzahn-Hellersdorf,325,W,103N,3,85,O,1089,984,105,0,154,0,1,153,44,109,nan
Stimme,10W326,10,Marzahn-Hellersdorf,326,W,103P,3,85,O,1199,1016,183,0,234,5,0,234,61,173,nan
Stimme,10W327,10,Marzahn-Hellersdorf,327,W,103P,3,85,O,1165,988,177,0,214,2,0,214,63,151,nan
Stimme,10W401,10,Marzahn-Hellersdorf,401,W,104A,4,85,O,1185,1043,142,0,158,2,0,158,62,96,nan
Stimme,10W402,10,Marzahn-Hellersdorf,402,W,104B,4,85,O,1179,1008,171,0,139,0,0,139,57,82,nan
Stimme,10W403,10,Marzahn-Hellersdorf,403,W,104B,4,85,O,1177,1037,140,0,196,0,0,196,52,144,nan
Stimme,10W404,10,Marzahn-Hellersdorf,404,W,104C,4,85,O,1129,1009,120,0,178,2,1,177,50,127,nan
Stimme,10W405,10,Marzahn-Hellersdorf,405,W,104D,4,85,O,1171,1067,104,0,146,0,0,146,46,100,nan
Stimme,10W406,10,Marzahn-Hellersdorf,406,W,104E,4,85,O,1342,1171,171,0,209,1,0,209,64,145,nan
Stimme,10W407,10,Marzahn-Hellersdorf,407,W,104F,4,85,O,734,582,152,0,141,3,0,141,46,95,nan
Stimme,10W408,10,Marzahn-Hellersdorf,408,W,104F,4,85,O,733,575,158,0,149,0,0,149,47,102,nan
Stimme,10W409,10,Marzahn-Hellersdorf,409,W,104G,4,85,O,1296,1110,186,0,183,1,0,183,46,137,nan
Stimme,10W410,10,Marzahn-Hellersdorf,410,W,104H,4,85,O,1194,1038,156,0,160,1,0,160,52,108,nan
Stimme,10W411,10,Marzahn-Hellersdorf,411,W,104H,4,85,O,1109,959,150,0,213,0,0,213,71,142,nan
Stimme,10W412,10,Marzahn-Hellersdorf,412,W,104J,4,85,O,1221,960,261,0,278,1,1,277,58,219,nan
Stimme,10W413,10,Marzahn-Hellersdorf,413,W,104K,4,85,O,1242,918,324,0,271,1,0,271,96,175,nan
Stimme,10W414,10,Marzahn-Hellersdorf,414,W,104L,4,85,O,1068,877,191,0,254,1,2,252,51,201,nan
Stimme,10W415,10,Marzahn-Hellersdorf,415,W,104M,4,85,O,1075,946,129,0,99,0,0,99,35,64,nan
Stimme,10W416,10,Marzahn-Hellersdorf,416,W,104M,4,85,O,1234,1013,221,0,354,0,0,354,78,276,nan
Stimme,10W417,10,Marzahn-Hellersdorf,417,W,104N,4,85,O,1131,984,147,0,173,0,2,171,58,113,nan
Stimme,10W418,10,Marzahn-Hellersdorf,418,W,104N,4,85,O,1204,1066,138,0,164,0,0,164,56,108,nan
Stimme,10W419,10,Marzahn-Hellersdorf,419,W,104P,4,85,O,1233,929,304,0,202,1,0,202,70,132,nan
Stimme,10W420,10,Marzahn-Hellersdorf,420,W,104Q,4,85,O,1321,953,368,0,292,0,1,291,72,219,nan
Stimme,10W421,10,Marzahn-Hellersdorf,421,W,104R,4,85,O,1350,1061,289,0,331,6,0,331,114,217,nan
Stimme,10W422,10,Marzahn-Hellersdorf,422,W,104S,4,85,O,821,715,106,0,124,0,0,124,70,54,nan
Stimme,10W423,10,Marzahn-Hellersdorf,423,W,104T,4,85,O,1027,817,210,0,228,2,0,228,65,163,nan
Stimme,10W424,10,Marzahn-Hellersdorf,424,W,104T,4,85,O,733,557,176,0,220,6,0,220,76,144,nan
Stimme,10W425,10,Marzahn-Hellersdorf,425,W,104V,4,85,O,1166,874,292,0,245,3,0,245,82,163,nan
Stimme,10W426,10,Marzahn-Hellersdorf,426,W,104W,4,85,O,1073,799,274,0,336,3,1,335,106,229,nan
Stimme,10W427,10,Marzahn-Hellersdorf,427,W,104X,4,85,O,1137,841,296,0,295,4,0,295,105,190,nan
Stimme,10W428,10,Marzahn-Hellersdorf,428,W,104Y,4,85,O,1051,758,293,0,229,1,2,227,70,157,nan
Stimme,10W429,10,Marzahn-Hellersdorf,429,W,104ZA,4,85,O,1104,868,236,0,253,3,1,252,77,175,nan
Stimme,10W430,10,Marzahn-Hellersdorf,430,W,104ZB,4,85,O,1041,811,230,0,239,0,0,239,61,178,nan
Stimme,10W431,10,Marzahn-Hellersdorf,431,W,104ZC,4,85,O,1179,958,221,0,250,0,1,249,75,174,nan
Stimme,10W501,10,Marzahn-Hellersdorf,501,W,105A,5,85,O,1188,893,295,0,273,2,2,271,39,232,nan
Stimme,10W502,10,Marzahn-Hellersdorf,502,W,105B,5,85,O,1217,925,292,0,250,0,3,247,62,185,nan
Stimme,10W503,10,Marzahn-Hellersdorf,503,W,105C,5,85,O,1216,885,331,0,236,0,0,236,55,181,nan
Stimme,10W504,10,Marzahn-Hellersdorf,504,W,105D,5,85,O,1222,890,332,0,315,1,3,312,84,228,nan
Stimme,10W505,10,Marzahn-Hellersdorf,505,W,105E,5,85,O,1174,895,279,0,320,2,0,320,80,240,nan
Stimme,10W506,10,Marzahn-Hellersdorf,506,W,105F,5,85,O,1222,985,237,0,367,3,0,367,116,251,nan
Stimme,10W507,10,Marzahn-Hellersdorf,507,W,105G,5,85,O,1310,985,325,0,244,6,0,244,87,157,nan
Stimme,10W508,10,Marzahn-Hellersdorf,508,W,105H,5,85,O,1031,788,243,0,276,3,2,274,101,173,nan
Stimme,10W509,10,Marzahn-Hellersdorf,509,W,105J,5,85,O,1204,981,223,0,221,2,0,221,60,161,nan
Stimme,10W510,10,Marzahn-Hellersdorf,510,W,105K,5,85,O,980,705,275,0,202,1,0,202,67,135,nan
Stimme,10W511,10,Marzahn-Hellersdorf,511,W,105L,5,85,O,1137,879,258,0,258,6,0,258,95,163,nan
Stimme,10W512,10,Marzahn-Hellersdorf,512,W,105M,5,85,O,1137,938,199,0,284,4,1,283,82,201,nan
Stimme,10W513,10,Marzahn-Hellersdorf,513,W,105N,5,85,O,1159,883,276,0,257,0,0,257,63,194,nan
Stimme,10W514,10,Marzahn-Hellersdorf,514,W,105P,5,85,O,1090,783,307,0,218,3,0,218,73,145,nan
Stimme,10W515,10,Marzahn-Hellersdorf,515,W,105Q,5,85,O,1052,801,251,0,248,1,1,247,44,203,nan
Stimme,10W516,10,Marzahn-Hellersdorf,516,W,105R,5,85,O,1084,823,261,0,280,2,0,280,49,231,nan
Stimme,10W517,10,Marzahn-Hellersdorf,517,W,105S,5,85,O,1068,809,259,0,261,1,0,261,57,204,nan
Stimme,10W518,10,Marzahn-Hellersdorf,518,W,105T,5,85,O,1058,819,239,0,261,2,0,261,61,200,nan
Stimme,10W519,10,Marzahn-Hellersdorf,519,W,105V,5,85,O,1063,833,230,0,287,2,0,287,62,225,nan
Stimme,10W520,10,Marzahn-Hellersdorf,520,W,105W,5,85,O,1137,860,277,0,291,2,2,289,61,228,nan
Stimme,10W521,10,Marzahn-Hellersdorf,521,W,105X,5,85,O,1085,812,273,0,202,0,2,200,39,161,nan
Stimme,10W522,10,Marzahn-Hellersdorf,522,W,105Y,5,85,O,1048,779,269,0,222,4,0,222,37,185,nan
Stimme,10W523,10,Marzahn-Hellersdorf,523,W,105ZA,5,85,O,1053,766,287,0,220,1,1,219,81,138,nan
Stimme,10W524,10,Marzahn-Hellersdorf,524,W,105ZB,5,85,O,1038,779,259,0,288,4,0,288,54,234,nan
Stimme,10W525,10,Marzahn-Hellersdorf,525,W,105ZC,5,85,O,1053,801,252,0,307,6,1,306,50,256,nan
Stimme,10W526,10,Marzahn-Hellersdorf,526,W,105ZD,5,85,O,1033,803,230,0,286,1,1,285,71,214,nan
Stimme,10W527,10,Marzahn-Hellersdorf,527,W,105ZE,5,85,O,1141,856,285,0,296,4,0,296,93,203,nan
Stimme,10W528,10,Marzahn-Hellersdorf,528,W,105ZF,5,85,O,1155,880,275,0,268,0,0,268,68,200,nan
Stimme,10W529,10,Marzahn-Hellersdorf,529,W,105ZG,5,85,O,1070,819,251,0,228,2,0,228,53,175,nan
Stimme,10W530,10,Marzahn-Hellersdorf,530,W,105ZH,5,85,O,1228,948,280,0,248,0,0,248,76,172,nan
Stimme,10W601,10,Marzahn-Hellersdorf,601,W,106A,6,85,O,1283,1162,121,0,141,0,1,140,26,114,nan
Stimme,10W602,10,Marzahn-Hellersdorf,602,W,106A,6,85,O,1296,1170,126,0,167,0,0,167,43,124,nan
Stimme,10W603,10,Marzahn-Hellersdorf,603,W,106B,6,85,O,1249,1140,109,0,138,0,2,136,38,98,nan
Stimme,10W604,10,Marzahn-Hellersdorf,604,W,106B,6,85,O,1353,1180,173,0,186,0,1,185,45,140,nan
Stimme,10W605,10,Marzahn-Hellersdorf,605,W,106C,6,85,O,1384,1208,176,0,220,4,1,219,60,159,nan
Stimme,10W606,10,Marzahn-Hellersdorf,606,W,106C,6,85,O,1234,1101,133,0,166,0,0,166,56,110,nan
Stimme,10W607,10,Marzahn-Hellersdorf,607,W,106D,6,85,O,1242,1067,175,0,180,0,0,180,51,129,nan
Stimme,10W608,10,Marzahn-Hellersdorf,608,W,106D,6,85,O,1274,1122,152,0,144,0,0,144,37,107,nan
Stimme,10W609,10,Marzahn-Hellersdorf,609,W,106E,6,85,O,1232,1154,78,0,187,0,0,187,54,133,nan
Stimme,10W610,10,Marzahn-Hellersdorf,610,W,106E,6,85,O,1121,1007,114,0,154,0,0,154,46,108,nan
Stimme,10W611,10,Marzahn-Hellersdorf,611,W,106F,6,85,O,1112,961,151,0,172,0,1,171,41,130,nan
Stimme,10W612,10,Marzahn-Hellersdorf,612,W,106F,6,85,O,896,774,122,0,106,0,0,106,35,71,nan
Stimme,10W613,10,Marzahn-Hellersdorf,613,W,106G,6,85,O,1249,1055,194,0,183,3,0,183,59,124,nan
Stimme,10W614,10,Marzahn-Hellersdorf,614,W,106G,6,85,O,1266,1108,158,0,130,0,0,130,37,93,nan
Stimme,10W615,10,Marzahn-Hellersdorf,615,W,106H,6,85,O,1231,1039,192,0,264,1,2,262,72,190,nan
Stimme,10W616,10,Marzahn-Hellersdorf,616,W,106J,6,85,O,1107,911,196,0,287,4,1,286,88,198,nan
Stimme,10W617,10,Marzahn-Hellersdorf,617,W,106K,6,85,O,1124,866,258,0,304,4,0,304,77,227,nan
Stimme,10W618,10,Marzahn-Hellersdorf,618,W,106K,6,85,O,1114,940,174,0,208,1,1,207,56,151,nan
Stimme,10W619,10,Marzahn-Hellersdorf,619,W,106L,6,85,O,1088,866,222,0,244,0,2,242,67,175,nan
Stimme,10W620,10,Marzahn-Hellersdorf,620,W,106M,6,85,O,1111,827,284,0,290,0,0,290,70,220,nan
Stimme,10W621,10,Marzahn-Hellersdorf,621,W,106N,6,85,O,1142,1048,94,0,178,0,0,178,28,150,nan
Stimme,10W622,10,Marzahn-Hellersdorf,622,W,106N,6,85,O,1170,1063,107,0,160,0,2,158,29,129,nan
Stimme,10W623,10,Marzahn-Hellersdorf,623,W,106P,6,85,O,1188,1065,123,0,129,0,0,129,27,102,nan
Stimme,10W624,10,Marzahn-Hellersdorf,624,W,106P,6,85,O,990,907,83,0,65,0,0,65,15,50,nan
Stimme,10W625,10,Marzahn-Hellersdorf,625,W,106Q,6,85,O,1145,1036,109,0,123,0,1,122,37,85,nan
Stimme,10W626,10,Marzahn-Hellersdorf,626,W,106Q,6,85,O,1243,1124,119,0,202,0,0,202,48,154,nan
Stimme,10B1A,10,Marzahn-Hellersdorf,1A,B,101A,1,85,O,0,0,0,0,379,379,0,379,122,257,nan
Stimme,10B1B,10,Marzahn-Hellersdorf,1B,B,101B,1,85,O,0,0,0,0,0,0,0,0,0,0,10B1A
Stimme,10B1C,10,Marzahn-Hellersdorf,1C,B,101C,1,85,O,0,0,0,0,376,376,0,376,93,283,nan
Stimme,10B1D,10,Marzahn-Hellersdorf,1D,B,101D,1,85,O,0,0,0,0,0,0,0,0,0,0,10B1C
Stimme,10B1E,10,Marzahn-Hellersdorf,1E,B,101E,1,85,O,0,0,0,0,538,538,2,536,164,372,nan
Stimme,10B1F,10,Marzahn-Hellersdorf,1F,B,101F,1,85,O,0,0,0,0,0,0,0,0,0,0,10B1E
Stimme,10B1G,10,Marzahn-Hellersdorf,1G,B,101G,1,85,O,0,0,0,0,359,359,0,359,109,250,nan
Stimme,10B1H,10,Marzahn-Hellersdorf,1H,B,101H,1,85,O,0,0,0,0,0,0,0,0,0,0,10B1G
Stimme,10B1J,10,Marzahn-Hellersdorf,1J,B,101J,1,85,O,0,0,0,0,460,460,2,458,160,298,nan
Stimme,10B1K,10,Marzahn-Hellersdorf,1K,B,101K,1,85,O,0,0,0,0,0,0,0,0,0,0,10B1J
Stimme,10B1L,10,Marzahn-Hellersdorf,1L,B,101L,1,85,O,0,0,0,0,415,415,1,414,109,305,nan
Stimme,10B1M,10,Marzahn-Hellersdorf,1M,B,101M,1,85,O,0,0,0,0,0,0,0,0,0,0,10B1L
Stimme,10B2A,10,Marzahn-Hellersdorf,2A,B,102A,2,85,O,0,0,0,0,558,558,1,557,188,369,nan
Stimme,10B2B,10,Marzahn-Hellersdorf,2B,B,102B,2,85,O,0,0,0,0,0,0,0,0,0,0,10B2A
Stimme,10B2C,10,Marzahn-Hellersdorf,2C,B,102C,2,85,O,0,0,0,0,376,376,0,376,123,253,nan
Stimme,10B2D,10,Marzahn-Hellersdorf,2D,B,102D,2,85,O,0,0,0,0,0,0,0,0,0,0,10B2C
Stimme,10B2E,10,Marzahn-Hellersdorf,2E,B,102E,2,85,O,0,0,0,0,329,329,0,329,85,244,nan
Stimme,10B2F,10,Marzahn-Hellersdorf,2F,B,102F,2,85,O,0,0,0,0,0,0,0,0,0,0,10B2E
Stimme,10B2G,10,Marzahn-Hellersdorf,2G,B,102G,2,85,O,0,0,0,0,424,424,1,423,138,285,nan
Stimme,10B2H,10,Marzahn-Hellersdorf,2H,B,102H,2,85,O,0,0,0,0,0,0,0,0,0,0,10B2G
Stimme,10B2J,10,Marzahn-Hellersdorf,2J,B,102J,2,85,O,0,0,0,0,322,322,0,322,119,203,nan
Stimme,10B2K,10,Marzahn-Hellersdorf,2K,B,102K,2,85,O,0,0,0,0,0,0,0,0,0,0,10B2J
Stimme,10B2L,10,Marzahn-Hellersdorf,2L,B,102L,2,85,O,0,0,0,0,436,436,0,436,122,314,nan
Stimme,10B2M,10,Marzahn-Hellersdorf,2M,B,102M,2,85,O,0,0,0,0,0,0,0,0,0,0,10B2L
Stimme,10B2N,10,Marzahn-Hellersdorf,2N,B,102N,2,85,O,0,0,0,0,295,295,1,294,86,208,nan
Stimme,10B2P,10,Marzahn-Hellersdorf,2P,B,102P,2,85,O,0,0,0,0,0,0,0,0,0,0,10B2N
Stimme,10B2Q,10,Marzahn-Hellersdorf,2Q,B,102Q,2,85,O,0,0,0,0,414,414,2,412,130,282,nan
Stimme,10B2R,10,Marzahn-Hellersdorf,2R,B,102R,2,85,O,0,0,0,0,0,0,0,0,0,0,10B2Q
Stimme,10B2S,10,Marzahn-Hellersdorf,2S,B,102S,2,85,O,0,0,0,0,504,504,0,504,139,365,nan
Stimme,10B2T,10,Marzahn-Hellersdorf,2T,B,102T,2,85,O,0,0,0,0,0,0,0,0,0,0,10B2S
Stimme,10B3A,10,Marzahn-Hellersdorf,3A,B,103A,3,85,O,0,0,0,0,337,337,4,333,101,232,nan
Stimme,10B3B,10,Marzahn-Hellersdorf,3B,B,103B,3,85,O,0,0,0,0,0,0,0,0,0,0,10B3A
Stimme,10B3C,10,Marzahn-Hellersdorf,3C,B,103C,3,85,O,0,0,0,0,317,317,1,316,126,190,nan
Stimme,10B3D,10,Marzahn-Hellersdorf,3D,B,103D,3,85,O,0,0,0,0,0,0,0,0,0,0,10B3C
Stimme,10B3E,10,Marzahn-Hellersdorf,3E,B,103E,3,85,O,0,0,0,0,486,486,1,485,175,310,nan
Stimme,10B3F,10,Marzahn-Hellersdorf,3F,B,103F,3,85,O,0,0,0,0,0,0,0,0,0,0,10B3E
Stimme,10B3G,10,Marzahn-Hellersdorf,3G,B,103G,3,85,O,0,0,0,0,382,382,1,381,119,262,nan
Stimme,10B3H,10,Marzahn-Hellersdorf,3H,B,103H,3,85,O,0,0,0,0,0,0,0,0,0,0,10B3G
Stimme,10B3J,10,Marzahn-Hellersdorf,3J,B,103J,3,85,O,0,0,0,0,246,246,0,246,75,171,nan
Stimme,10B3K,10,Marzahn-Hellersdorf,3K,B,103K,3,85,O,0,0,0,0,0,0,0,0,0,0,10B3J
Stimme,10B3L,10,Marzahn-Hellersdorf,3L,B,103L,3,85,O,0,0,0,0,554,554,3,551,197,354,nan
Stimme,10B3M,10,Marzahn-Hellersdorf,3M,B,103M,3,85,O,0,0,0,0,0,0,0,0,0,0,10B3L
Stimme,10B3N,10,Marzahn-Hellersdorf,3N,B,103N,3,85,O,0,0,0,0,564,564,2,562,158,404,nan
Stimme,10B3P,10,Marzahn-Hellersdorf,3P,B,103P,3,85,O,0,0,0,0,0,0,0,0,0,0,10B3N
Stimme,10B4A,10,Marzahn-Hellersdorf,4A,B,104A,4,85,O,0,0,0,0,392,392,0,392,156,236,nan
Stimme,10B4B,10,Marzahn-Hellersdorf,4B,B,104B,4,85,O,0,0,0,0,0,0,0,0,0,0,10B4A
Stimme,10B4C,10,Marzahn-Hellersdorf,4C,B,104C,4,85,O,0,0,0,0,192,192,1,191,72,119,nan
Stimme,10B4D,10,Marzahn-Hellersdorf,4D,B,104D,4,85,O,0,0,0,0,0,0,0,0,0,0,10B4C
Stimme,10B4E,10,Marzahn-Hellersdorf,4E,B,104E,4,85,O,0,0,0,0,425,425,0,425,111,314,nan
Stimme,10B4F,10,Marzahn-Hellersdorf,4F,B,104F,4,85,O,0,0,0,0,0,0,0,0,0,0,10B4E
Stimme,10B4G,10,Marzahn-Hellersdorf,4G,B,104G,4,85,O,0,0,0,0,428,428,0,428,149,279,nan
Stimme,10B4H,10,Marzahn-Hellersdorf,4H,B,104H,4,85,O,0,0,0,0,0,0,0,0,0,0,10B4G
Stimme,10B4J,10,Marzahn-Hellersdorf,4J,B,104J,4,85,O,0,0,0,0,538,538,0,538,145,393,nan
Stimme,10B4K,10,Marzahn-Hellersdorf,4K,B,104K,4,85,O,0,0,0,0,0,0,0,0,0,0,10B4J
Stimme,10B4L,10,Marzahn-Hellersdorf,4L,B,104L,4,85,O,0,0,0,0,474,474,1,473,141,332,nan
Stimme,10B4M,10,Marzahn-Hellersdorf,4M,B,104M,4,85,O,0,0,0,0,0,0,0,0,0,0,10B4L
Stimme,10B4N,10,Marzahn-Hellersdorf,4N,B,104N,4,85,O,0,0,0,0,530,530,0,530,158,372,nan
Stimme,10B4P,10,Marzahn-Hellersdorf,4P,B,104P,4,85,O,0,0,0,0,0,0,0,0,0,0,10B4N
Stimme,10B4Q,10,Marzahn-Hellersdorf,4Q,B,104Q,4,85,O,0,0,0,0,582,582,3,579,176,403,nan
Stimme,10B4R,10,Marzahn-Hellersdorf,4R,B,104R,4,85,O,0,0,0,0,0,0,0,0,0,0,10B4Q
Stimme,10B4S,10,Marzahn-Hellersdorf,4S,B,104S,4,85,O,0,0,0,0,425,425,0,425,149,276,nan
Stimme,10B4T,10,Marzahn-Hellersdorf,4T,B,104T,4,85,O,0,0,0,0,0,0,0,0,0,0,10B4S
Stimme,10B4V,10,Marzahn-Hellersdorf,4V,B,104V,4,85,O,0,0,0,0,508,508,0,508,165,343,nan
Stimme,10B4W,10,Marzahn-Hellersdorf,4W,B,104W,4,85,O,0,0,0,0,0,0,0,0,0,0,10B4V
Stimme,10B4X,10,Marzahn-Hellersdorf,4X,B,104X,4,85,O,0,0,0,0,532,532,0,532,140,392,nan
Stimme,10B4Y,10,Marzahn-Hellersdorf,4Y,B,104Y,4,85,O,0,0,0,0,0,0,0,0,0,0,10B4X
Stimme,10B4ZA,10,Marzahn-Hellersdorf,4ZA,B,104ZA,4,85,O,0,0,0,0,414,414,1,413,127,286,nan
Stimme,10B4ZB,10,Marzahn-Hellersdorf,4ZB,B,104ZB,4,85,O,0,0,0,0,0,0,0,0,0,0,10B4ZA
Stimme,10B4ZC,10,Marzahn-Hellersdorf,4ZC,B,104ZC,4,85,O,0,0,0,0,193,193,0,193,58,135,nan
Stimme,10B5A,10,Marzahn-Hellersdorf,5A,B,105A,5,85,O,0,0,0,0,551,551,3,548,158,390,nan
Stimme,10B5B,10,Marzahn-Hellersdorf,5B,B,105B,5,85,O,0,0,0,0,0,0,0,0,0,0,10B5A
Stimme,10B5C,10,Marzahn-Hellersdorf,5C,B,105C,5,85,O,0,0,0,0,612,612,0,612,154,458,nan
Stimme,10B5D,10,Marzahn-Hellersdorf,5D,B,105D,5,85,O,0,0,0,0,0,0,0,0,0,0,10B5C
Stimme,10B5E,10,Marzahn-Hellersdorf,5E,B,105E,5,85,O,0,0,0,0,461,461,0,461,153,308,nan
Stimme,10B5F,10,Marzahn-Hellersdorf,5F,B,105F,5,85,O,0,0,0,0,0,0,0,0,0,0,10B5E
Stimme,10B5G,10,Marzahn-Hellersdorf,5G,B,105G,5,85,O,0,0,0,0,502,502,1,501,179,322,nan
Stimme,10B5H,10,Marzahn-Hellersdorf,5H,B,105H,5,85,O,0,0,0,0,0,0,0,0,0,0,10B5G
Stimme,10B5J,10,Marzahn-Hellersdorf,5J,B,105J,5,85,O,0,0,0,0,438,438,1,437,128,309,nan
Stimme,10B5K,10,Marzahn-Hellersdorf,5K,B,105K,5,85,O,0,0,0,0,0,0,0,0,0,0,10B5J
Stimme,10B5L,10,Marzahn-Hellersdorf,5L,B,105L,5,85,O,0,0,0,0,391,391,0,391,116,275,nan
Stimme,10B5M,10,Marzahn-Hellersdorf,5M,B,105M,5,85,O,0,0,0,0,0,0,0,0,0,0,10B5L
Stimme,10B5N,10,Marzahn-Hellersdorf,5N,B,105N,5,85,O,0,0,0,0,513,513,0,513,170,343,nan
Stimme,10B5P,10,Marzahn-Hellersdorf,5P,B,105P,5,85,O,0,0,0,0,0,0,0,0,0,0,10B5N
Stimme,10B5Q,10,Marzahn-Hellersdorf,5Q,B,105Q,5,85,O,0,0,0,0,467,467,0,467,119,348,nan
Stimme,10B5R,10,Marzahn-Hellersdorf,5R,B,105R,5,85,O,0,0,0,0,0,0,0,0,0,0,10B5Q
Stimme,10B5S,10,Marzahn-Hellersdorf,5S,B,105S,5,85,O,0,0,0,0,435,435,1,434,100,334,nan
Stimme,10B5T,10,Marzahn-Hellersdorf,5T,B,105T,5,85,O,0,0,0,0,0,0,0,0,0,0,10B5S
Stimme,10B5V,10,Marzahn-Hellersdorf,5V,B,105V,5,85,O,0,0,0,0,462,462,0,462,111,351,nan
Stimme,10B5W,10,Marzahn-Hellersdorf,5W,B,105W,5,85,O,0,0,0,0,0,0,0,0,0,0,10B5V
Stimme,10B5X,10,Marzahn-Hellersdorf,5X,B,105X,5,85,O,0,0,0,0,485,485,0,485,126,359,nan
Stimme,10B5Y,10,Marzahn-Hellersdorf,5Y,B,105Y,5,85,O,0,0,0,0,0,0,0,0,0,0,10B5X
Stimme,10B5ZA,10,Marzahn-Hellersdorf,5ZA,B,105ZA,5,85,O,0,0,0,0,498,498,0,498,127,371,nan
Stimme,10B5ZB,10,Marzahn-Hellersdorf,5ZB,B,105ZB,5,85,O,0,0,0,0,0,0,0,0,0,0,10B5ZA
Stimme,10B5ZC,10,Marzahn-Hellersdorf,5ZC,B,105ZC,5,85,O,0,0,0,0,436,436,0,436,95,341,nan
Stimme,10B5ZD,10,Marzahn-Hellersdorf,5ZD,B,105ZD,5,85,O,0,0,0,0,0,0,0,0,0,0,10B5ZC
Stimme,10B5ZE,10,Marzahn-Hellersdorf,5ZE,B,105ZE,5,85,O,0,0,0,0,501,501,0,501,148,353,nan
Stimme,10B5ZF,10,Marzahn-Hellersdorf,5ZF,B,105ZF,5,85,O,0,0,0,0,0,0,0,0,0,0,10B5ZE
Stimme,10B5ZG,10,Marzahn-Hellersdorf,5ZG,B,105ZG,5,85,O,0,0,0,0,463,463,1,462,129,333,nan
Stimme,10B5ZH,10,Marzahn-Hellersdorf,5ZH,B,105ZH,5,85,O,0,0,0,0,0,0,0,0,0,0,10B5ZG
Stimme,10B6A,10,Marzahn-Hellersdorf,6A,B,106A,6,85,O,0,0,0,0,445,445,0,445,149,296,nan
Stimme,10B6B,10,Marzahn-Hellersdorf,6B,B,106B,6,85,O,0,0,0,0,0,0,0,0,0,0,10B6A
Stimme,10B6C,10,Marzahn-Hellersdorf,6C,B,106C,6,85,O,0,0,0,0,549,549,0,549,170,379,nan
Stimme,10B6D,10,Marzahn-Hellersdorf,6D,B,106D,6,85,O,0,0,0,0,0,0,0,0,0,0,10B6C
Stimme,10B6E,10,Marzahn-Hellersdorf,6E,B,106E,6,85,O,0,0,0,0,405,405,2,403,141,262,nan
Stimme,10B6F,10,Marzahn-Hellersdorf,6F,B,106F,6,85,O,0,0,0,0,0,0,0,0,0,0,10B6E
Stimme,10B6G,10,Marzahn-Hellersdorf,6G,B,106G,6,85,O,0,0,0,0,473,473,1,472,159,313,nan
Stimme,10B6H,10,Marzahn-Hellersdorf,6H,B,106H,6,85,O,0,0,0,0,0,0,0,0,0,0,10B6G
Stimme,10B6J,10,Marzahn-Hellersdorf,6J,B,106J,6,85,O,0,0,0,0,537,537,1,536,182,354,nan
Stimme,10B6K,10,Marzahn-Hellersdorf,6K,B,106K,6,85,O,0,0,0,0,0,0,0,0,0,0,10B6J
Stimme,10B6L,10,Marzahn-Hellersdorf,6L,B,106L,6,85,O,0,0,0,0,465,465,0,465,122,343,nan
Stimme,10B6M,10,Marzahn-Hellersdorf,6M,B,106M,6,85,O,0,0,0,0,0,0,0,0,0,0,10B6L
Stimme,10B6N,10,Marzahn-Hellersdorf,6N,B,106N,6,85,O,0,0,0,0,348,348,0,348,108,240,nan
Stimme,10B6P,10,Marzahn-Hellersdorf,6P,B,106P,6,85,O,0,0,0,0,0,0,0,0,0,0,10B6N
Stimme,10B6Q,10,Marzahn-Hellersdorf,6Q,B,106Q,6,85,O,0,0,0,0,206,206,1,205,67,138,nan
Stimme,11W101,11,Lichtenberg,101,W,111A,1,86,O,1024,863,161,0,177,0,0,177,38,139,nan
Stimme,11W102,11,Lichtenberg,102,W,111A,1,86,O,1118,913,205,0,289,2,1,288,61,227,nan
Stimme,11W103,11,Lichtenberg,103,W,111C,1,86,O,1464,1189,275,0,324,2,0,324,89,235,nan
Stimme,11W104,11,Lichtenberg,104,W,111B,1,86,O,989,906,83,0,198,1,0,198,42,156,nan
Stimme,11W105,11,Lichtenberg,105,W,111B,1,86,O,828,636,192,0,209,3,0,209,52,157,nan
Stimme,11W106,11,Lichtenberg,106,W,111D,1,86,O,1001,893,108,0,142,0,0,142,37,105,nan
Stimme,11W107,11,Lichtenberg,107,W,111E,1,86,O,927,859,68,0,118,0,0,118,32,86,nan
Stimme,11W108,11,Lichtenberg,108,W,111E,1,86,O,988,889,99,0,71,0,0,71,13,58,nan
Stimme,11W109,11,Lichtenberg,109,W,111D,1,86,O,1086,891,195,0,171,1,0,171,30,141,nan
Stimme,11W110,11,Lichtenberg,110,W,111I,1,86,O,920,843,77,0,88,0,0,88,17,71,nan
Stimme,11W111,11,Lichtenberg,111,W,111F,1,86,O,1106,945,161,0,158,2,0,158,36,122,nan
Stimme,11W112,11,Lichtenberg,112,W,111F,1,86,O,892,759,133,0,150,0,1,149,32,117,nan
Stimme,11W113,11,Lichtenberg,113,W,111I,1,86,O,963,852,111,0,156,0,0,156,45,111,nan
Stimme,11W114,11,Lichtenberg,114,W,111K,1,86,O,649,597,52,0,70,0,0,70,11,59,nan
Stimme,11W115,11,Lichtenberg,115,W,111K,1,86,O,675,580,95,0,108,0,0,108,25,83,nan
Stimme,11W116,11,Lichtenberg,116,W,111L,1,86,O,855,752,103,0,163,0,1,162,48,114,nan
Stimme,11W117,11,Lichtenberg,117,W,111G,1,86,O,861,776,85,0,136,0,0,136,33,103,nan
Stimme,11W118,11,Lichtenberg,118,W,111H,1,86,O,922,782,140,0,147,0,0,147,34,113,nan
Stimme,11W119,11,Lichtenberg,119,W,111H,1,86,O,926,839,87,0,116,1,1,115,36,79,nan
Stimme,11W120,11,Lichtenberg,120,W,111L,1,86,O,827,749,78,0,93,0,0,93,24,69,nan
Stimme,11W121,11,Lichtenberg,121,W,111Q,1,86,O,780,718,62,0,126,0,0,126,37,89,nan
Stimme,11W122,11,Lichtenberg,122,W,111R,1,86,O,930,864,66,0,112,0,3,109,31,78,nan
Stimme,11W123,11,Lichtenberg,123,W,111R,1,86,O,913,831,82,0,116,2,1,115,27,88,nan
Stimme,11W124,11,Lichtenberg,124,W,111C,1,86,O,1097,988,109,0,228,2,2,226,59,167,nan
Stimme,11W125,11,Lichtenberg,125,W,111G,1,86,O,1015,935,80,0,89,0,1,88,19,69,nan
Stimme,11W126,11,Lichtenberg,126,W,111N,1,86,O,857,720,137,0,128,0,0,128,24,104,nan
Stimme,11W127,11,Lichtenberg,127,W,111P,1,86,O,941,824,117,0,156,2,0,156,32,124,nan
Stimme,11W128,11,Lichtenberg,128,W,111Q,1,86,O,845,775,70,0,65,0,0,65,18,47,nan
Stimme,11W129,11,Lichtenberg,129,W,111S,1,86,O,999,888,111,0,88,0,0,88,16,72,nan
Stimme,11W130,11,Lichtenberg,130,W,111T,1,86,O,881,808,73,0,122,0,1,121,27,94,nan
Stimme,11W131,11,Lichtenberg,131,W,111M,1,86,O,769,693,76,0,140,0,0,140,48,92,nan
Stimme,11W132,11,Lichtenberg,132,W,111M,1,86,O,930,794,136,0,160,0,0,160,45,115,nan
Stimme,11W133,11,Lichtenberg,133,W,111N,1,86,O,837,680,157,0,163,0,1,162,45,117,nan
Stimme,11W134,11,Lichtenberg,134,W,111S,1,86,O,768,701,67,0,92,0,0,92,13,79,nan
Stimme,11W135,11,Lichtenberg,135,W,111P,1,86,O,1193,1064,129,0,187,1,0,187,46,141,nan
Stimme,11W136,11,Lichtenberg,136,W,111T,1,86,O,804,733,71,0,119,0,1,118,19,99,nan
Stimme,11W201,11,Lichtenberg,201,W,112A,2,86,O,904,744,160,0,130,0,1,129,34,95,nan
Stimme,11W202,11,Lichtenberg,202,W,112A,2,86,O,998,884,114,0,134,1,0,134,28,106,nan
Stimme,11W203,11,Lichtenberg,203,W,112B,2,86,O,1021,886,135,0,122,0,1,121,25,96,nan
Stimme,11W204,11,Lichtenberg,204,W,112B,2,86,O,878,779,99,0,89,0,0,89,21,68,nan
Stimme,11W205,11,Lichtenberg,205,W,112C,2,86,O,986,890,96,0,158,0,0,158,37,121,nan
Stimme,11W206,11,Lichtenberg,206,W,112C,2,86,O,929,848,81,0,124,0,0,124,33,91,nan
Stimme,11W207,11,Lichtenberg,207,W,112D,2,86,O,839,760,79,0,95,0,0,95,15,80,nan
Stimme,11W208,11,Lichtenberg,208,W,112D,2,86,O,1107,837,270,0,243,8,0,243,72,171,nan
Stimme,11W209,11,Lichtenberg,209,W,112E,2,86,O,1043,788,255,0,273,3,2,271,73,198,nan
Stimme,11W210,11,Lichtenberg,210,W,112F,2,86,O,939,801,138,0,164,0,0,164,32,132,nan
Stimme,11W211,11,Lichtenberg,211,W,112E,2,86,O,911,763,148,0,246,2,0,246,79,167,nan
Stimme,11W212,11,Lichtenberg,212,W,112I,2,86,O,849,660,189,0,212,5,0,212,58,154,nan
Stimme,11W213,11,Lichtenberg,213,W,112F,2,86,O,742,621,121,0,99,1,0,99,48,51,nan
Stimme,11W214,11,Lichtenberg,214,W,112G,2,86,O,873,786,87,0,85,0,0,85,30,55,nan
Stimme,11W215,11,Lichtenberg,215,W,112G,2,86,O,966,757,209,0,191,0,0,191,33,158,nan
Stimme,11W216,11,Lichtenberg,216,W,112H,2,86,O,1096,850,246,0,279,0,1,278,86,192,nan
Stimme,11W217,11,Lichtenberg,217,W,112H,2,86,O,1003,849,154,0,243,1,0,243,70,173,nan
Stimme,11W218,11,Lichtenberg,218,W,112I,2,86,O,777,681,96,0,123,0,0,123,33,90,nan
Stimme,11W219,11,Lichtenberg,219,W,112K,2,86,O,894,792,102,0,122,0,1,121,29,92,nan
Stimme,11W220,11,Lichtenberg,220,W,112K,2,86,O,921,775,146,0,225,3,0,225,53,172,nan
Stimme,11W221,11,Lichtenberg,221,W,112L,2,86,O,1028,799,229,0,153,1,0,153,54,99,nan
Stimme,11W222,11,Lichtenberg,222,W,112L,2,86,O,1016,880,136,0,208,4,1,207,90,117,nan
Stimme,11W223,11,Lichtenberg,223,W,112M,2,86,O,858,721,137,0,150,1,0,150,49,101,nan
Stimme,11W224,11,Lichtenberg,224,W,112N,2,86,O,866,718,148,0,217,2,2,215,83,132,nan
Stimme,11W225,11,Lichtenberg,225,W,112P,2,86,O,887,764,123,0,183,1,0,183,59,124,nan
Stimme,11W226,11,Lichtenberg,226,W,112Q,2,86,O,1116,970,146,0,244,1,0,244,95,149,nan
Stimme,11W227,11,Lichtenberg,227,W,112P,2,86,O,947,795,152,0,149,1,0,149,57,92,nan
Stimme,11W228,11,Lichtenberg,228,W,112M,2,86,O,968,750,218,0,186,3,2,184,50,134,nan
Stimme,11W229,11,Lichtenberg,229,W,112N,2,86,O,1039,826,213,0,258,4,0,258,151,107,nan
Stimme,11W230,11,Lichtenberg,230,W,112Q,2,86,O,870,704,166,0,164,0,0,164,53,111,nan
Stimme,11W231,11,Lichtenberg,231,W,112R,2,86,O,1086,964,122,0,176,2,0,176,64,112,nan
Stimme,11W232,11,Lichtenberg,232,W,112R,2,86,O,1524,1322,202,0,239,4,1,238,89,149,nan
Stimme,11W233,11,Lichtenberg,233,W,112S,2,86,O,933,787,146,0,154,2,0,154,45,109,nan
Stimme,11W234,11,Lichtenberg,234,W,112S,2,86,O,846,684,162,0,124,1,2,122,40,82,nan
Stimme,11W301,11,Lichtenberg,301,W,113A,3,86,O,1050,932,118,0,149,1,1,148,64,84,nan
Stimme,11W302,11,Lichtenberg,302,W,113F,3,86,O,1018,873,145,0,132,1,0,132,66,66,nan
Stimme,11W303,11,Lichtenberg,303,W,113A,3,86,O,935,821,114,0,135,1,1,134,49,85,nan
Stimme,11W304,11,Lichtenberg,304,W,113A,3,86,O,912,825,87,0,108,1,1,107,50,57,nan
Stimme,11W305,11,Lichtenberg,305,W,113B,3,86,O,967,842,125,0,174,0,2,172,69,103,nan
Stimme,11W306,11,Lichtenberg,306,W,113B,3,86,O,1035,830,205,0,167,1,0,167,75,92,nan
Stimme,11W307,11,Lichtenberg,307,W,113C,3,86,O,997,856,141,0,199,1,1,198,85,113,nan
Stimme,11W308,11,Lichtenberg,308,W,113C,3,86,O,966,843,123,0,141,0,0,141,62,79,nan
Stimme,11W309,11,Lichtenberg,309,W,113D,3,86,O,954,821,133,0,147,3,0,147,53,94,nan
Stimme,11W310,11,Lichtenberg,310,W,113D,3,86,O,1035,932,103,0,120,0,1,119,48,71,nan
Stimme,11W311,11,Lichtenberg,311,W,113E,3,86,O,1190,1060,130,0,193,0,2,191,53,138,nan
Stimme,11W312,11,Lichtenberg,312,W,113E,3,86,O,1164,1044,120,0,179,0,0,179,52,127,nan
Stimme,11W313,11,Lichtenberg,313,W,113F,3,86,O,1194,978,216,0,136,2,0,136,66,70,nan
Stimme,11W314,11,Lichtenberg,314,W,113G,3,86,O,977,833,144,0,111,3,0,111,32,79,nan
Stimme,11W315,11,Lichtenberg,315,W,113G,3,86,O,934,801,133,0,118,2,0,118,38,80,nan
Stimme,11W316,11,Lichtenberg,316,W,113H,3,86,O,861,781,80,0,168,0,3,165,75,90,nan
Stimme,11W317,11,Lichtenberg,317,W,113H,3,86,O,880,771,109,0,129,0,0,129,50,79,nan
Stimme,11W318,11,Lichtenberg,318,W,113L,3,86,O,988,878,110,0,103,1,0,103,52,51,nan
Stimme,11W319,11,Lichtenberg,319,W,113L,3,86,O,813,698,115,0,79,1,0,79,27,52,nan
Stimme,11W320,11,Lichtenberg,320,W,113I,3,86,O,1021,873,148,0,174,0,0,174,63,111,nan
Stimme,11W321,11,Lichtenberg,321,W,113I,3,86,O,914,794,120,0,124,2,0,124,41,83,nan
Stimme,11W322,11,Lichtenberg,322,W,113K,3,86,O,789,705,84,0,123,0,2,121,46,75,nan
Stimme,11W323,11,Lichtenberg,323,W,113K,3,86,O,963,865,98,0,113,0,0,113,66,47,nan
Stimme,11W324,11,Lichtenberg,324,W,113L,3,86,O,724,506,218,0,152,8,2,150,98,52,nan
Stimme,11W325,11,Lichtenberg,325,W,113M,3,86,O,948,808,140,0,188,4,0,188,75,113,nan
Stimme,11W326,11,Lichtenberg,326,W,113M,3,86,O,643,507,136,0,158,3,1,157,86,71,nan
Stimme,11W327,11,Lichtenberg,327,W,113N,3,86,O,852,670,182,0,183,5,0,183,109,74,nan
Stimme,11W328,11,Lichtenberg,328,W,113N,3,86,O,1166,948,218,0,201,6,1,200,136,64,nan
Stimme,11W329,11,Lichtenberg,329,W,113P,3,86,O,775,633,142,0,105,1,1,104,50,54,nan
Stimme,11W330,11,Lichtenberg,330,W,113P,3,86,O,1010,855,155,0,97,1,0,97,49,48,nan
Stimme,11W331,11,Lichtenberg,331,W,113Q,3,86,O,958,822,136,0,154,2,0,154,53,101,nan
Stimme,11W332,11,Lichtenberg,332,W,113Q,3,86,O,894,772,122,0,102,3,0,102,43,59,nan
Stimme,11W333,11,Lichtenberg,333,W,113R,3,86,O,921,799,122,0,145,0,0,145,49,96,nan
Stimme,11W334,11,Lichtenberg,334,W,113R,3,86,O,664,615,49,0,107,0,0,107,36,71,nan
Stimme,11W335,11,Lichtenberg,335,W,113S,3,86,O,810,700,110,0,118,1,0,118,52,66,nan
Stimme,11W336,11,Lichtenberg,336,W,113S,3,86,O,755,638,117,0,156,0,0,156,45,111,nan
Stimme,11W401,11,Lichtenberg,401,W,114A,4,86,O,1018,855,163,0,207,5,0,207,125,82,nan
Stimme,11W402,11,Lichtenberg,402,W,114A,4,86,O,859,727,132,0,176,3,1,175,78,97,nan
Stimme,11W403,11,Lichtenberg,403,W,114B,4,86,O,979,811,168,0,152,0,0,152,53,99,nan
Stimme,11W404,11,Lichtenberg,404,W,114B,4,86,O,922,797,125,0,195,1,0,195,97,98,nan
Stimme,11W405,11,Lichtenberg,405,W,114C,4,86,O,985,846,139,0,184,0,2,182,74,108,nan
Stimme,11W406,11,Lichtenberg,406,W,114C,4,86,O,903,794,109,0,155,2,1,154,54,100,nan
Stimme,11W407,11,Lichtenberg,407,W,114D,4,86,O,988,878,110,0,149,1,1,148,63,85,nan
Stimme,11W408,11,Lichtenberg,408,W,114E,4,86,O,983,866,117,0,148,3,0,148,75,73,nan
Stimme,11W409,11,Lichtenberg,409,W,114D,4,86,O,970,805,165,0,164,5,0,164,88,76,nan
Stimme,11W410,11,Lichtenberg,410,W,114E,4,86,O,1029,887,142,0,153,0,0,153,72,81,nan
Stimme,11W411,11,Lichtenberg,411,W,114F,4,86,O,786,670,116,0,124,1,0,124,67,57,nan
Stimme,11W412,11,Lichtenberg,412,W,114G,4,86,O,782,648,134,0,194,2,1,193,94,99,nan
Stimme,11W413,11,Lichtenberg,413,W,114F,4,86,O,878,694,184,0,174,2,0,174,115,59,nan
Stimme,11W414,11,Lichtenberg,414,W,114G,4,86,O,986,836,150,0,157,2,1,156,89,67,nan
Stimme,11W415,11,Lichtenberg,415,W,114K,4,86,O,702,509,193,0,129,1,0,129,73,56,nan
Stimme,11W416,11,Lichtenberg,416,W,114H,4,86,O,1177,936,241,0,251,7,0,251,177,74,nan
Stimme,11W417,11,Lichtenberg,417,W,114H,4,86,O,966,763,203,0,219,5,0,219,126,93,nan
Stimme,11W418,11,Lichtenberg,418,W,114I,4,86,O,1004,812,192,0,177,5,2,175,113,62,nan
Stimme,11W419,11,Lichtenberg,419,W,114K,4,86,O,918,771,147,0,163,2,1,162,49,113,nan
Stimme,11W420,11,Lichtenberg,420,W,114L,4,86,O,959,813,146,0,153,3,0,153,85,68,nan
Stimme,11W421,11,Lichtenberg,421,W,114M,4,86,O,1012,809,203,0,220,3,0,220,135,85,nan
Stimme,11W422,11,Lichtenberg,422,W,114L,4,86,O,924,764,160,0,196,3,1,195,135,60,nan
Stimme,11W423,11,Lichtenberg,423,W,114I,4,86,O,832,646,186,0,181,0,1,180,125,55,nan
Stimme,11W424,11,Lichtenberg,424,W,114M,4,86,O,846,637,209,0,133,6,0,133,107,26,nan
Stimme,11W425,11,Lichtenberg,425,W,114N,4,86,O,866,706,160,0,145,2,1,144,90,54,nan
Stimme,11W426,11,Lichtenberg,426,W,114N,4,86,O,968,767,201,0,213,8,1,212,144,68,nan
Stimme,11W427,11,Lichtenberg,427,W,114P,4,86,O,1027,893,134,0,146,1,0,146,73,73,nan
Stimme,11W428,11,Lichtenberg,428,W,114P,4,86,O,882,746,136,0,149,0,0,149,56,93,nan
Stimme,11W429,11,Lichtenberg,429,W,114Q,4,86,O,1174,1028,146,0,151,5,0,151,81,70,nan
Stimme,11W430,11,Lichtenberg,430,W,114Q,4,86,O,701,611,90,0,95,1,0,95,28,67,nan
Stimme,11W431,11,Lichtenberg,431,W,114R,4,86,O,828,698,130,0,154,0,0,154,59,95,nan
Stimme,11W432,11,Lichtenberg,432,W,114R,4,86,O,864,755,109,0,177,1,2,175,105,70,nan
Stimme,11W433,11,Lichtenberg,433,W,114T,4,86,O,839,610,229,0,216,4,1,215,166,49,nan
Stimme,11W434,11,Lichtenberg,434,W,114S,4,86,O,844,713,131,0,152,3,1,151,65,86,nan
Stimme,11W435,11,Lichtenberg,435,W,114T,4,86,O,813,625,188,0,255,4,0,255,202,53,nan
Stimme,11W436,11,Lichtenberg,436,W,114S,4,86,O,1002,778,224,0,296,3,3,293,234,59,nan
Stimme,11W501,11,Lichtenberg,501,W,115A,5,86,O,805,659,146,0,173,1,0,173,107,66,nan
Stimme,11W502,11,Lichtenberg,502,W,115C,5,86,O,998,869,129,0,145,6,0,145,57,88,nan
Stimme,11W503,11,Lichtenberg,503,W,115C,5,86,O,1020,897,123,0,162,1,0,162,40,122,nan
Stimme,11W504,11,Lichtenberg,504,W,115D,5,86,O,845,717,128,0,177,0,0,177,50,127,nan
Stimme,11W505,11,Lichtenberg,505,W,115E,5,86,O,812,696,116,0,77,3,1,76,27,49,nan
Stimme,11W506,11,Lichtenberg,506,W,115E,5,86,O,953,809,144,0,110,2,0,110,38,72,nan
Stimme,11W507,11,Lichtenberg,507,W,115A,5,86,O,1066,901,165,0,217,3,0,217,138,79,nan
Stimme,11W508,11,Lichtenberg,508,W,115B,5,86,O,993,828,165,0,225,6,0,225,127,98,nan
Stimme,11W509,11,Lichtenberg,509,W,115B,5,86,O,1270,1014,256,0,240,4,2,238,97,141,nan
Stimme,11W510,11,Lichtenberg,510,W,115D,5,86,O,1145,936,209,0,214,0,0,214,76,138,nan
Stimme,11W511,11,Lichtenberg,511,W,115F,5,86,O,940,742,198,0,190,1,1,189,131,58,nan
Stimme,11W512,11,Lichtenberg,512,W,115F,5,86,O,915,749,166,0,165,3,1,164,101,63,nan
Stimme,11W513,11,Lichtenberg,513,W,115H,5,86,O,1015,805,210,0,233,3,0,233,118,115,nan
Stimme,11W514,11,Lichtenberg,514,W,115I,5,86,O,1028,860,168,0,205,3,0,205,111,94,nan
Stimme,11W515,11,Lichtenberg,515,W,115L,5,86,O,965,843,122,0,217,0,0,217,90,127,nan
Stimme,11W516,11,Lichtenberg,516,W,115L,5,86,O,963,788,175,0,145,0,0,145,56,89,nan
Stimme,11W517,11,Lichtenberg,517,W,115G,5,86,O,985,761,224,0,170,4,0,170,132,38,nan
Stimme,11W518,11,Lichtenberg,518,W,115G,5,86,O,842,696,146,0,191,1,0,191,118,73,nan
Stimme,11W519,11,Lichtenberg,519,W,115H,5,86,O,932,747,185,0,161,0,0,161,74,87,nan
Stimme,11W520,11,Lichtenberg,520,W,115I,5,86,O,854,749,105,0,130,0,1,129,58,71,nan
Stimme,11W521,11,Lichtenberg,521,W,115K,5,86,O,1022,868,154,0,172,1,3,169,76,93,nan
Stimme,11W522,11,Lichtenberg,522,W,115K,5,86,O,957,854,103,0,133,1,0,133,45,88,nan
Stimme,11W523,11,Lichtenberg,523,W,115M,5,86,O,971,784,187,0,211,2,0,211,141,70,nan
Stimme,11W524,11,Lichtenberg,524,W,115M,5,86,O,857,692,165,0,186,5,0,186,145,41,nan
Stimme,11W525,11,Lichtenberg,525,W,115N,5,86,O,966,721,245,0,255,7,1,254,194,60,nan
Stimme,11W526,11,Lichtenberg,526,W,115N,5,86,O,1037,803,234,0,257,4,0,257,176,81,nan
Stimme,11W527,11,Lichtenberg,527,W,115P,5,86,O,891,706,185,0,175,5,0,175,111,64,nan
Stimme,11W528,11,Lichtenberg,528,W,115P,5,86,O,953,797,156,0,189,2,0,189,81,108,nan
Stimme,11W529,11,Lichtenberg,529,W,115Q,5,86,O,1086,932,154,0,145,4,0,145,60,85,nan
Stimme,11W530,11,Lichtenberg,530,W,115Q,5,86,O,1009,824,185,0,141,0,0,141,57,84,nan
Stimme,11W531,11,Lichtenberg,531,W,115R,5,86,O,940,799,141,0,206,2,0,206,76,130,nan
Stimme,11W532,11,Lichtenberg,532,W,115R,5,86,O,1053,901,152,0,158,2,1,157,66,91,nan
Stimme,11W533,11,Lichtenberg,533,W,115S,5,86,O,874,749,125,0,131,1,0,131,66,65,nan
Stimme,11W534,11,Lichtenberg,534,W,115S,5,86,O,1113,958,155,0,141,3,0,141,55,86,nan
Stimme,11W601,11,Lichtenberg,601,W,116E,6,86,O,942,769,173,0,215,2,0,215,130,85,nan
Stimme,11W602,11,Lichtenberg,602,W,116E,6,86,O,952,713,239,0,236,1,0,236,177,59,nan
Stimme,11W603,11,Lichtenberg,603,W,116F,6,86,O,841,644,197,0,293,5,2,291,195,96,nan
Stimme,11W604,11,Lichtenberg,604,W,116A,6,86,O,916,719,197,0,127,2,0,127,53,74,nan
Stimme,11W605,11,Lichtenberg,605,W,116A,6,86,O,974,816,158,0,169,0,0,169,65,104,nan
Stimme,11W606,11,Lichtenberg,606,W,116B,6,86,O,1053,917,136,0,177,5,2,175,77,98,nan
Stimme,11W607,11,Lichtenberg,607,W,116B,6,86,O,1472,1228,244,0,218,2,0,218,126,92,nan
Stimme,11W608,11,Lichtenberg,608,W,116C,6,86,O,861,728,133,0,142,4,0,142,62,80,nan
Stimme,11W609,11,Lichtenberg,609,W,116C,6,86,O,956,797,159,0,177,4,0,177,78,99,nan
Stimme,11W610,11,Lichtenberg,610,W,116D,6,86,O,943,801,142,0,126,0,1,125,48,77,nan
Stimme,11W611,11,Lichtenberg,611,W,116D,6,86,O,917,767,150,0,151,1,0,151,48,103,nan
Stimme,11W612,11,Lichtenberg,612,W,116F,6,86,O,799,667,132,0,175,2,1,174,88,86,nan
Stimme,11W613,11,Lichtenberg,613,W,116G,6,86,O,1001,793,208,0,176,0,1,175,87,88,nan
Stimme,11W614,11,Lichtenberg,614,W,116G,6,86,O,785,620,165,0,174,9,0,174,90,84,nan
Stimme,11W615,11,Lichtenberg,615,W,116I,6,86,O,948,729,219,0,231,5,1,230,93,137,nan
Stimme,11W616,11,Lichtenberg,616,W,116I,6,86,O,1052,864,188,0,202,1,0,202,66,136,nan
Stimme,11W617,11,Lichtenberg,617,W,116K,6,86,O,840,659,181,0,187,3,0,187,102,85,nan
Stimme,11W618,11,Lichtenberg,618,W,116H,6,86,O,785,611,174,0,197,2,0,197,119,78,nan
Stimme,11W619,11,Lichtenberg,619,W,116H,6,86,O,793,648,145,0,170,3,2,168,101,67,nan
Stimme,11W620,11,Lichtenberg,620,W,116N,6,86,O,757,557,200,0,217,1,0,217,94,123,nan
Stimme,11W621,11,Lichtenberg,621,W,116N,6,86,O,809,625,184,0,221,0,1,220,112,108,nan
Stimme,11W622,11,Lichtenberg,622,W,116P,6,86,O,870,661,209,0,252,4,1,251,142,109,nan
Stimme,11W623,11,Lichtenberg,623,W,116Q,6,86,O,955,746,209,0,250,1,1,249,135,114,nan
Stimme,11W624,11,Lichtenberg,624,W,116K,6,86,O,897,702,195,0,251,0,0,251,146,105,nan
Stimme,11W625,11,Lichtenberg,625,W,116L,6,86,O,869,707,162,0,265,5,0,265,165,100,nan
Stimme,11W626,11,Lichtenberg,626,W,116L,6,86,O,874,661,213,0,203,0,0,203,102,101,nan
Stimme,11W627,11,Lichtenberg,627,W,116M,6,86,O,923,665,258,0,220,1,1,219,115,104,nan
Stimme,11W628,11,Lichtenberg,628,W,116R,6,86,O,1193,906,287,0,258,2,0,258,144,114,nan
Stimme,11W629,11,Lichtenberg,629,W,116R,6,86,O,851,627,224,0,214,8,1,213,121,92,nan
Stimme,11W630,11,Lichtenberg,630,W,116Q,6,86,O,893,693,200,0,282,3,1,281,166,115,nan
Stimme,11W631,11,Lichtenberg,631,W,116M,6,86,O,783,629,154,0,193,1,0,193,108,85,nan
Stimme,11W632,11,Lichtenberg,632,W,116S,6,86,O,856,666,190,0,213,2,0,213,127,86,nan
Stimme,11W633,11,Lichtenberg,633,W,116P,6,86,O,921,711,210,0,247,2,5,242,92,150,nan
Stimme,11W634,11,Lichtenberg,634,W,116S,6,86,O,667,426,241,0,196,7,1,195,109,86,nan
Stimme,11B1A,11,Lichtenberg,1A,B,111A,1,86,O,0,0,0,0,379,379,1,378,123,255,nan
Stimme,11B1B,11,Lichtenberg,1B,B,111B,1,86,O,0,0,0,0,245,245,1,244,77,167,nan
Stimme,11B1C,11,Lichtenberg,1C,B,111C,1,86,O,0,0,0,0,336,336,0,336,84,252,nan
Stimme,11B1D,11,Lichtenberg,1D,B,111D,1,86,O,0,0,0,0,267,267,1,266,89,177,nan
Stimme,11B1E,11,Lichtenberg,1E,B,111E,1,86,O,0,0,0,0,150,150,3,147,44,103,nan
Stimme,11B1F,11,Lichtenberg,1F,B,111F,1,86,O,0,0,0,0,247,247,0,247,56,191,nan
Stimme,11B1G,11,Lichtenberg,1G,B,111G,1,86,O,0,0,0,0,140,140,1,139,51,88,nan
Stimme,11B1H,11,Lichtenberg,1H,B,111H,1,86,O,0,0,0,0,197,197,0,197,75,122,nan
Stimme,11B1I,11,Lichtenberg,1I,B,111I,1,86,O,0,0,0,0,155,155,0,155,38,117,nan
Stimme,11B1K,11,Lichtenberg,1K,B,111K,1,86,O,0,0,0,0,136,136,0,136,42,94,nan
Stimme,11B1L,11,Lichtenberg,1L,B,111L,1,86,O,0,0,0,0,153,153,1,152,41,111,nan
Stimme,11B1M,11,Lichtenberg,1M,B,111M,1,86,O,0,0,0,0,193,193,0,193,69,124,nan
Stimme,11B1N,11,Lichtenberg,1N,B,111N,1,86,O,0,0,0,0,266,266,0,266,85,181,nan
Stimme,11B1P,11,Lichtenberg,1P,B,111P,1,86,O,0,0,0,0,217,217,1,216,75,141,nan
Stimme,11B1Q,11,Lichtenberg,1Q,B,111Q,1,86,O,0,0,0,0,108,108,0,108,42,66,nan
Stimme,11B1R,11,Lichtenberg,1R,B,111R,1,86,O,0,0,0,0,130,130,0,130,47,83,nan
Stimme,11B1S,11,Lichtenberg,1S,B,111S,1,86,O,0,0,0,0,152,152,1,151,58,93,nan
Stimme,11B1T,11,Lichtenberg,1T,B,111T,1,86,O,0,0,0,0,113,113,0,113,34,79,nan
Stimme,11B2A,11,Lichtenberg,2A,B,112A,2,86,O,0,0,0,0,239,239,0,239,63,176,nan
Stimme,11B2B,11,Lichtenberg,2B,B,112B,2,86,O,0,0,0,0,209,209,0,209,56,153,nan
Stimme,11B2C,11,Lichtenberg,2C,B,112C,2,86,O,0,0,0,0,169,169,0,169,47,122,nan
Stimme,11B2D,11,Lichtenberg,2D,B,112D,2,86,O,0,0,0,0,312,312,0,312,79,233,nan
Stimme,11B2E,11,Lichtenberg,2E,B,112E,2,86,O,0,0,0,0,353,353,1,352,115,237,nan
Stimme,11B2F,11,Lichtenberg,2F,B,112F,2,86,O,0,0,0,0,221,221,0,221,85,136,nan
Stimme,11B2G,11,Lichtenberg,2G,B,112G,2,86,O,0,0,0,0,264,264,0,264,63,201,nan
Stimme,11B2H,11,Lichtenberg,2H,B,112H,2,86,O,0,0,0,0,358,358,0,358,133,225,nan
Stimme,11B2I,11,Lichtenberg,2I,B,112I,2,86,O,0,0,0,0,247,247,1,246,72,174,nan
Stimme,11B2K,11,Lichtenberg,2K,B,112K,2,86,O,0,0,0,0,213,213,0,213,58,155,nan
Stimme,11B2L,11,Lichtenberg,2L,B,112L,2,86,O,0,0,0,0,312,312,1,311,112,199,nan
Stimme,11B2M,11,Lichtenberg,2M,B,112M,2,86,O,0,0,0,0,308,308,0,308,103,205,nan
Stimme,11B2N,11,Lichtenberg,2N,B,112N,2,86,O,0,0,0,0,315,315,2,313,162,151,nan
Stimme,11B2P,11,Lichtenberg,2P,B,112P,2,86,O,0,0,0,0,251,251,0,251,116,135,nan
Stimme,11B2Q,11,Lichtenberg,2Q,B,112Q,2,86,O,0,0,0,0,262,262,1,261,124,137,nan
Stimme,11B2R,11,Lichtenberg,2R,B,112R,2,86,O,0,0,0,0,279,279,0,279,136,143,nan
Stimme,11B2S,11,Lichtenberg,2S,B,112S,2,86,O,0,0,0,0,269,269,0,269,79,190,nan
Stimme,11B3A,11,Lichtenberg,3A,B,113A,3,86,O,0,0,0,0,274,274,0,274,139,135,nan
Stimme,11B3B,11,Lichtenberg,3B,B,113B,3,86,O,0,0,0,0,279,279,0,279,118,161,nan
Stimme,11B3C,11,Lichtenberg,3C,B,113C,3,86,O,0,0,0,0,242,242,0,242,114,128,nan
Stimme,11B3D,11,Lichtenberg,3D,B,113D,3,86,O,0,0,0,0,206,206,2,204,77,127,nan
Stimme,11B3E,11,Lichtenberg,3E,B,113E,3,86,O,0,0,0,0,222,222,1,221,84,137,nan
Stimme,11B3F,11,Lichtenberg,3F,B,113F,3,86,O,0,0,0,0,323,323,5,318,138,180,nan
Stimme,11B3G,11,Lichtenberg,3G,B,113G,3,86,O,0,0,0,0,242,242,0,242,109,133,nan
Stimme,11B3H,11,Lichtenberg,3H,B,113H,3,86,O,0,0,0,0,170,170,1,169,57,112,nan
Stimme,11B3I,11,Lichtenberg,3I,B,113I,3,86,O,0,0,0,0,242,242,1,241,114,127,nan
Stimme,11B3K,11,Lichtenberg,3K,B,113K,3,86,O,0,0,0,0,163,163,0,163,85,78,nan
Stimme,11B3L,11,Lichtenberg,3L,B,113L,3,86,O,0,0,0,0,357,357,1,356,219,137,nan
Stimme,11B3M,11,Lichtenberg,3M,B,113M,3,86,O,0,0,0,0,239,239,4,235,122,113,nan
Stimme,11B3N,11,Lichtenberg,3N,B,113N,3,86,O,0,0,0,0,332,332,1,331,235,96,nan
Stimme,11B3P,11,Lichtenberg,3P,B,113P,3,86,O,0,0,0,0,261,261,1,260,127,133,nan
Stimme,11B3Q,11,Lichtenberg,3Q,B,113Q,3,86,O,0,0,0,0,222,222,1,221,98,123,nan
Stimme,11B3R,11,Lichtenberg,3R,B,113R,3,86,O,0,0,0,0,150,150,0,150,68,82,nan
Stimme,11B3S,11,Lichtenberg,3S,B,113S,3,86,O,0,0,0,0,197,197,1,196,73,123,nan
Stimme,11B4A,11,Lichtenberg,4A,B,114A,4,86,O,0,0,0,0,249,249,0,249,144,105,nan
Stimme,11B4B,11,Lichtenberg,4B,B,114B,4,86,O,0,0,0,0,258,258,0,258,108,150,nan
Stimme,11B4C,11,Lichtenberg,4C,B,114C,4,86,O,0,0,0,0,208,208,0,208,78,130,nan
Stimme,11B4D,11,Lichtenberg,4D,B,114D,4,86,O,0,0,0,0,232,232,0,232,123,109,nan
Stimme,11B4E,11,Lichtenberg,4E,B,114E,4,86,O,0,0,0,0,225,225,0,225,102,123,nan
Stimme,11B4F,11,Lichtenberg,4F,B,114F,4,86,O,0,0,0,0,260,260,0,260,168,92,nan
Stimme,11B4G,11,Lichtenberg,4G,B,114G,4,86,O,0,0,0,0,257,257,4,253,132,121,nan
Stimme,11B4H,11,Lichtenberg,4H,B,114H,4,86,O,0,0,0,0,378,378,1,377,265,112,nan
Stimme,11B4I,11,Lichtenberg,4I,B,114I,4,86,O,0,0,0,0,338,338,0,338,246,92,nan
Stimme,11B4K,11,Lichtenberg,4K,B,114K,4,86,O,0,0,0,0,287,287,0,287,131,156,nan
Stimme,11B4L,11,Lichtenberg,4L,B,114L,4,86,O,0,0,0,0,276,276,0,276,175,101,nan
Stimme,11B4M,11,Lichtenberg,4M,B,114M,4,86,O,0,0,0,0,357,357,2,355,263,92,nan
Stimme,11B4N,11,Lichtenberg,4N,B,114N,4,86,O,0,0,0,0,305,305,1,304,216,88,nan
Stimme,11B4P,11,Lichtenberg,4P,B,114P,4,86,O,0,0,0,0,242,242,2,240,110,130,nan
Stimme,11B4Q,11,Lichtenberg,4Q,B,114Q,4,86,O,0,0,0,0,205,205,2,203,108,95,nan
Stimme,11B4R,11,Lichtenberg,4R,B,114R,4,86,O,0,0,0,0,213,213,0,213,120,93,nan
Stimme,11B4S,11,Lichtenberg,4S,B,114S,4,86,O,0,0,0,0,306,306,0,306,219,87,nan
Stimme,11B4T,11,Lichtenberg,4T,B,114T,4,86,O,0,0,0,0,365,365,0,365,283,82,nan
Stimme,11B5A,11,Lichtenberg,5A,B,115A,5,86,O,0,0,0,0,273,273,0,273,198,75,nan
Stimme,11B5B,11,Lichtenberg,5B,B,115B,5,86,O,0,0,0,0,365,365,1,364,244,120,nan
Stimme,11B5C,11,Lichtenberg,5C,B,115C,5,86,O,0,0,0,0,227,227,0,227,101,126,nan
Stimme,11B5D,11,Lichtenberg,5D,B,115D,5,86,O,0,0,0,0,296,296,1,295,118,177,nan
Stimme,11B5E,11,Lichtenberg,5E,B,115E,5,86,O,0,0,0,0,220,220,2,218,109,109,nan
Stimme,11B5F,11,Lichtenberg,5F,B,115F,5,86,O,0,0,0,0,321,321,0,321,227,94,nan
Stimme,11B5G,11,Lichtenberg,5G,B,115G,5,86,O,0,0,0,0,316,316,2,314,220,94,nan
Stimme,11B5H,11,Lichtenberg,5H,B,115H,5,86,O,0,0,0,0,344,344,0,344,217,127,nan
Stimme,11B5I,11,Lichtenberg,5I,B,115I,5,86,O,0,0,0,0,235,235,1,234,142,92,nan
Stimme,11B5K,11,Lichtenberg,5K,B,115K,5,86,O,0,0,0,0,221,221,0,221,96,125,nan
Stimme,11B5L,11,Lichtenberg,5L,B,115L,5,86,O,0,0,0,0,249,249,0,249,96,153,nan
Stimme,11B5M,11,Lichtenberg,5M,B,115M,5,86,O,0,0,0,0,304,304,0,304,239,65,nan
Stimme,11B5N,11,Lichtenberg,5N,B,115N,5,86,O,0,0,0,0,404,404,1,403,303,100,nan
Stimme,11B5P,11,Lichtenberg,5P,B,115P,5,86,O,0,0,0,0,290,290,0,290,181,109,nan
Stimme,11B5Q,11,Lichtenberg,5Q,B,115Q,5,86,O,0,0,0,0,291,291,0,291,118,173,nan
Stimme,11B5R,11,Lichtenberg,5R,B,115R,5,86,O,0,0,0,0,241,241,1,240,112,128,nan
Stimme,11B5S,11,Lichtenberg,5S,B,115S,5,86,O,0,0,0,0,233,233,0,233,111,122,nan
Stimme,11B6A,11,Lichtenberg,6A,B,116A,6,86,O,0,0,0,0,318,318,0,318,136,182,nan
Stimme,11B6B,11,Lichtenberg,6B,B,116B,6,86,O,0,0,0,0,336,336,0,336,177,159,nan
Stimme,11B6C,11,Lichtenberg,6C,B,116C,6,86,O,0,0,0,0,238,238,0,238,108,130,nan
Stimme,11B6D,11,Lichtenberg,6D,B,116D,6,86,O,0,0,0,0,242,242,2,240,123,117,nan
Stimme,11B6E,11,Lichtenberg,6E,B,116E,6,86,O,0,0,0,0,359,359,1,358,233,125,nan
Stimme,11B6F,11,Lichtenberg,6F,B,116F,6,86,O,0,0,0,0,286,286,1,285,171,114,nan
Stimme,11B6G,11,Lichtenberg,6G,B,116G,6,86,O,0,0,0,0,328,328,0,328,193,135,nan
Stimme,11B6H,11,Lichtenberg,6H,B,116H,6,86,O,0,0,0,0,280,280,1,279,148,131,nan
Stimme,11B6I,11,Lichtenberg,6I,B,116I,6,86,O,0,0,0,0,365,365,1,364,162,202,nan
Stimme,11B6K,11,Lichtenberg,6K,B,116K,6,86,O,0,0,0,0,321,321,2,319,189,130,nan
Stimme,11B6L,11,Lichtenberg,6L,B,116L,6,86,O,0,0,0,0,322,322,1,321,180,141,nan
Stimme,11B6M,11,Lichtenberg,6M,B,116M,6,86,O,0,0,0,0,372,372,2,370,201,169,nan
Stimme,11B6N,11,Lichtenberg,6N,B,116N,6,86,O,0,0,0,0,334,334,2,332,150,182,nan
Stimme,11B6P,11,Lichtenberg,6P,B,116P,6,86,O,0,0,0,0,357,357,0,357,191,166,nan
Stimme,11B6Q,11,Lichtenberg,6Q,B,116Q,6,86,O,0,0,0,0,358,358,1,357,201,156,nan
Stimme,11B6R,11,Lichtenberg,6R,B,116R,6,86,O,0,0,0,0,445,445,1,444,249,195,nan
Stimme,11B6S,11,Lichtenberg,6S,B,116S,6,86,O,0,0,0,0,371,371,5,366,202,164,nan
Stimme,12W101,12,Reinickendorf,101,W,121A,1,77,W,1124,890,234,0,185,2,1,184,85,99,nan
Stimme,12W102,12,Reinickendorf,102,W,121A,1,77,W,834,748,86,0,105,0,1,104,53,51,nan
Stimme,12W103,12,Reinickendorf,103,W,121B,1,77,W,762,664,98,0,98,0,1,97,39,58,nan
Stimme,12W104,12,Reinickendorf,104,W,121B,1,77,W,831,731,100,0,151,5,1,150,67,83,nan
Stimme,12W105,12,Reinickendorf,105,W,121C,1,77,W,964,842,122,0,99,3,1,98,54,44,nan
Stimme,12W106,12,Reinickendorf,106,W,121I,1,77,W,1145,993,152,0,159,2,0,159,77,82,nan
Stimme,12W107,12,Reinickendorf,107,W,121D,1,77,W,854,762,92,0,154,0,0,154,47,107,nan
Stimme,12W108,12,Reinickendorf,108,W,121D,1,77,W,1152,1026,126,0,239,1,0,239,90,149,nan
Stimme,12W109,12,Reinickendorf,109,W,121E,1,77,W,849,730,119,0,98,1,1,97,35,62,nan
Stimme,12W110,12,Reinickendorf,110,W,121E,1,77,W,950,810,140,0,128,2,0,128,58,70,nan
Stimme,12W111,12,Reinickendorf,111,W,121F,1,77,W,1083,923,160,0,160,3,0,160,104,56,nan
Stimme,12W112,12,Reinickendorf,112,W,121G,1,77,W,1175,947,228,0,176,4,0,176,63,113,nan
Stimme,12W113,12,Reinickendorf,113,W,121G,1,77,W,920,788,132,0,139,0,0,139,44,95,nan
Stimme,12W114,12,Reinickendorf,114,W,121H,1,77,W,1350,1237,113,0,119,0,1,118,50,68,nan
Stimme,12W115,12,Reinickendorf,115,W,121H,1,77,W,994,886,108,0,133,1,0,133,63,70,nan
Stimme,12W116,12,Reinickendorf,116,W,121C,1,77,W,1011,886,125,0,152,1,1,151,75,76,nan
Stimme,12W117,12,Reinickendorf,117,W,121J,1,77,W,1057,911,146,0,141,0,0,141,63,78,nan
Stimme,12W118,12,Reinickendorf,118,W,121I,1,77,W,1083,976,107,0,116,1,0,116,49,67,nan
Stimme,12W119,12,Reinickendorf,119,W,121K,1,77,W,1249,1062,187,0,162,3,1,161,82,79,nan
Stimme,12W120,12,Reinickendorf,120,W,121K,1,77,W,1249,1095,154,0,166,4,1,165,64,101,nan
Stimme,12W121,12,Reinickendorf,121,W,121L,1,77,W,1137,968,169,0,166,0,1,165,74,91,nan
Stimme,12W122,12,Reinickendorf,122,W,121J,1,77,W,1129,972,157,0,170,3,1,169,77,92,nan
Stimme,12W123,12,Reinickendorf,123,W,121F,1,77,W,1176,1015,161,0,140,0,0,140,46,94,nan
Stimme,12W124,12,Reinickendorf,124,W,121M,1,77,W,1126,987,139,0,132,2,2,130,56,74,nan
Stimme,12W125,12,Reinickendorf,125,W,121M,1,77,W,1167,1038,129,0,168,2,2,166,82,84,nan
Stimme,12W126,12,Reinickendorf,126,W,121L,1,77,W,1307,1101,206,0,175,4,0,175,80,95,nan
Stimme,12W201,12,Reinickendorf,201,W,122A,2,77,W,1045,927,118,0,180,0,1,179,57,122,nan
Stimme,12W202,12,Reinickendorf,202,W,122B,2,77,W,1127,909,218,0,151,1,0,151,41,110,nan
Stimme,12W203,12,Reinickendorf,203,W,122C,2,77,W,1131,877,254,0,247,2,0,247,76,171,nan
Stimme,12W204,12,Reinickendorf,204,W,122D,2,77,W,915,744,171,0,201,1,1,200,51,149,nan
Stimme,12W205,12,Reinickendorf,205,W,122D,2,77,W,741,641,100,0,196,0,1,195,62,133,nan
Stimme,12W206,12,Reinickendorf,206,W,122E,2,77,W,1281,1020,261,0,154,2,0,154,57,97,nan
Stimme,12W207,12,Reinickendorf,207,W,122F,2,77,W,1303,1140,163,0,215,1,1,214,52,162,nan
Stimme,12W208,12,Reinickendorf,208,W,122E,2,77,W,1200,1088,112,0,111,0,0,111,27,84,nan
Stimme,12W209,12,Reinickendorf,209,W,122F,2,77,W,1213,1037,176,0,144,2,1,143,39,104,nan
Stimme,12W210,12,Reinickendorf,210,W,122G,2,77,W,1198,978,220,0,158,2,0,158,53,105,nan
Stimme,12W211,12,Reinickendorf,211,W,122B,2,77,W,1309,1086,223,0,214,1,2,212,66,146,nan
Stimme,12W212,12,Reinickendorf,212,W,122G,2,77,W,1240,1040,200,0,151,1,1,150,28,122,nan
Stimme,12W213,12,Reinickendorf,213,W,122H,2,77,W,1109,976,133,0,189,0,0,189,69,120,nan
Stimme,12W214,12,Reinickendorf,214,W,122H,2,77,W,1241,1044,197,0,215,0,1,214,61,153,nan
Stimme,12W215,12,Reinickendorf,215,W,122I,2,77,W,1317,1116,201,0,197,1,3,194,49,145,nan
Stimme,12W216,12,Reinickendorf,216,W,122J,2,77,W,909,817,92,0,133,0,1,132,55,77,nan
Stimme,12W217,12,Reinickendorf,217,W,122K,2,77,W,1171,1005,166,0,190,0,1,189,71,118,nan
Stimme,12W218,12,Reinickendorf,218,W,122L,2,77,W,935,833,102,0,83,1,1,82,33,49,nan
Stimme,12W219,12,Reinickendorf,219,W,122L,2,77,W,984,854,130,0,141,2,2,139,44,95,nan
Stimme,12W220,12,Reinickendorf,220,W,122J,2,77,W,1183,1098,85,0,129,2,1,128,51,77,nan
Stimme,12W221,12,Reinickendorf,221,W,122K,2,77,W,1279,1087,192,0,205,8,1,204,84,120,nan
Stimme,12W222,12,Reinickendorf,222,W,122M,2,77,W,1297,1167,130,0,147,2,0,147,70,77,nan
Stimme,12W223,12,Reinickendorf,223,W,122M,2,77,W,557,461,96,0,173,2,0,173,53,120,nan
Stimme,12W224,12,Reinickendorf,224,W,122M,2,77,W,321,285,36,0,73,0,0,73,19,54,nan
Stimme,12W225,12,Reinickendorf,225,W,122A,2,77,W,1092,923,169,0,185,0,2,183,63,120,nan
Stimme,12W226,12,Reinickendorf,226,W,122I,2,77,W,961,821,140,0,163,0,0,163,33,130,nan
Stimme,12W301,12,Reinickendorf,301,W,123A,3,77,W,1300,1032,268,0,435,2,2,433,113,320,nan
Stimme,12W302,12,Reinickendorf,302,W,123B,3,77,W,1211,954,257,0,320,1,0,320,97,223,nan
Stimme,12W303,12,Reinickendorf,303,W,123B,3,77,W,1216,966,250,0,294,2,1,293,86,207,nan
Stimme,12W304,12,Reinickendorf,304,W,123D,3,77,W,998,802,196,0,249,8,0,249,108,141,nan
Stimme,12W305,12,Reinickendorf,305,W,123G,3,77,W,1224,923,301,0,323,3,0,323,118,205,nan
Stimme,12W306,12,Reinickendorf,306,W,123C,3,77,W,1381,1052,329,0,348,3,0,348,107,241,nan
Stimme,12W307,12,Reinickendorf,307,W,123F,3,77,W,1343,1042,301,0,364,1,4,360,112,248,nan
Stimme,12W308,12,Reinickendorf,308,W,123E,3,77,W,1252,956,296,0,343,6,1,342,103,239,nan
Stimme,12W309,12,Reinickendorf,309,W,123D,3,77,W,1295,1017,278,0,295,1,1,294,124,170,nan
Stimme,12W310,12,Reinickendorf,310,W,123H,3,77,W,1187,892,295,0,316,4,4,312,99,213,nan
Stimme,12W311,12,Reinickendorf,311,W,123E,3,77,W,1170,830,340,0,262,2,0,262,83,179,nan
Stimme,12W312,12,Reinickendorf,312,W,123F,3,77,W,1334,950,384,0,309,3,3,306,83,223,nan
Stimme,12W313,12,Reinickendorf,313,W,123H,3,77,W,1231,935,296,0,312,5,1,311,92,219,nan
Stimme,12W314,12,Reinickendorf,314,W,123J,3,77,W,1201,993,208,0,217,1,1,216,89,127,nan
Stimme,12W315,12,Reinickendorf,315,W,123P,3,77,W,1173,907,266,0,307,3,3,304,99,205,nan
Stimme,12W316,12,Reinickendorf,316,W,123J,3,77,W,1280,1030,250,0,275,10,2,273,124,149,nan
Stimme,12W317,12,Reinickendorf,317,W,123K,3,77,W,1277,1027,250,0,243,2,2,241,89,152,nan
Stimme,12W318,12,Reinickendorf,318,W,123I,3,77,W,1178,881,297,0,319,0,0,319,133,186,nan
Stimme,12W319,12,Reinickendorf,319,W,123L,3,77,W,1362,1232,130,0,164,0,2,162,50,112,nan
Stimme,12W320,12,Reinickendorf,320,W,123M,3,77,W,1118,1016,102,0,131,3,0,131,43,88,nan
Stimme,12W321,12,Reinickendorf,321,W,123K,3,77,W,1269,1120,149,0,232,0,0,232,81,151,nan
Stimme,12W322,12,Reinickendorf,322,W,123M,3,77,W,1343,1140,203,0,230,1,3,227,71,156,nan
Stimme,12W323,12,Reinickendorf,323,W,123I,3,77,W,1066,814,252,0,280,2,0,280,80,200,nan
Stimme,12W324,12,Reinickendorf,324,W,123L,3,77,W,249,216,33,0,71,0,1,70,22,48,nan
Stimme,12W325,12,Reinickendorf,325,W,123N,3,77,W,1208,973,235,0,250,2,0,250,137,113,nan
Stimme,12W401,12,Reinickendorf,401,W,124A,4,77,W,1449,1161,288,0,383,3,2,381,165,216,nan
Stimme,12W402,12,Reinickendorf,402,W,124A,4,77,W,1232,973,259,0,240,4,0,240,83,157,nan
Stimme,12W403,12,Reinickendorf,403,W,124B,4,77,W,1137,855,282,0,215,1,2,213,62,151,nan
Stimme,12W404,12,Reinickendorf,404,W,124C,4,77,W,1186,1075,111,0,119,0,1,118,30,88,nan
Stimme,12W405,12,Reinickendorf,405,W,124C,4,77,W,1305,1165,140,0,174,2,1,173,61,112,nan
Stimme,12W406,12,Reinickendorf,406,W,124D,4,77,W,1293,1064,229,0,224,1,0,224,101,123,nan
Stimme,12W407,12,Reinickendorf,407,W,124E,4,77,W,1108,854,254,0,299,3,1,298,121,177,nan
Stimme,12W408,12,Reinickendorf,408,W,124F,4,77,W,1617,1301,316,0,420,5,2,418,177,241,nan
Stimme,12W409,12,Reinickendorf,409,W,124F,4,77,W,1153,966,187,0,249,1,3,246,71,175,nan
Stimme,12W410,12,Reinickendorf,410,W,124B,4,77,W,992,848,144,0,186,0,2,184,49,135,nan
Stimme,12W411,12,Reinickendorf,411,W,124G,4,77,W,884,756,128,0,193,4,1,192,42,150,nan
Stimme,12W412,12,Reinickendorf,412,W,124D,4,77,W,1336,1118,218,0,342,4,3,339,125,214,nan
Stimme,12W413,12,Reinickendorf,413,W,124E,4,77,W,1290,981,309,0,254,4,3,251,82,169,nan
Stimme,12W414,12,Reinickendorf,414,W,124H,4,77,W,1399,1105,294,0,291,7,4,287,130,157,nan
Stimme,12W415,12,Reinickendorf,415,W,124N,4,77,W,1329,1050,279,0,233,11,1,232,108,124,nan
Stimme,12W416,12,Reinickendorf,416,W,124I,4,77,W,1325,1126,199,0,224,0,0,224,73,151,nan
Stimme,12W417,12,Reinickendorf,417,W,124J,4,77,W,1362,1094,268,0,309,3,3,306,102,204,nan
Stimme,12W418,12,Reinickendorf,418,W,124H,4,77,W,1360,1193,167,0,192,2,1,191,78,113,nan
Stimme,12W419,12,Reinickendorf,419,W,124G,4,77,W,1421,1188,233,0,228,0,0,228,74,154,nan
Stimme,12W420,12,Reinickendorf,420,W,124I,4,77,W,1298,1095,203,0,250,2,1,249,84,165,nan
Stimme,12W421,12,Reinickendorf,421,W,124K,4,77,W,1091,912,179,0,294,3,0,294,106,188,nan
Stimme,12W422,12,Reinickendorf,422,W,124L,4,77,W,1129,949,180,0,225,2,2,223,74,149,nan
Stimme,12W423,12,Reinickendorf,423,W,124K,4,77,W,1272,1078,194,0,232,0,0,232,97,135,nan
Stimme,12W424,12,Reinickendorf,424,W,124M,4,77,W,1333,1123,210,0,234,2,1,233,49,184,nan
Stimme,12W425,12,Reinickendorf,425,W,124M,4,77,W,975,827,148,0,200,0,1,199,46,153,nan
Stimme,12W426,12,Reinickendorf,426,W,124L,4,77,W,912,799,113,0,140,1,0,140,48,92,nan
Stimme,12W427,12,Reinickendorf,427,W,124N,4,77,W,1180,995,185,0,194,4,0,194,76,118,nan
Stimme,12W501,12,Reinickendorf,501,W,125A,5,77,W,1179,915,264,0,352,4,2,350,131,219,nan
Stimme,12W502,12,Reinickendorf,502,W,125B,5,77,W,1214,919,295,0,299,2,1,298,91,207,nan
Stimme,12W503,12,Reinickendorf,503,W,125A,5,77,W,1326,996,330,0,298,7,1,297,98,199,nan
Stimme,12W504,12,Reinickendorf,504,W,125E,5,77,W,1224,1116,108,0,91,0,0,91,25,66,nan
Stimme,12W505,12,Reinickendorf,505,W,125C,5,77,W,879,734,145,0,125,0,0,125,30,95,nan
Stimme,12W506,12,Reinickendorf,506,W,125C,5,77,W,846,728,118,0,104,0,0,104,25,79,nan
Stimme,12W507,12,Reinickendorf,507,W,125C,5,77,W,789,705,84,0,91,0,0,91,27,64,nan
Stimme,12W508,12,Reinickendorf,508,W,125D,5,77,W,604,577,27,0,44,0,0,44,17,27,nan
Stimme,12W509,12,Reinickendorf,509,W,125B,5,77,W,941,852,89,0,84,0,0,84,20,64,nan
Stimme,12W510,12,Reinickendorf,510,W,125F,5,77,W,716,662,54,0,63,0,1,62,18,44,nan
Stimme,12W511,12,Reinickendorf,511,W,125D,5,77,W,1292,1168,124,0,89,2,0,89,25,64,nan
Stimme,12W512,12,Reinickendorf,512,W,125E,5,77,W,969,900,69,0,127,0,0,127,43,84,nan
Stimme,12W513,12,Reinickendorf,513,W,125J,5,77,W,1171,1068,103,0,96,0,0,96,17,79,nan
Stimme,12W514,12,Reinickendorf,514,W,125J,5,77,W,1202,1107,95,0,81,1,0,81,24,57,nan
Stimme,12W515,12,Reinickendorf,515,W,125D,5,77,W,799,745,54,0,81,0,0,81,20,61,nan
Stimme,12W516,12,Reinickendorf,516,W,125F,5,77,W,1213,1131,82,0,135,2,0,135,54,81,nan
Stimme,12W517,12,Reinickendorf,517,W,125I,5,77,W,900,825,75,0,92,1,0,92,21,71,nan
Stimme,12W518,12,Reinickendorf,518,W,125I,5,77,W,1133,976,157,0,163,0,0,163,48,115,nan
Stimme,12W519,12,Reinickendorf,519,W,125H,5,77,W,1108,978,130,0,124,2,1,123,35,88,nan
Stimme,12W520,12,Reinickendorf,520,W,125F,5,77,W,982,883,99,0,61,0,0,61,23,38,nan
Stimme,12W521,12,Reinickendorf,521,W,125I,5,77,W,1005,808,197,0,150,0,0,150,50,100,nan
Stimme,12W522,12,Reinickendorf,522,W,125H,5,77,W,783,710,73,0,68,0,0,68,10,58,nan
Stimme,12W523,12,Reinickendorf,523,W,125G,5,77,W,1145,1074,71,0,121,0,1,120,32,88,nan
Stimme,12W524,12,Reinickendorf,524,W,125G,5,77,W,1105,1029,76,0,114,1,1,113,27,86,nan
Stimme,12W525,12,Reinickendorf,525,W,125H,5,77,W,765,611,154,0,167,1,1,166,44,122,nan
Stimme,12W526,12,Reinickendorf,526,W,125G,5,77,W,1247,1138,109,0,114,0,0,114,25,89,nan
Stimme,12W601,12,Reinickendorf,601,W,126A,6,77,W,266,240,26,0,72,2,0,72,37,35,nan
Stimme,12W602,12,Reinickendorf,602,W,126A,6,77,W,1316,989,327,0,391,3,2,389,121,268,nan
Stimme,12W603,12,Reinickendorf,603,W,126B,6,77,W,1166,848,318,0,240,6,0,240,96,144,nan
Stimme,12W604,12,Reinickendorf,604,W,126E,6,77,W,1043,796,247,0,303,0,2,301,124,177,nan
Stimme,12W605,12,Reinickendorf,605,W,126D,6,77,W,871,648,223,0,237,3,2,235,78,157,nan
Stimme,12W606,12,Reinickendorf,606,W,126C,6,77,W,1222,922,300,0,329,5,0,329,129,200,nan
Stimme,12W607,12,Reinickendorf,607,W,126F,6,77,W,991,771,220,0,242,1,0,242,95,147,nan
Stimme,12W608,12,Reinickendorf,608,W,126G,6,77,W,692,536,156,0,189,2,2,187,75,112,nan
Stimme,12W609,12,Reinickendorf,609,W,126H,6,77,W,1240,905,335,0,297,6,3,294,93,201,nan
Stimme,12W610,12,Reinickendorf,610,W,126J,6,77,W,962,733,229,0,238,6,0,238,102,136,nan
Stimme,12W611,12,Reinickendorf,611,W,126G,6,77,W,806,628,178,0,215,1,3,212,78,134,nan
Stimme,12W612,12,Reinickendorf,612,W,126I,6,77,W,1226,922,304,0,257,2,0,257,91,166,nan
Stimme,12W613,12,Reinickendorf,613,W,126J,6,77,W,1079,841,238,0,285,9,1,284,115,169,nan
Stimme,12W614,12,Reinickendorf,614,W,126K,6,77,W,1214,912,302,0,237,1,1,236,113,123,nan
Stimme,12W615,12,Reinickendorf,615,W,126L,6,77,W,1298,1007,291,0,279,4,0,279,94,185,nan
Stimme,12W616,12,Reinickendorf,616,W,126M,6,77,W,1217,923,294,0,306,2,2,304,115,189,nan
Stimme,12W617,12,Reinickendorf,617,W,126N,6,77,W,1189,926,263,0,306,0,1,305,142,163,nan
Stimme,12W618,12,Reinickendorf,618,W,126P,6,77,W,1263,964,299,0,312,3,3,309,136,173,nan
Stimme,12W619,12,Reinickendorf,619,W,126Q,6,77,W,1249,1001,248,0,417,4,5,412,177,235,nan
Stimme,12W620,12,Reinickendorf,620,W,126R,6,77,W,968,758,210,0,262,0,0,262,96,166,nan
Stimme,12W621,12,Reinickendorf,621,W,126S,6,77,W,916,704,212,0,249,9,0,249,122,127,nan
Stimme,12W622,12,Reinickendorf,622,W,126T,6,77,W,1079,790,289,0,259,1,0,259,90,169,nan
Stimme,12W623,12,Reinickendorf,623,W,126S,6,77,W,872,668,204,0,247,2,1,246,78,168,nan
Stimme,12W624,12,Reinickendorf,624,W,126U,6,77,W,1133,950,183,0,344,7,2,342,107,235,nan
Stimme,12W625,12,Reinickendorf,625,W,126V,6,77,W,1114,862,252,0,216,0,0,216,86,130,nan
Stimme,12W626,12,Reinickendorf,626,W,126W,6,77,W,1191,893,298,0,317,6,1,316,116,200,nan
Stimme,12B1A,12,Reinickendorf,1A,B,121A,1,77,W,0,0,0,0,455,455,2,453,171,282,nan
Stimme,12B1B,12,Reinickendorf,1B,B,121B,1,77,W,0,0,0,0,0,0,0,0,0,0,01B1A
Stimme,12B1C,12,Reinickendorf,1C,B,121C,1,77,W,0,0,0,0,368,368,1,367,171,196,nan
Stimme,12B1D,12,Reinickendorf,1D,B,121D,1,77,W,0,0,0,0,0,0,0,0,0,0,12B1C
Stimme,12B1E,12,Reinickendorf,1E,B,121E,1,77,W,0,0,0,0,485,485,0,485,178,307,nan
Stimme,12B1F,12,Reinickendorf,1F,B,121F,1,77,W,0,0,0,0,0,0,0,0,0,0,12B1E
Stimme,12B1G,12,Reinickendorf,1G,B,121G,1,77,W,0,0,0,0,497,497,1,496,178,318,nan
Stimme,12B1H,12,Reinickendorf,1H,B,121H,1,77,W,0,0,0,0,0,0,0,0,0,0,12B1G
Stimme,12B1I,12,Reinickendorf,1I,B,121I,1,77,W,0,0,0,0,469,469,1,468,233,235,nan
Stimme,12B1J,12,Reinickendorf,1J,B,121J,1,77,W,0,0,0,0,0,0,0,0,0,0,12B1I
Stimme,12B1K,12,Reinickendorf,1K,B,121K,1,77,W,0,0,0,0,787,787,4,783,388,395,nan
Stimme,12B1L,12,Reinickendorf,1L,B,121L,1,77,W,0,0,0,0,0,0,0,0,0,0,12B1K
Stimme,12B1M,12,Reinickendorf,1M,B,121M,1,77,W,0,0,0,0,0,0,0,0,0,0,12B1K
Stimme,12B2A,12,Reinickendorf,2A,B,122A,2,77,W,0,0,0,0,645,645,0,645,211,434,nan
Stimme,12B2B,12,Reinickendorf,2B,B,122B,2,77,W,0,0,0,0,0,0,0,0,0,0,12B2A
Stimme,12B2C,12,Reinickendorf,2C,B,122C,2,77,W,0,0,0,0,469,469,0,469,141,328,nan
Stimme,12B2D,12,Reinickendorf,2D,B,122D,2,77,W,0,0,0,0,0,0,0,0,0,0,12B2C
Stimme,12B2E,12,Reinickendorf,2E,B,122E,2,77,W,0,0,0,0,593,593,0,593,218,375,nan
Stimme,12B2F,12,Reinickendorf,2F,B,122F,2,77,W,0,0,0,0,0,0,0,0,0,0,12B2E
Stimme,12B2G,12,Reinickendorf,2G,B,122G,2,77,W,0,0,0,0,688,688,3,685,200,485,nan
Stimme,12B2H,12,Reinickendorf,2H,B,122H,2,77,W,0,0,0,0,0,0,0,0,0,0,12B2G
Stimme,12B2I,12,Reinickendorf,2I,B,122I,2,77,W,0,0,0,0,431,431,1,430,164,266,nan
Stimme,12B2J,12,Reinickendorf,2J,B,122J,2,77,W,0,0,0,0,0,0,0,0,0,0,12B2I
Stimme,12B2K,12,Reinickendorf,2K,B,122K,2,77,W,0,0,0,0,707,707,2,705,249,456,nan
Stimme,12B2L,12,Reinickendorf,2L,B,122L,2,77,W,0,0,0,0,0,0,0,0,0,0,12B2K
Stimme,12B2M,12,Reinickendorf,2M,B,122M,2,77,W,0,0,0,0,0,0,0,0,0,0,12B2K
Stimme,12B3A,12,Reinickendorf,3A,B,123A,3,77,W,0,0,0,0,695,695,1,694,185,509,nan
Stimme,12B3B,12,Reinickendorf,3B,B,123B,3,77,W,0,0,0,0,0,0,0,0,0,0,12B3A
Stimme,12B3C,12,Reinickendorf,3C,B,123C,3,77,W,0,0,0,0,848,848,1,847,248,599,nan
Stimme,12B3D,12,Reinickendorf,3D,B,123D,3,77,W,0,0,0,0,931,931,5,926,327,599,nan
Stimme,12B3E,12,Reinickendorf,3E,B,123E,3,77,W,0,0,0,0,0,0,0,0,0,0,12B3C
Stimme,12B3F,12,Reinickendorf,3F,B,123F,3,77,W,0,0,0,0,880,880,1,879,249,630,nan
Stimme,12B3G,12,Reinickendorf,3G,B,123G,3,77,W,0,0,0,0,0,0,0,0,0,0,12B3F
Stimme,12B3H,12,Reinickendorf,3H,B,123H,3,77,W,0,0,0,0,0,0,0,0,0,0,12B3D
Stimme,12B3I,12,Reinickendorf,3I,B,123I,3,77,W,0,0,0,0,0,0,0,0,0,0,12B3P
Stimme,12B3J,12,Reinickendorf,3J,B,123J,3,77,W,0,0,0,0,599,599,3,596,261,335,nan
Stimme,12B3K,12,Reinickendorf,3K,B,123K,3,77,W,0,0,0,0,732,732,0,732,245,487,nan
Stimme,12B3L,12,Reinickendorf,3L,B,123L,3,77,W,0,0,0,0,0,0,0,0,0,0,12B3K
Stimme,12B3M,12,Reinickendorf,3M,B,123M,3,77,W,0,0,0,0,0,0,0,0,0,0,12B3K
Stimme,12B3N,12,Reinickendorf,3N,B,123N,3,77,W,0,0,0,0,0,0,0,0,0,0,12B3J
Stimme,12B3P,12,Reinickendorf,3P,B,123P,3,77,W,0,0,0,0,703,703,3,700,218,482,nan
Stimme,12B4A,12,Reinickendorf,4A,B,124A,4,77,W,0,0,0,0,892,892,2,890,374,516,nan
Stimme,12B4B,12,Reinickendorf,4B,B,124B,4,77,W,0,0,0,0,597,597,1,596,200,396,nan
Stimme,12B4C,12,Reinickendorf,4C,B,124C,4,77,W,0,0,0,0,0,0,0,0,0,0,12B4B
Stimme,12B4D,12,Reinickendorf,4D,B,124D,4,77,W,0,0,0,0,895,895,1,894,319,575,nan
Stimme,12B4E,12,Reinickendorf,4E,B,124E,4,77,W,0,0,0,0,0,0,0,0,0,0,12B4D
Stimme,12B4F,12,Reinickendorf,4F,B,124F,4,77,W,0,0,0,0,0,0,0,0,0,0,12B4A
Stimme,12B4G,12,Reinickendorf,4G,B,124G,4,77,W,0,0,0,0,706,706,2,704,246,458,nan
Stimme,12B4H,12,Reinickendorf,4H,B,124H,4,77,W,0,0,0,0,0,0,0,0,0,0,12B4G
Stimme,12B4I,12,Reinickendorf,4I,B,124I,4,77,W,0,0,0,0,750,750,1,749,316,433,nan
Stimme,12B4J,12,Reinickendorf,4J,B,124J,4,77,W,0,0,0,0,548,548,1,547,180,367,nan
Stimme,12B4K,12,Reinickendorf,4K,B,124K,4,77,W,0,0,0,0,576,576,0,576,197,379,nan
Stimme,12B4L,12,Reinickendorf,4L,B,124L,4,77,W,0,0,0,0,0,0,0,0,0,0,12B4K
Stimme,12B4M,12,Reinickendorf,4M,B,124M,4,77,W,0,0,0,0,0,0,0,0,0,0,12B4J
Stimme,12B4N,12,Reinickendorf,4N,B,124N,4,77,W,0,0,0,0,0,0,0,0,0,0,12B4I
Stimme,12B5A,12,Reinickendorf,5A,B,125A,5,77,W,0,0,0,0,855,855,2,853,241,612,nan
Stimme,12B5B,12,Reinickendorf,5B,B,125B,5,77,W,0,0,0,0,0,0,0,0,0,0,12B5A
Stimme,12B5C,12,Reinickendorf,5C,B,125C,5,77,W,0,0,0,0,472,472,1,471,113,358,nan
Stimme,12B5D,12,Reinickendorf,5D,B,125D,5,77,W,0,0,0,0,0,0,0,0,0,0,12B5C
Stimme,12B5E,12,Reinickendorf,5E,B,125E,5,77,W,0,0,0,0,357,357,0,357,129,228,nan
Stimme,12B5F,12,Reinickendorf,5F,B,125F,5,77,W,0,0,0,0,384,384,0,384,116,268,nan
Stimme,12B5G,12,Reinickendorf,5G,B,125G,5,77,W,0,0,0,0,0,0,0,0,0,0,12B5F
Stimme,12B5H,12,Reinickendorf,5H,B,125H,5,77,W,0,0,0,0,681,681,2,679,184,495,nan
Stimme,12B5I,12,Reinickendorf,5I,B,125I,5,77,W,0,0,0,0,0,0,0,0,0,0,12B5H
Stimme,12B5J,12,Reinickendorf,5J,B,125J,5,77,W,0,0,0,0,0,0,0,0,0,0,12B5E
Stimme,12B6A,12,Reinickendorf,6A,B,126A,6,77,W,0,0,0,0,590,590,1,589,189,400,nan
Stimme,12B6B,12,Reinickendorf,6B,B,126B,6,77,W,0,0,0,0,0,0,0,0,0,0,12B6A
Stimme,12B6C,12,Reinickendorf,6C,B,126C,6,77,W,0,0,0,0,671,671,1,670,219,451,nan
Stimme,12B6D,12,Reinickendorf,6D,B,126D,6,77,W,0,0,0,0,412,412,1,411,145,266,nan
Stimme,12B6E,12,Reinickendorf,6E,B,126E,6,77,W,0,0,0,0,0,0,0,0,0,0,12B6D
Stimme,12B6F,12,Reinickendorf,6F,B,126F,6,77,W,0,0,0,0,500,500,3,497,144,353,nan
Stimme,12B6G,12,Reinickendorf,6G,B,126G,6,77,W,0,0,0,0,0,0,0,0,0,0,12B6F
Stimme,12B6H,12,Reinickendorf,6H,B,126H,6,77,W,0,0,0,0,561,561,0,561,192,369,nan
Stimme,12B6I,12,Reinickendorf,6I,B,126I,6,77,W,0,0,0,0,0,0,0,0,0,0,12B6H
Stimme,12B6J,12,Reinickendorf,6J,B,126J,6,77,W,0,0,0,0,0,0,0,0,0,0,12B6C
Stimme,12B6K,12,Reinickendorf,6K,B,126K,6,77,W,0,0,0,0,536,536,1,535,197,338,nan
Stimme,12B6L,12,Reinickendorf,6L,B,126L,6,77,W,0,0,0,0,0,0,0,0,0,0,12B6K
Stimme,12B6M,12,Reinickendorf,6M,B,126M,6,77,W,0,0,0,0,519,519,1,518,175,343,nan
Stimme,12B6N,12,Reinickendorf,6N,B,126N,6,77,W,0,0,0,0,425,425,0,425,148,277,nan
Stimme,12B6P,12,Reinickendorf,6P,B,126P,6,77,W,0,0,0,0,0,0,0,0,0,0,12B6Q
Stimme,12B6Q,12,Reinickendorf,6Q,B,126Q,6,77,W,0,0,0,0,461,461,5,456,185,271,nan
Stimme,12B6R,12,Reinickendorf,6R,B,126R,6,77,W,0,0,0,0,0,0,0,0,0,0,12B6N
Stimme,12B6S,12,Reinickendorf,6S,B,126S,6,77,W,0,0,0,0,617,617,1,616,204,412,nan
Stimme,12B6T,12,Reinickendorf,6T,B,126T,6,77,W,0,0,0,0,0,0,0,0,0,0,12B6S
Stimme,12B6U,12,Reinickendorf,6U,B,126U,6,77,W,0,0,0,0,380,380,3,377,124,253,nan
Stimme,12B6V,12,Reinickendorf,6V,B,126V,6,77,W,0,0,0,0,0,0,0,0,0,0,12B6U
Stimme,12B6W,12,Reinickendorf,6W,B,126W,6,77,W,0,0,0,0,0,0,0,0,0,0,12B6M
