address,vote_type,district_id,district_name,electoral_district_id,electoral_district_type,electoral_district_berlin_election_id,electoral_district_federal_election_id,berlin_east_west,eligible_voters,eligible_voters_a1,eligible_voters_a2,eligible_voters_a3,voters,voters_b1,invalid_votes,valid_votes,vote_yes,vote_no
01W100,,01,Mitte,100,,1,75,W,1269,1037,232,0,572,5,13,559,358,201
01W101,,01,Mitte,101,,1,75,O,1490,975,515,0,757,14,3,754,413,341
01W102,,01,Mitte,102,,1,75,O,1306,813,493,0,603,5,10,593,357,236
01W103,,01,Mitte,103,,1,75,O,1555,980,575,0,772,0,13,759,466,293
01W104,,01,Mitte,104,,1,75,O,1241,768,473,0,611,17,16,595,336,259
01W105,,01,Mitte,105,,1,75,O,1049,689,360,0,509,6,15,494,273,221
01W106,,01,Mitte,106,,1,75,O,1407,826,581,0,662,15,8,654,408,246
01W107,,01,Mitte,107,,1,75,O,1111,763,348,0,612,0,8,604,341,263
01W108,,01,Mitte,108,,1,75,O,1004,628,376,0,483,8,7,476,270,206
01W109,,01,Mitte,109,,1,75,W,1133,900,233,0,536,4,16,520,352,168
01W110,,01,Mitte,110,,1,75,O,1552,999,553,0,841,14,13,828,424,404
01W111,,01,Mitte,111,,1,75,O,1010,665,345,0,549,14,6,543,300,243
01W112,,01,Mitte,112,,1,75,O,1194,790,404,0,599,15,16,583,299,284
01W113,,01,Mitte,113,,1,75,O,1172,785,387,0,673,20,19,654,320,334
01W114,,01,Mitte,114,,1,75,O,1447,952,495,0,740,21,18,722,400,322
01W115,,01,Mitte,115,,1,75,O,866,638,228,0,481,7,6,475,293,182
01W116,,01,Mitte,116,,1,75,O,697,452,245,0,378,9,10,368,214,154
01W117,,01,Mitte,117,,1,75,O,1486,1038,448,0,861,12,22,839,415,424
01W118,,01,Mitte,118,,1,75,O,1148,797,351,0,664,0,20,644,316,328
01W119,,01,Mitte,119,,1,75,O,877,603,274,0,506,12,7,499,211,288
01W120,,01,Mitte,120,,1,75,O,1066,679,387,0,544,17,13,531,262,269
01W121,,01,Mitte,121,,1,75,O,1089,683,406,0,554,0,16,538,286,252
01W122,,01,Mitte,122,,1,75,O,1204,787,417,0,643,25,13,630,313,317
01W123,,01,Mitte,123,,1,75,O,1006,693,313,0,520,14,13,507,261,246
01W200,,01,Mitte,200,,2,75,O,896,642,254,0,448,3,9,439,265,174
01W201,,01,Mitte,201,,2,75,O,1114,748,366,0,532,12,3,529,357,172
01W202,,01,Mitte,202,,2,75,O,1131,695,436,0,470,8,8,462,289,173
01W203,,01,Mitte,203,,2,75,O,1071,634,437,0,392,5,8,384,210,174
01W204,,01,Mitte,204,,2,75,O,1931,1184,747,0,832,12,12,820,514,306
01W205,,01,Mitte,205,,2,75,O,1222,859,363,0,563,5,11,552,297,255
01W206,,01,Mitte,206,,2,75,O,1355,886,469,0,561,6,23,538,298,240
01W207,,01,Mitte,207,,2,75,O,1138,727,411,0,531,5,19,512,263,249
01W208,,01,Mitte,208,,2,75,O,894,545,349,0,432,11,8,424,222,202
01W209,,01,Mitte,209,,2,75,O,1235,854,381,0,640,9,21,619,316,303
01W210,,01,Mitte,210,,2,75,O,1135,764,371,0,585,6,16,569,303,266
01W211,,01,Mitte,211,,2,75,O,880,656,224,0,465,3,13,452,226,226
01W212,,01,Mitte,212,,2,75,O,866,594,272,0,480,14,19,461,266,195
01W213,,01,Mitte,213,,2,75,O,640,446,194,0,295,8,8,287,168,119
01W214,,01,Mitte,214,,2,75,O,830,540,290,0,354,4,8,346,168,178
01W215,,01,Mitte,215,,2,75,O,1016,685,331,0,526,1,5,521,268,253
01W216,,01,Mitte,216,,2,75,O,945,646,299,0,491,3,15,476,237,239
01W217,,01,Mitte,217,,2,75,O,1072,773,299,0,449,3,11,438,224,214
01W218,,01,Mitte,218,,2,75,O,1525,1140,385,0,801,14,24,777,403,374
01W219,,01,Mitte,219,,2,75,O,342,273,69,0,172,0,8,164,99,65
01W220,,01,Mitte,220,,2,75,O,785,535,250,0,345,5,12,333,163,170
01W221,,01,Mitte,221,,2,75,O,1491,991,500,0,717,0,17,700,384,316
01W222,,01,Mitte,222,,2,75,O,903,632,271,0,425,5,5,420,214,206
01W223,,01,Mitte,223,,2,75,O,1499,977,522,0,771,10,16,755,327,428
01W224,,01,Mitte,224,,2,75,O,837,586,251,0,402,3,17,385,201,184
01W225,,01,Mitte,225,,2,75,O,1367,928,439,0,677,1,16,661,327,334
01W226,,01,Mitte,226,,2,75,O,758,590,168,0,393,7,18,375,173,202
01W227,,01,Mitte,227,,2,75,O,1362,953,409,0,711,7,10,701,292,409
01W228,,01,Mitte,228,,2,75,O,2280,1500,780,0,1095,12,21,1074,534,540
01W300,,01,Mitte,300,,3,75,W,1302,997,305,0,608,7,12,596,373,223
01W301,,01,Mitte,301,,3,75,W,871,624,247,0,438,0,7,431,241,190
01W302,,01,Mitte,302,,3,75,W,1187,904,283,0,577,5,11,566,364,202
01W303,,01,Mitte,303,,3,75,W,888,696,192,0,427,6,17,410,275,135
01W304,,01,Mitte,304,,3,75,W,942,688,254,0,527,8,5,522,305,217
01W305,,01,Mitte,305,,3,75,W,1043,723,320,0,558,1,17,541,320,221
01W306,,01,Mitte,306,,3,75,W,1356,918,438,0,707,9,9,698,378,320
01W307,,01,Mitte,307,,3,75,W,1137,823,314,0,657,3,19,638,383,255
01W308,,01,Mitte,308,,3,75,W,1145,809,336,0,629,6,8,621,339,282
01W309,,01,Mitte,309,,3,75,W,1268,885,383,0,731,14,17,714,399,315
01W310,,01,Mitte,310,,3,75,W,900,616,284,0,487,4,10,477,285,192
01W311,,01,Mitte,311,,3,75,W,1037,637,400,0,478,6,11,467,272,195
01W312,,01,Mitte,312,,3,75,W,783,494,289,0,380,7,8,372,220,152
01W313,,01,Mitte,313,,3,75,W,825,568,257,0,407,7,6,401,245,156
01W314,,01,Mitte,314,,3,75,W,1085,803,282,0,559,4,11,548,358,190
01W315,,01,Mitte,315,,3,75,W,831,605,226,0,386,5,10,376,233,143
01W316,,01,Mitte,316,,3,75,W,1215,979,236,0,634,6,12,622,448,174
01W317,,01,Mitte,317,,3,75,W,745,563,182,0,387,0,2,385,225,160
01W318,,01,Mitte,318,,3,75,W,1116,724,392,0,545,6,12,533,340,193
01W319,,01,Mitte,319,,3,75,W,998,630,368,0,471,3,6,465,293,172
01W320,,01,Mitte,320,,3,75,W,591,385,206,0,322,4,7,315,168,147
01W321,,01,Mitte,321,,3,75,W,997,667,330,0,465,3,10,455,300,155
01W322,,01,Mitte,322,,3,75,W,1127,771,356,0,487,3,6,481,354,127
01W323,,01,Mitte,323,,3,75,W,1153,806,347,0,597,6,17,580,371,209
01W324,,01,Mitte,324,,3,75,W,1583,1043,540,0,630,0,13,617,423,194
01W325,,01,Mitte,325,,3,75,W,998,763,235,0,403,0,13,390,251,139
01W326,,01,Mitte,326,,3,75,W,1174,840,334,0,593,3,10,583,342,241
01W327,,01,Mitte,327,,3,75,W,1471,1050,421,0,691,14,11,680,357,323
01W400,,01,Mitte,400,,4,75,W,1351,1031,320,0,629,6,14,615,404,211
01W401,,01,Mitte,401,,4,75,W,924,736,188,0,456,5,6,450,278,172
01W402,,01,Mitte,402,,4,75,W,1308,1082,226,0,617,2,14,603,399,204
01W403,,01,Mitte,403,,4,75,W,1010,744,266,0,506,8,18,488,259,229
01W404,,01,Mitte,404,,4,75,W,704,545,159,0,350,4,10,340,208,132
01W405,,01,Mitte,405,,4,75,W,790,622,168,0,407,0,8,399,257,142
01W406,,01,Mitte,406,,4,75,W,847,639,208,0,449,9,22,427,231,196
01W407,,01,Mitte,407,,4,75,W,1191,902,289,0,642,11,11,631,393,238
01W408,,01,Mitte,408,,4,75,W,995,728,267,0,543,7,16,527,273,254
01W409,,01,Mitte,409,,4,75,W,960,696,264,0,494,2,8,486,303,183
01W410,,01,Mitte,410,,4,75,W,1274,929,345,0,686,8,11,675,394,281
01W411,,01,Mitte,411,,4,75,W,1076,799,277,0,522,0,5,517,333,184
01W412,,01,Mitte,412,,4,75,W,894,646,248,0,460,0,17,443,252,191
01W413,,01,Mitte,413,,4,75,W,863,653,210,0,444,5,10,434,263,171
01W414,,01,Mitte,414,,4,75,W,838,641,197,0,420,5,2,418,231,187
01W415,,01,Mitte,415,,4,75,W,861,603,258,0,464,0,13,451,245,206
01W416,,01,Mitte,416,,4,75,W,1075,810,265,0,550,6,16,534,339,195
01W417,,01,Mitte,417,,4,75,W,1168,879,289,0,540,5,8,532,310,222
01W418,,01,Mitte,418,,4,75,W,1119,851,268,0,501,6,7,494,321,173
01W419,,01,Mitte,419,,4,75,W,1268,950,318,0,672,9,11,661,382,279
01W420,,01,Mitte,420,,4,75,W,983,733,250,0,541,11,13,528,305,223
01W421,,01,Mitte,421,,4,75,W,813,638,175,0,434,2,5,429,271,158
01W422,,01,Mitte,422,,4,75,W,1008,710,298,0,447,8,9,438,238,200
01W423,,01,Mitte,423,,4,75,W,876,690,186,0,413,4,12,401,245,156
01W424,,01,Mitte,424,,4,75,W,1229,923,306,0,627,6,17,610,337,273
01W425,,01,Mitte,425,,4,75,W,1316,973,343,0,685,10,11,674,335,339
01W426,,01,Mitte,426,,4,75,W,1268,906,362,0,596,6,13,583,313,270
01W427,,01,Mitte,427,,4,75,W,866,621,245,0,400,0,4,396,207,189
01W428,,01,Mitte,428,,4,75,W,819,559,260,0,360,0,9,351,205,146
01W500,,01,Mitte,500,,5,75,W,1017,717,300,0,464,3,6,458,281,177
01W501,,01,Mitte,501,,5,75,W,834,632,202,0,417,2,7,410,218,192
01W502,,01,Mitte,502,,5,75,W,547,438,109,0,232,0,3,229,128,101
01W503,,01,Mitte,503,,5,75,W,1064,814,250,0,558,0,5,553,199,354
01W504,,01,Mitte,504,,5,75,W,667,535,132,0,308,1,4,304,204,100
01W505,,01,Mitte,505,,5,75,W,956,763,193,0,434,0,5,429,251,178
01W506,,01,Mitte,506,,5,75,W,983,710,273,0,496,1,3,493,226,267
01W507,,01,Mitte,507,,5,75,W,1480,1094,386,0,748,6,8,740,324,416
01W508,,01,Mitte,508,,5,75,W,1211,858,353,0,654,2,3,651,315,336
01W509,,01,Mitte,509,,5,75,W,1125,911,214,0,534,0,4,530,299,231
01W510,,01,Mitte,510,,5,75,W,1057,869,188,0,544,0,10,534,312,222
01W511,,01,Mitte,511,,5,75,W,1118,894,224,0,495,1,6,489,289,200
01W512,,01,Mitte,512,,5,75,W,1027,834,193,0,399,1,9,390,235,155
01W513,,01,Mitte,513,,5,75,W,1357,1073,284,0,698,6,8,690,346,344
01W514,,01,Mitte,514,,5,75,W,1035,813,222,0,487,4,10,477,270,207
01W515,,01,Mitte,515,,5,75,W,1324,1078,246,0,676,7,10,666,386,280
01W516,,01,Mitte,516,,5,75,W,985,777,208,0,457,1,5,452,272,180
01W517,,01,Mitte,517,,5,75,W,1364,1056,308,0,592,4,7,585,305,280
01W518,,01,Mitte,518,,5,75,W,1292,1030,262,0,562,3,6,556,316,240
01W519,,01,Mitte,519,,5,75,W,1314,1009,305,0,674,8,26,648,333,315
01W520,,01,Mitte,520,,5,75,W,1371,1031,340,0,672,3,11,661,329,332
01W521,,01,Mitte,521,,5,75,W,1287,1043,244,0,475,1,6,469,301,168
01W522,,01,Mitte,522,,5,75,W,889,619,270,0,423,1,0,423,207,216
01W523,,01,Mitte,523,,5,75,W,649,492,157,0,369,0,5,364,214,150
01W524,,01,Mitte,524,,5,75,W,853,606,247,0,409,0,12,397,218,179
01W525,,01,Mitte,525,,5,75,W,859,654,205,0,432,5,12,420,201,219
01W526,,01,Mitte,526,,5,75,W,1481,1046,435,0,703,7,10,693,342,351
01W600,,01,Mitte,600,,6,75,W,1457,1146,311,0,619,7,12,607,288,319
01W601,,01,Mitte,601,,6,75,W,792,633,159,0,420,2,10,410,191,219
01W602,,01,Mitte,602,,6,75,W,1040,807,233,0,577,2,1,576,203,373
01W603,,01,Mitte,603,,6,75,W,907,729,178,0,432,4,7,425,191,234
01W604,,01,Mitte,604,,6,75,W,849,703,146,0,353,0,4,349,196,153
01W605,,01,Mitte,605,,6,75,W,1090,860,230,0,497,0,9,488,249,239
01W606,,01,Mitte,606,,6,75,W,835,648,187,0,405,1,13,392,174,218
01W607,,01,Mitte,607,,6,75,W,861,686,175,0,304,3,9,295,131,164
01W608,,01,Mitte,608,,6,75,W,1017,809,208,0,431,6,16,415,189,226
01W609,,01,Mitte,609,,6,75,W,1094,908,186,0,552,2,6,546,264,282
01W610,,01,Mitte,610,,6,75,W,1122,954,168,0,524,9,5,519,266,253
01W611,,01,Mitte,611,,6,75,W,1363,1099,264,0,664,6,9,655,356,299
01W612,,01,Mitte,612,,6,75,W,975,796,179,0,441,4,4,437,218,219
01W613,,01,Mitte,613,,6,75,W,1435,1106,329,0,687,0,12,675,343,332
01W614,,01,Mitte,614,,6,75,W,1180,887,293,0,615,7,12,603,330,273
01W615,,01,Mitte,615,,6,75,W,896,737,159,0,389,0,6,383,212,171
01W616,,01,Mitte,616,,6,75,W,1123,843,280,0,537,4,7,530,228,302
01W617,,01,Mitte,617,,6,75,W,1031,804,227,0,493,5,18,475,262,213
01W618,,01,Mitte,618,,6,75,W,1402,1128,274,0,646,5,18,628,323,305
01W619,,01,Mitte,619,,6,75,W,1221,945,276,0,611,6,20,591,305,286
01W620,,01,Mitte,620,,6,75,W,976,782,194,0,445,1,9,436,256,180
01W621,,01,Mitte,621,,6,75,W,980,851,129,0,419,5,18,401,252,149
01W622,,01,Mitte,622,,6,75,W,662,540,122,0,263,0,8,255,146,109
01W623,,01,Mitte,623,,6,75,W,901,676,225,0,353,3,6,347,164,183
01W624,,01,Mitte,624,,6,75,W,1248,1017,231,0,501,5,23,478,273,205
01W625,,01,Mitte,625,,6,75,W,1017,847,170,0,488,3,12,476,295,181
01W700,,01,Mitte,700,,7,75,W,804,636,168,0,355,0,4,351,233,118
01W701,,01,Mitte,701,,7,75,W,1306,904,402,0,611,5,20,591,267,324
01W702,,01,Mitte,702,,7,75,W,1076,838,238,0,481,5,13,468,281,187
01W703,,01,Mitte,703,,7,75,W,841,661,180,0,406,3,10,396,234,162
01W704,,01,Mitte,704,,7,75,W,849,620,229,0,381,1,11,370,192,178
01W705,,01,Mitte,705,,7,75,W,968,686,282,0,484,7,14,470,221,249
01W706,,01,Mitte,706,,7,75,W,1203,855,348,0,578,10,9,569,283,286
01W707,,01,Mitte,707,,7,75,W,1209,890,319,0,650,7,16,634,340,294
01W708,,01,Mitte,708,,7,75,W,1141,874,267,0,554,2,5,549,303,246
01W709,,01,Mitte,709,,7,75,W,1087,829,258,0,533,5,12,521,272,249
01W710,,01,Mitte,710,,7,75,W,1300,1005,295,0,587,1,15,572,346,226
01W711,,01,Mitte,711,,7,75,W,1056,800,256,0,529,6,9,520,298,222
01W712,,01,Mitte,712,,7,75,W,1255,1010,245,0,576,0,10,566,330,236
01W713,,01,Mitte,713,,7,75,W,919,698,221,0,372,4,5,367,237,130
01W714,,01,Mitte,714,,7,75,W,1091,892,199,0,480,4,14,466,273,193
01W715,,01,Mitte,715,,7,75,W,1182,995,187,0,569,6,11,558,374,184
01W716,,01,Mitte,716,,7,75,W,913,755,158,0,446,0,9,437,299,138
01W717,,01,Mitte,717,,7,75,W,1127,932,195,0,534,4,8,526,356,170
01W718,,01,Mitte,718,,7,75,W,844,758,86,0,366,1,11,355,223,132
01W719,,01,Mitte,719,,7,75,W,985,875,110,0,456,3,19,437,307,130
01W720,,01,Mitte,720,,7,75,W,1198,949,249,0,595,6,18,577,349,228
01W721,,01,Mitte,721,,7,75,W,1116,964,152,0,500,1,16,484,339,145
01W722,,01,Mitte,722,,7,75,W,1023,845,178,0,530,0,17,513,308,205
01W723,,01,Mitte,723,,7,75,W,1044,828,216,0,537,2,6,531,307,224
01W724,,01,Mitte,724,,7,75,W,895,752,143,0,451,0,10,441,292,149
01W725,,01,Mitte,725,,7,75,W,1029,857,172,0,473,7,12,461,322,139
02W101,,02,Friedrichshain-Kreuzberg,101,,1,83,W,1095,681,414,0,504,8,12,492,260,232
02W102,,02,Friedrichshain-Kreuzberg,102,,1,83,W,1760,1162,598,0,918,13,24,894,406,488
02W103,,02,Friedrichshain-Kreuzberg,103,,1,83,W,1704,1115,589,0,864,16,33,831,380,451
02W104,,02,Friedrichshain-Kreuzberg,104,,1,83,W,1533,1039,494,0,821,13,24,797,400,397
02W105,,02,Friedrichshain-Kreuzberg,105,,1,83,W,1743,1176,567,0,859,12,22,837,478,359
02W106,,02,Friedrichshain-Kreuzberg,106,,1,83,W,1851,1267,584,0,973,11,33,940,452,488
02W107,,02,Friedrichshain-Kreuzberg,107,,1,83,W,1500,1026,474,0,697,8,19,678,323,355
02W108,,02,Friedrichshain-Kreuzberg,108,,1,83,W,1814,1236,578,0,938,17,18,920,444,476
02W109,,02,Friedrichshain-Kreuzberg,109,,1,83,W,1502,1064,438,0,812,12,26,786,333,453
02W110,,02,Friedrichshain-Kreuzberg,110,,1,83,W,1414,972,442,0,735,12,24,711,308,403
02W111,,02,Friedrichshain-Kreuzberg,111,,1,83,W,1597,1110,487,0,835,8,26,809,333,476
02W112,,02,Friedrichshain-Kreuzberg,112,,1,83,W,1748,1255,493,0,906,13,5,901,383,518
02W113,,02,Friedrichshain-Kreuzberg,113,,1,83,W,1518,974,544,0,805,10,33,772,290,482
02W114,,02,Friedrichshain-Kreuzberg,114,,1,83,W,1152,774,378,0,631,9,15,616,230,386
02W115,,02,Friedrichshain-Kreuzberg,115,,1,83,W,1329,895,434,0,697,4,4,693,293,400
02W116,,02,Friedrichshain-Kreuzberg,116,,1,83,W,1678,1147,531,0,889,13,36,853,361,492
02W117,,02,Friedrichshain-Kreuzberg,117,,1,83,W,1534,1216,318,0,761,7,19,742,366,376
02W118,,02,Friedrichshain-Kreuzberg,118,,1,83,W,1453,1054,399,0,696,14,33,663,257,406
02W119,,02,Friedrichshain-Kreuzberg,119,,1,83,W,1579,1094,485,0,837,13,36,801,305,496
02W120,,02,Friedrichshain-Kreuzberg,120,,1,83,W,1798,1285,513,0,920,21,31,889,387,502
02W121,,02,Friedrichshain-Kreuzberg,121,,1,83,W,1618,1085,533,0,879,14,25,854,323,531
02W122,,02,Friedrichshain-Kreuzberg,122,,1,83,W,1426,1136,290,0,696,8,23,673,301,372
02W201,,02,Friedrichshain-Kreuzberg,201,,2,83,W,1059,699,360,0,565,15,18,547,190,357
02W202,,02,Friedrichshain-Kreuzberg,202,,2,83,W,1351,1162,189,0,613,4,19,594,333,261
02W203,,02,Friedrichshain-Kreuzberg,203,,2,83,W,1150,853,297,0,579,3,14,565,268,297
02W204,,02,Friedrichshain-Kreuzberg,204,,2,83,W,869,652,217,0,476,8,14,462,202,260
02W205,,02,Friedrichshain-Kreuzberg,205,,2,83,W,1356,954,402,0,738,11,14,724,270,454
02W206,,02,Friedrichshain-Kreuzberg,206,,2,83,W,1374,972,402,0,686,26,30,656,256,400
02W207,,02,Friedrichshain-Kreuzberg,207,,2,83,W,1319,969,350,0,710,5,22,688,252,436
02W208,,02,Friedrichshain-Kreuzberg,208,,2,83,W,1084,760,324,0,595,13,19,576,263,313
02W209,,02,Friedrichshain-Kreuzberg,209,,2,83,W,1171,905,266,0,595,10,33,562,256,306
02W210,,02,Friedrichshain-Kreuzberg,210,,2,83,W,1166,820,346,0,573,10,32,541,199,342
02W211,,02,Friedrichshain-Kreuzberg,211,,2,83,W,1126,847,279,0,588,11,20,568,223,345
02W212,,02,Friedrichshain-Kreuzberg,212,,2,83,W,1207,884,323,0,722,14,23,699,234,465
02W213,,02,Friedrichshain-Kreuzberg,213,,2,83,W,1053,801,252,0,567,9,21,546,254,292
02W214,,02,Friedrichshain-Kreuzberg,214,,2,83,W,1427,1064,363,0,815,13,24,791,321,470
02W215,,02,Friedrichshain-Kreuzberg,215,,2,83,O,1702,1179,523,0,924,12,24,900,387,513
02W216,,02,Friedrichshain-Kreuzberg,216,,2,83,O,1302,867,435,0,680,8,38,642,274,368
02W217,,02,Friedrichshain-Kreuzberg,217,,2,83,O,1660,1111,549,0,938,10,29,909,349,560
02W218,,02,Friedrichshain-Kreuzberg,218,,2,83,O,1711,1174,537,0,901,6,37,864,364,500
02W219,,02,Friedrichshain-Kreuzberg,219,,2,83,O,974,671,303,0,517,6,20,497,195,302
02W220,,02,Friedrichshain-Kreuzberg,220,,2,83,O,1497,1066,431,0,832,7,23,809,338,471
02W221,,02,Friedrichshain-Kreuzberg,221,,2,83,O,1438,1014,424,0,760,5,30,730,330,400
02W222,,02,Friedrichshain-Kreuzberg,222,,2,83,O,1350,884,466,0,724,8,17,707,279,428
02W223,,02,Friedrichshain-Kreuzberg,223,,2,83,O,1697,1266,431,0,868,8,19,849,462,387
02W224,,02,Friedrichshain-Kreuzberg,224,,2,83,O,1423,1042,381,0,775,8,20,755,331,424
02W225,,02,Friedrichshain-Kreuzberg,225,,2,83,O,1445,1018,427,0,768,10,24,744,308,436
02W226,,02,Friedrichshain-Kreuzberg,226,,2,83,O,1474,1042,432,0,887,17,15,872,404,468
02W301,,02,Friedrichshain-Kreuzberg,301,,3,83,W,1199,991,208,0,603,3,10,593,360,233
02W302,,02,Friedrichshain-Kreuzberg,302,,3,83,W,1577,1299,278,0,724,5,37,687,437,250
02W303,,02,Friedrichshain-Kreuzberg,303,,3,83,W,557,478,79,0,251,2,6,245,155,90
02W304,,02,Friedrichshain-Kreuzberg,304,,3,83,W,1378,1093,285,0,654,8,21,633,334,299
02W305,,02,Friedrichshain-Kreuzberg,305,,3,83,W,1294,1106,188,0,607,3,10,597,387,210
02W306,,02,Friedrichshain-Kreuzberg,306,,3,83,W,1380,1107,273,0,665,6,6,659,434,225
02W307,,02,Friedrichshain-Kreuzberg,307,,3,83,W,1557,1261,296,0,739,3,22,717,420,297
02W308,,02,Friedrichshain-Kreuzberg,308,,3,83,W,1048,868,180,0,461,9,12,449,264,185
02W309,,02,Friedrichshain-Kreuzberg,309,,3,83,W,1302,1095,207,0,641,5,15,626,414,212
02W310,,02,Friedrichshain-Kreuzberg,310,,3,83,W,1282,911,371,0,663,6,21,642,344,298
02W311,,02,Friedrichshain-Kreuzberg,311,,3,83,W,1208,850,358,0,643,10,23,620,242,378
02W312,,02,Friedrichshain-Kreuzberg,312,,3,83,W,1647,1197,450,0,863,18,29,834,347,487
02W313,,02,Friedrichshain-Kreuzberg,313,,3,83,W,1247,1037,210,0,556,3,13,543,378,165
02W314,,02,Friedrichshain-Kreuzberg,314,,3,83,W,1467,1228,239,0,588,6,6,582,387,195
02W315,,02,Friedrichshain-Kreuzberg,315,,3,83,W,1458,1153,305,0,623,6,15,608,309,299
02W316,,02,Friedrichshain-Kreuzberg,316,,3,83,W,1220,1089,131,0,520,5,16,504,319,185
02W317,,02,Friedrichshain-Kreuzberg,317,,3,83,W,903,729,174,0,382,4,13,369,218,151
02W318,,02,Friedrichshain-Kreuzberg,318,,3,83,W,1190,956,234,0,590,10,27,563,282,281
02W319,,02,Friedrichshain-Kreuzberg,319,,3,83,W,1251,960,291,0,664,7,22,642,243,399
02W320,,02,Friedrichshain-Kreuzberg,320,,3,83,W,1559,1186,373,0,829,16,31,798,351,447
02W321,,02,Friedrichshain-Kreuzberg,321,,3,83,W,1460,1184,276,0,652,9,31,621,286,335
02W322,,02,Friedrichshain-Kreuzberg,322,,3,83,W,1362,983,379,0,736,9,24,712,289,423
02W323,,02,Friedrichshain-Kreuzberg,323,,3,83,W,1351,955,396,0,696,9,29,667,271,396
02W324,,02,Friedrichshain-Kreuzberg,324,,3,83,W,1258,946,312,0,624,8,25,599,306,293
02W325,,02,Friedrichshain-Kreuzberg,325,,3,83,W,1023,782,241,0,521,6,22,499,197,302
02W401,,02,Friedrichshain-Kreuzberg,401,,4,83,O,1181,810,371,0,591,8,12,579,292,287
02W402,,02,Friedrichshain-Kreuzberg,402,,4,83,O,1118,858,260,0,522,2,12,510,257,253
02W403,,02,Friedrichshain-Kreuzberg,403,,4,83,O,1320,966,354,0,681,1,18,663,343,320
02W404,,02,Friedrichshain-Kreuzberg,404,,4,83,O,1544,1158,386,0,739,7,20,719,356,363
02W405,,02,Friedrichshain-Kreuzberg,405,,4,83,O,1435,1063,372,0,745,3,23,722,360,362
02W406,,02,Friedrichshain-Kreuzberg,406,,4,83,O,831,563,268,0,426,6,13,413,211,202
02W407,,02,Friedrichshain-Kreuzberg,407,,4,83,O,959,621,338,0,563,13,11,552,243,309
02W408,,02,Friedrichshain-Kreuzberg,408,,4,83,O,1362,929,433,0,696,6,22,674,330,344
02W409,,02,Friedrichshain-Kreuzberg,409,,4,83,O,1018,748,270,0,528,12,10,518,252,266
02W410,,02,Friedrichshain-Kreuzberg,410,,4,83,O,1312,985,327,0,752,6,31,721,332,389
02W411,,02,Friedrichshain-Kreuzberg,411,,4,83,O,1355,966,389,0,777,4,21,756,319,437
02W412,,02,Friedrichshain-Kreuzberg,412,,4,83,O,1358,1005,353,0,678,9,26,652,313,339
02W413,,02,Friedrichshain-Kreuzberg,413,,4,83,O,1599,1111,488,0,853,7,17,836,351,485
02W414,,02,Friedrichshain-Kreuzberg,414,,4,83,O,1425,968,457,0,703,11,21,682,296,386
02W415,,02,Friedrichshain-Kreuzberg,415,,4,83,O,1851,1252,599,0,911,6,13,898,438,460
02W416,,02,Friedrichshain-Kreuzberg,416,,4,83,O,1483,1025,458,0,653,5,12,641,314,327
02W417,,02,Friedrichshain-Kreuzberg,417,,4,83,O,1699,1220,479,0,815,5,21,794,378,416
02W418,,02,Friedrichshain-Kreuzberg,418,,4,83,O,1140,818,322,0,582,2,17,565,278,287
02W419,,02,Friedrichshain-Kreuzberg,419,,4,83,O,1653,1218,434,1,910,12,17,893,422,471
02W420,,02,Friedrichshain-Kreuzberg,420,,4,83,O,1401,965,436,0,786,8,11,775,361,414
02W421,,02,Friedrichshain-Kreuzberg,421,,4,83,O,1251,805,446,0,667,10,22,645,251,394
02W422,,02,Friedrichshain-Kreuzberg,422,,4,83,O,1456,1049,407,0,822,9,30,792,328,464
02W423,,02,Friedrichshain-Kreuzberg,423,,4,83,O,948,677,271,0,448,6,8,440,223,217
02W424,,02,Friedrichshain-Kreuzberg,424,,4,83,O,1221,892,329,0,555,6,21,534,272,262
02W425,,02,Friedrichshain-Kreuzberg,425,,4,83,O,1652,1263,389,0,859,7,15,844,440,404
02W426,,02,Friedrichshain-Kreuzberg,426,,4,83,O,872,678,194,0,441,3,16,425,241,184
02W501,,02,Friedrichshain-Kreuzberg,501,,5,83,O,1621,1162,459,0,862,7,28,834,376,458
02W502,,02,Friedrichshain-Kreuzberg,502,,5,83,O,1776,1266,510,0,972,0,25,947,444,503
02W503,,02,Friedrichshain-Kreuzberg,503,,5,83,O,966,708,258,0,565,2,16,549,239,310
02W504,,02,Friedrichshain-Kreuzberg,504,,5,83,O,1512,1051,461,0,779,7,24,755,344,411
02W505,,02,Friedrichshain-Kreuzberg,505,,5,83,O,1656,1167,489,0,836,6,26,810,344,466
02W506,,02,Friedrichshain-Kreuzberg,506,,5,83,O,1838,1248,590,0,933,11,35,898,380,518
02W507,,02,Friedrichshain-Kreuzberg,507,,5,83,O,1568,1060,508,0,865,7,22,843,368,475
02W508,,02,Friedrichshain-Kreuzberg,508,,5,83,O,1807,1242,565,0,993,12,14,979,446,533
02W509,,02,Friedrichshain-Kreuzberg,509,,5,83,O,1471,1010,461,0,804,10,25,779,312,467
02W510,,02,Friedrichshain-Kreuzberg,510,,5,83,O,2064,1418,646,0,1142,10,25,1117,482,635
02W511,,02,Friedrichshain-Kreuzberg,511,,5,83,O,1202,812,390,0,598,4,17,581,255,326
02W512,,02,Friedrichshain-Kreuzberg,512,,5,83,O,1307,918,389,0,661,5,24,637,285,352
02W513,,02,Friedrichshain-Kreuzberg,513,,5,83,O,1271,936,335,0,711,2,26,685,338,347
02W514,,02,Friedrichshain-Kreuzberg,514,,5,83,O,1430,1002,428,0,780,10,29,751,324,427
02W515,,02,Friedrichshain-Kreuzberg,515,,5,83,O,1547,1125,422,0,806,17,25,781,371,410
02W516,,02,Friedrichshain-Kreuzberg,516,,5,83,O,1259,878,381,0,661,4,28,633,291,342
02W517,,02,Friedrichshain-Kreuzberg,517,,5,83,O,1236,843,393,0,666,7,12,654,270,384
02W518,,02,Friedrichshain-Kreuzberg,518,,5,83,O,962,659,303,0,512,10,22,490,195,295
02W519,,02,Friedrichshain-Kreuzberg,519,,5,83,O,1429,966,463,0,793,9,30,763,313,450
02W520,,02,Friedrichshain-Kreuzberg,520,,5,83,O,1657,1094,563,0,807,14,30,777,300,477
02W521,,02,Friedrichshain-Kreuzberg,521,,5,83,O,1521,1022,499,0,785,5,29,756,298,458
02W522,,02,Friedrichshain-Kreuzberg,522,,5,83,O,1398,972,426,0,730,4,12,718,329,389
02W523,,02,Friedrichshain-Kreuzberg,523,,5,83,O,961,631,330,0,481,5,16,465,203,262
02W524,,02,Friedrichshain-Kreuzberg,524,,5,83,O,1323,864,459,0,676,8,19,657,270,387
03W101,,03,Pankow,101,,1,76,,2133,1568,565,0,1121,5,27,1094,545,549
03W102,,03,Pankow,102,,1,76,,1850,1281,569,0,875,0,13,862,454,408
03W103,,03,Pankow,103,,1,76,,1447,1218,229,0,644,1,20,624,327,297
03W104,,03,Pankow,104,,1,76,,1508,1161,347,0,672,2,19,653,371,282
03W105,,03,Pankow,105,,1,76,,1104,852,252,0,598,1,10,588,309,279
03W106,,03,Pankow,106,,1,76,,1408,1236,172,0,635,1,4,631,414,217
03W107,,03,Pankow,107,,1,76,,916,766,150,0,457,0,2,455,299,156
03W108,,03,Pankow,108,,1,76,,1419,1191,228,0,756,1,24,732,441,291
03W109,,03,Pankow,109,,1,76,,1529,1189,340,0,897,3,17,880,504,376
03W110,,03,Pankow,110,,1,76,,1488,1232,256,0,823,2,17,806,476,330
03W111,,03,Pankow,111,,1,76,,1285,996,289,0,765,3,6,759,406,353
03W112,,03,Pankow,112,,1,76,,1323,1003,320,0,734,5,15,719,376,343
03W113,,03,Pankow,113,,1,76,,1538,1220,318,0,985,3,19,966,465,501
03W114,,03,Pankow,114,,1,76,,1333,943,390,0,775,7,5,770,350,420
03W115,,03,Pankow,115,,1,76,,1533,1089,444,0,898,5,14,884,449,435
03W116,,03,Pankow,116,,1,76,,1595,1253,342,0,933,7,13,920,540,380
03W117,,03,Pankow,117,,1,76,,1504,1266,238,0,793,3,16,777,501,276
03W118,,03,Pankow,118,,1,76,,1536,1108,428,0,883,1,12,871,405,466
03W119,,03,Pankow,119,,1,76,,1858,1432,426,0,1055,3,7,1048,543,505
03W120,,03,Pankow,120,,1,76,,1869,1412,457,0,1040,3,15,1025,488,537
03W121,,03,Pankow,121,,1,76,,1881,1413,468,0,1028,6,13,1015,515,500
03W122,,03,Pankow,122,,1,76,,1610,1118,492,0,897,6,7,890,456,434
03W123,,03,Pankow,123,,1,76,,1525,1218,307,0,946,2,8,938,556,382
03W201,,03,Pankow,201,,2,76,,643,560,83,0,454,2,7,447,284,163
03W202,,03,Pankow,202,,2,76,,861,717,144,0,543,4,11,532,299,233
03W203,,03,Pankow,203,,2,76,,1529,1209,320,0,882,7,6,876,530,346
03W204,,03,Pankow,204,,2,76,,1578,1213,365,0,866,2,11,855,516,339
03W205,,03,Pankow,205,,2,76,,1428,1060,368,0,755,4,12,743,407,336
03W206,,03,Pankow,206,,2,76,,1667,1192,475,0,955,1,20,935,502,433
03W207,,03,Pankow,207,,2,76,,1518,1180,338,0,898,7,13,885,489,396
03W208,,03,Pankow,208,,2,76,,1666,1197,469,0,881,2,7,874,463,411
03W209,,03,Pankow,209,,2,76,,1696,1246,450,0,921,6,7,914,450,464
03W210,,03,Pankow,210,,2,76,,1751,1313,438,0,1035,7,13,1022,435,587
03W211,,03,Pankow,211,,2,76,,1537,1101,436,0,898,5,5,893,398,495
03W212,,03,Pankow,212,,2,76,,1425,1028,397,0,795,6,12,783,364,419
03W213,,03,Pankow,213,,2,76,,1685,1188,497,0,915,8,9,906,346,560
03W214,,03,Pankow,214,,2,76,,1588,1081,507,0,812,3,6,806,364,442
03W215,,03,Pankow,215,,2,76,,1503,1067,436,0,763,6,7,756,430,326
03W216,,03,Pankow,216,,2,76,,1624,1168,456,0,818,2,5,813,433,380
03W217,,03,Pankow,217,,2,76,,1388,1035,353,0,804,3,16,788,356,432
03W218,,03,Pankow,218,,2,76,,2007,1394,613,0,1068,11,20,1048,542,506
03W219,,03,Pankow,219,,2,76,,1571,1188,383,0,911,2,11,900,496,404
03W220,,03,Pankow,220,,2,76,,1626,1140,486,0,888,3,8,880,290,590
03W221,,03,Pankow,221,,2,76,,1654,1037,617,0,786,4,6,780,253,527
03W222,,03,Pankow,222,,2,76,,965,777,188,0,535,3,13,522,308,214
03W301,,03,Pankow,301,,3,76,,1665,1165,500,0,872,1,8,864,378,486
03W302,,03,Pankow,302,,3,76,,1677,1280,397,0,777,6,9,768,325,443
03W303,,03,Pankow,303,,3,76,,1672,1300,372,0,854,0,9,845,385,460
03W304,,03,Pankow,304,,3,76,,1710,1209,501,0,921,4,7,914,331,583
03W305,,03,Pankow,305,,3,76,,1658,1175,483,0,868,6,12,856,351,505
03W306,,03,Pankow,306,,3,76,,1737,1169,568,0,890,6,8,882,293,589
03W307,,03,Pankow,307,,3,76,,1416,1033,383,0,848,3,11,837,280,557
03W308,,03,Pankow,308,,3,76,,1328,921,407,0,641,0,8,633,194,439
03W309,,03,Pankow,309,,3,76,,1442,1098,344,0,804,0,3,801,247,554
03W310,,03,Pankow,310,,3,76,,1589,1157,432,0,886,0,11,875,262,613
03W311,,03,Pankow,311,,3,76,,1064,701,363,0,552,1,6,546,119,427
03W312,,03,Pankow,312,,3,76,,1556,1048,508,0,847,0,3,844,175,669
03W313,,03,Pankow,313,,3,76,,1455,1027,428,0,833,3,10,823,205,618
03W314,,03,Pankow,314,,3,76,,1552,1075,477,0,711,8,7,704,126,578
03W315,,03,Pankow,315,,3,76,,1526,1037,489,0,871,4,8,863,202,661
03W316,,03,Pankow,316,,3,76,,1745,1225,520,0,1022,5,10,1012,254,758
03W317,,03,Pankow,317,,3,76,,1697,1177,520,0,928,4,4,924,231,693
03W318,,03,Pankow,318,,3,76,,1568,1089,479,0,786,1,10,776,233,543
03W319,,03,Pankow,319,,3,76,,1753,1282,471,0,901,5,14,887,368,519
03W320,,03,Pankow,320,,3,76,,1557,1058,499,0,790,4,14,776,140,636
03W321,,03,Pankow,321,,3,76,,1588,1141,447,0,888,0,8,880,218,662
03W401,,03,Pankow,401,,4,76,,1860,1511,349,0,988,5,14,974,429,545
03W402,,03,Pankow,402,,4,76,,1754,1316,438,0,961,6,11,950,359,591
03W403,,03,Pankow,403,,4,76,,1928,1385,543,0,996,6,24,972,403,569
03W404,,03,Pankow,404,,4,76,,1528,1017,511,0,702,9,24,678,268,410
03W405,,03,Pankow,405,,4,76,,1622,1312,310,0,843,8,30,813,410,403
03W406,,03,Pankow,406,,4,76,,1747,1270,477,0,892,5,18,874,426,448
03W407,,03,Pankow,407,,4,76,,1672,1337,335,0,865,4,12,853,458,395
03W408,,03,Pankow,408,,4,76,,1845,1488,357,0,879,1,28,851,425,426
03W409,,03,Pankow,409,,4,76,,1330,960,370,0,636,2,9,627,267,360
03W410,,03,Pankow,410,,4,76,,1351,1077,274,0,721,3,24,697,350,347
03W411,,03,Pankow,411,,4,76,,1694,1245,449,0,941,2,8,933,239,694
03W412,,03,Pankow,412,,4,76,,1563,1121,442,0,836,6,6,830,180,650
03W413,,03,Pankow,413,,4,76,,1522,1093,429,0,793,4,9,784,238,546
03W414,,03,Pankow,414,,4,76,,2148,1371,777,0,1132,2,18,1114,416,698
03W415,,03,Pankow,415,,4,76,,1242,911,331,0,712,2,12,700,325,375
03W416,,03,Pankow,416,,4,76,,1749,1260,489,0,908,10,12,896,364,532
03W417,,03,Pankow,417,,4,76,,1741,1283,458,0,844,2,20,824,398,426
03W418,,03,Pankow,418,,4,76,,1010,779,231,0,389,2,6,383,189,194
03W501,,03,Pankow,501,,5,76,,1691,1232,459,0,928,3,13,915,339,576
03W502,,03,Pankow,502,,5,76,,1326,947,379,0,703,3,15,688,225,463
03W503,,03,Pankow,503,,5,76,,1609,1192,417,0,896,3,15,881,281,600
03W504,,03,Pankow,504,,5,76,,1380,990,390,0,775,0,10,765,262,503
03W505,,03,Pankow,505,,5,76,,1287,989,298,0,657,8,15,642,275,367
03W506,,03,Pankow,506,,5,76,,1482,1015,467,0,757,0,16,741,332,409
03W507,,03,Pankow,507,,5,76,,1588,1149,439,0,801,0,12,789,337,452
03W508,,03,Pankow,508,,5,76,,1463,1042,421,0,760,1,11,749,311,438
03W509,,03,Pankow,509,,5,76,,1779,1246,533,0,914,9,17,897,327,570
03W510,,03,Pankow,510,,5,76,,1474,1044,430,0,788,2,7,781,276,505
03W511,,03,Pankow,511,,5,76,,1628,1156,472,0,918,5,9,909,245,664
03W512,,03,Pankow,512,,5,76,,1580,1188,392,0,763,0,14,749,439,310
03W513,,03,Pankow,513,,5,76,,1703,1231,472,0,898,0,11,887,279,608
03W514,,03,Pankow,514,,5,76,,1569,1266,303,0,853,4,7,846,354,492
03W515,,03,Pankow,515,,5,76,,1294,984,310,0,755,7,5,750,180,570
03W516,,03,Pankow,516,,5,76,,1802,1215,587,0,939,0,11,928,218,710
03W517,,03,Pankow,517,,5,76,,1229,932,297,0,729,2,4,725,138,587
03W518,,03,Pankow,518,,5,76,,1427,1035,392,0,730,3,9,721,232,489
03W519,,03,Pankow,519,,5,76,,1314,912,402,0,654,3,8,646,261,385
03W520,,03,Pankow,520,,5,76,,1544,1075,469,0,835,14,12,823,334,489
03W600,,03,Pankow,600,,6,76,,1501,1060,441,0,780,7,23,757,281,476
03W601,,03,Pankow,601,,6,76,,1554,1202,352,0,829,8,16,813,346,467
03W602,,03,Pankow,602,,6,76,,1544,1044,500,0,811,15,14,797,318,479
03W603,,03,Pankow,603,,6,76,,1197,821,376,0,648,5,14,634,268,366
03W604,,03,Pankow,604,,6,76,,1376,939,437,0,774,4,13,761,288,473
03W605,,03,Pankow,605,,6,76,,1452,1054,398,0,841,13,22,819,316,503
03W606,,03,Pankow,606,,6,76,,1646,1123,523,0,899,11,22,877,327,550
03W607,,03,Pankow,607,,6,76,,1614,1091,523,0,902,9,10,892,359,533
03W608,,03,Pankow,608,,6,76,,1585,1101,484,0,888,0,19,869,372,497
03W609,,03,Pankow,609,,6,76,,1588,1068,520,0,872,18,15,857,378,479
03W610,,03,Pankow,610,,6,76,,1613,1187,426,0,948,10,17,931,417,514
03W611,,03,Pankow,611,,6,76,,1534,1002,532,0,752,20,13,739,336,403
03W612,,03,Pankow,612,,6,76,,1517,964,553,0,786,12,11,775,314,461
03W613,,03,Pankow,613,,6,76,,1444,969,475,0,769,12,15,754,326,428
03W614,,03,Pankow,614,,6,76,,1732,1151,581,0,950,13,26,924,352,572
03W615,,03,Pankow,615,,6,76,,923,617,306,0,518,8,11,507,242,265
03W616,,03,Pankow,616,,6,76,,816,539,277,0,438,12,7,431,168,263
03W617,,03,Pankow,617,,6,76,,1626,1131,495,0,926,20,28,898,415,483
03W618,,03,Pankow,618,,6,76,,1699,1078,621,0,903,25,14,889,394,495
03W619,,03,Pankow,619,,6,76,,1427,964,463,0,754,3,21,733,294,439
03W620,,03,Pankow,620,,6,76,,1752,1155,597,0,950,9,14,936,439,497
03W701,,03,Pankow,701,,7,76,,1521,1172,349,0,843,6,15,828,409,419
03W702,,03,Pankow,702,,7,76,,1456,1089,367,0,798,0,0,798,364,434
03W703,,03,Pankow,703,,7,76,,1652,1315,337,0,859,12,11,848,428,420
03W704,,03,Pankow,704,,7,76,,1337,1052,285,0,670,6,10,660,363,297
03W705,,03,Pankow,705,,7,76,,1639,1208,431,0,860,4,24,836,380,456
03W706,,03,Pankow,706,,7,83,O,1634,1189,445,0,745,0,19,726,361,365
03W707,,03,Pankow,707,,7,83,O,1917,1335,582,0,869,1,27,842,441,401
03W708,,03,Pankow,708,,7,83,O,1608,1140,468,0,792,11,0,792,360,432
03W709,,03,Pankow,709,,7,83,O,1645,1261,384,0,898,5,18,880,429,451
03W710,,03,Pankow,710,,7,83,O,1802,1359,443,0,952,6,30,922,432,490
03W711,,03,Pankow,711,,7,83,O,1548,1112,436,0,720,8,14,706,333,373
03W712,,03,Pankow,712,,7,76,,1534,1070,464,0,808,7,13,795,389,406
03W713,,03,Pankow,713,,7,76,,1486,980,506,0,785,11,5,780,349,431
03W714,,03,Pankow,714,,7,76,,1297,846,451,0,653,2,19,634,257,377
03W715,,03,Pankow,715,,7,76,,1672,1166,506,0,851,0,10,841,356,485
03W716,,03,Pankow,716,,7,76,,1506,991,515,0,763,11,11,752,328,424
03W717,,03,Pankow,717,,7,76,,1345,908,437,0,678,11,7,671,284,387
03W718,,03,Pankow,718,,7,76,,1081,828,253,0,624,6,14,610,279,331
03W719,,03,Pankow,719,,7,76,,1358,1033,325,0,733,5,7,726,364,362
03W720,,03,Pankow,720,,7,76,,1440,1000,440,0,805,11,18,787,327,460
03W801,,03,Pankow,801,,8,83,O,1945,1461,484,0,985,1,16,969,541,428
03W802,,03,Pankow,802,,8,83,O,1499,1062,437,0,824,13,27,797,367,430
03W803,,03,Pankow,803,,8,83,O,1491,1024,467,0,780,6,27,753,332,421
03W804,,03,Pankow,804,,8,83,O,1472,1005,467,0,852,12,15,837,356,481
03W805,,03,Pankow,805,,8,83,O,1786,1172,614,0,951,21,17,934,413,521
03W806,,03,Pankow,806,,8,83,O,1655,1048,607,0,871,17,27,844,392,452
03W807,,03,Pankow,807,,8,83,O,1520,966,554,0,788,10,14,774,317,457
03W808,,03,Pankow,808,,8,83,O,1731,1236,495,0,811,5,22,789,472,317
03W809,,03,Pankow,809,,8,76,,1588,979,609,0,812,10,20,792,339,453
03W810,,03,Pankow,810,,8,76,,1453,991,462,0,806,16,17,789,374,415
03W811,,03,Pankow,811,,8,76,,1471,957,514,0,795,20,22,773,348,425
03W812,,03,Pankow,812,,8,76,,1675,1058,617,0,877,13,20,857,393,464
03W813,,03,Pankow,813,,8,76,,1797,1177,620,0,997,17,18,979,477,502
03W814,,03,Pankow,814,,8,76,,1402,922,480,0,753,7,13,740,330,410
03W815,,03,Pankow,815,,8,76,,1522,1004,518,0,843,20,25,818,366,452
03W816,,03,Pankow,816,,8,76,,1475,1023,452,0,822,7,19,803,385,418
03W817,,03,Pankow,817,,8,76,,1295,868,427,0,652,9,16,636,295,341
03W818,,03,Pankow,818,,8,76,,1274,791,483,0,631,16,15,616,304,312
03W819,,03,Pankow,819,,8,76,,944,602,342,0,510,12,14,496,213,283
03W901,,03,Pankow,901,,9,76,,1648,1191,457,0,876,0,15,861,369,492
03W902,,03,Pankow,902,,9,76,,1567,1227,340,0,875,8,14,861,416,445
03W903,,03,Pankow,903,,9,76,,1816,1328,488,0,1077,16,25,1052,404,648
03W904,,03,Pankow,904,,9,76,,1698,1271,427,0,954,10,19,935,420,515
03W905,,03,Pankow,905,,9,83,O,1374,1045,329,0,716,1,15,701,359,342
03W906,,03,Pankow,906,,9,83,O,1141,843,298,0,600,0,19,581,270,311
03W907,,03,Pankow,907,,9,83,O,1176,896,280,0,615,1,16,599,345,254
03W908,,03,Pankow,908,,9,83,O,1572,1214,358,0,721,3,25,696,397,299
03W909,,03,Pankow,909,,9,83,O,1049,714,335,0,580,3,23,557,264,293
03W910,,03,Pankow,910,,9,83,O,1236,951,285,0,536,3,19,517,248,269
03W911,,03,Pankow,911,,9,83,O,1369,1066,303,0,693,6,17,676,332,344
03W912,,03,Pankow,912,,9,83,O,1351,1010,341,0,699,7,15,684,351,333
03W913,,03,Pankow,913,,9,83,O,1511,1085,426,0,799,6,25,774,354,420
03W914,,03,Pankow,914,,9,83,O,975,682,293,0,528,6,14,514,236,278
03W915,,03,Pankow,915,,9,83,O,1904,1349,555,0,966,12,37,929,433,496
03W916,,03,Pankow,916,,9,83,O,1611,1089,522,0,912,8,18,894,351,543
03W917,,03,Pankow,917,,9,83,O,1505,979,526,0,829,22,15,814,325,489
03W918,,03,Pankow,918,,9,83,O,1446,1001,445,0,823,10,18,805,364,441
03W919,,03,Pankow,919,,9,83,O,1639,1092,547,0,889,14,18,871,403,468
03W920,,03,Pankow,920,,9,83,O,1141,824,317,0,553,4,12,541,297,244
03W921,,03,Pankow,921,,9,83,O,1181,905,276,0,613,7,18,595,301,294
03W922,,03,Pankow,922,,9,83,O,1476,1034,442,0,911,11,17,894,361,533
03W923,,03,Pankow,923,,9,83,O,646,496,150,0,219,1,13,206,104,102
03W924,,03,Pankow,924,,9,83,O,1852,1259,593,0,974,17,29,945,396,549
04W101,,04,Charlottenburg-Wilmersdorf,101,,1,78,,1060,835,225,0,457,1,3,454,333,121
04W102,,04,Charlottenburg-Wilmersdorf,102,,1,78,,1090,840,250,0,502,0,17,485,335,150
04W103,,04,Charlottenburg-Wilmersdorf,103,,1,78,,1107,808,299,0,520,1,12,508,333,175
04W104,,04,Charlottenburg-Wilmersdorf,104,,1,78,,958,755,203,0,441,0,7,434,295,139
04W105,,04,Charlottenburg-Wilmersdorf,105,,1,78,,995,794,201,0,405,1,10,395,276,119
04W106,,04,Charlottenburg-Wilmersdorf,106,,1,78,,1406,1136,270,0,695,4,10,685,510,175
04W107,,04,Charlottenburg-Wilmersdorf,107,,1,78,,1315,1054,261,0,618,1,11,607,409,198
04W108,,04,Charlottenburg-Wilmersdorf,108,,1,78,,811,624,187,0,382,0,2,380,289,91
04W109,,04,Charlottenburg-Wilmersdorf,109,,1,78,,891,730,161,0,386,2,6,380,277,103
04W110,,04,Charlottenburg-Wilmersdorf,110,,1,78,,1181,914,267,0,582,2,12,570,415,155
04W111,,04,Charlottenburg-Wilmersdorf,111,,1,78,,1032,829,203,0,488,2,1,487,378,109
04W112,,04,Charlottenburg-Wilmersdorf,112,,1,78,,1256,992,264,0,640,0,15,625,444,181
04W113,,04,Charlottenburg-Wilmersdorf,113,,1,78,,1359,1027,332,0,722,0,14,708,482,226
04W114,,04,Charlottenburg-Wilmersdorf,114,,1,78,,1247,836,411,0,557,4,6,551,390,161
04W115,,04,Charlottenburg-Wilmersdorf,115,,1,78,,1402,980,422,0,738,3,2,736,468,268
04W116,,04,Charlottenburg-Wilmersdorf,116,,1,78,,1260,872,388,0,635,4,15,620,417,203
04W117,,04,Charlottenburg-Wilmersdorf,117,,1,78,,1624,1136,488,0,823,8,17,806,565,241
04W118,,04,Charlottenburg-Wilmersdorf,118,,1,78,,1493,1058,435,0,681,3,10,671,471,200
04W201,,04,Charlottenburg-Wilmersdorf,201,,2,80,,949,559,390,0,447,2,5,442,282,160
04W202,,04,Charlottenburg-Wilmersdorf,202,,2,80,,1137,718,419,0,530,0,8,522,347,175
04W203,,04,Charlottenburg-Wilmersdorf,203,,2,80,,1588,1022,566,0,800,0,12,788,526,262
04W204,,04,Charlottenburg-Wilmersdorf,204,,2,80,,1517,999,518,0,749,1,20,729,602,127
04W205,,04,Charlottenburg-Wilmersdorf,205,,2,80,,1373,876,497,0,699,10,10,689,520,169
04W206,,04,Charlottenburg-Wilmersdorf,206,,2,80,,1196,832,364,0,598,1,8,590,435,155
04W207,,04,Charlottenburg-Wilmersdorf,207,,2,80,,1157,792,365,0,563,10,9,554,373,181
04W208,,04,Charlottenburg-Wilmersdorf,208,,2,80,,1712,1350,362,0,774,5,21,753,524,229
04W209,,04,Charlottenburg-Wilmersdorf,209,,2,80,,1056,707,349,0,524,0,8,516,347,169
04W210,,04,Charlottenburg-Wilmersdorf,210,,2,80,,1215,776,439,0,603,1,11,592,406,186
04W211,,04,Charlottenburg-Wilmersdorf,211,,2,80,,1445,953,492,0,737,0,2,735,507,228
04W212,,04,Charlottenburg-Wilmersdorf,212,,2,80,,1134,652,482,0,513,5,3,510,353,157
04W213,,04,Charlottenburg-Wilmersdorf,213,,2,80,,1628,1033,595,0,795,7,9,786,557,229
04W214,,04,Charlottenburg-Wilmersdorf,214,,2,80,,1180,832,348,0,566,2,18,548,353,195
04W215,,04,Charlottenburg-Wilmersdorf,215,,2,80,,1646,1254,392,0,836,2,19,817,562,255
04W216,,04,Charlottenburg-Wilmersdorf,216,,2,80,,1064,684,380,0,526,2,4,522,373,149
04W217,,04,Charlottenburg-Wilmersdorf,217,,2,80,,1441,884,557,0,723,9,15,708,494,214
04W218,,04,Charlottenburg-Wilmersdorf,218,,2,80,,1432,994,438,0,733,0,5,728,536,192
04W219,,04,Charlottenburg-Wilmersdorf,219,,2,80,,1195,780,415,0,552,5,10,542,398,144
04W220,,04,Charlottenburg-Wilmersdorf,220,,2,80,,1222,760,462,0,616,13,14,602,396,206
04W221,,04,Charlottenburg-Wilmersdorf,221,,2,80,,1227,753,474,0,539,0,6,533,393,140
04W222,,04,Charlottenburg-Wilmersdorf,222,,2,80,,817,593,224,0,449,0,5,444,309,135
04W223,,04,Charlottenburg-Wilmersdorf,223,,2,80,,1550,1069,481,0,764,3,5,759,540,219
04W224,,04,Charlottenburg-Wilmersdorf,224,,2,80,,1097,696,401,0,603,6,17,586,357,229
04W301,,04,Charlottenburg-Wilmersdorf,301,,3,80,,1270,917,353,0,596,0,22,574,366,208
04W302,,04,Charlottenburg-Wilmersdorf,302,,3,80,,1108,777,331,0,573,6,6,567,389,178
04W303,,04,Charlottenburg-Wilmersdorf,303,,3,80,,1328,964,364,0,712,3,14,698,469,229
04W304,,04,Charlottenburg-Wilmersdorf,304,,3,80,,1318,945,373,0,687,5,3,684,461,223
04W305,,04,Charlottenburg-Wilmersdorf,305,,3,80,,1519,1036,483,0,764,7,11,753,488,265
04W306,,04,Charlottenburg-Wilmersdorf,306,,3,80,,1079,818,261,0,614,5,8,606,352,254
04W307,,04,Charlottenburg-Wilmersdorf,307,,3,80,,1394,1011,383,0,765,0,26,739,426,313
04W308,,04,Charlottenburg-Wilmersdorf,308,,3,80,,1530,1054,476,0,781,6,10,771,514,257
04W309,,04,Charlottenburg-Wilmersdorf,309,,3,80,,1563,1056,507,0,777,2,6,771,544,227
04W310,,04,Charlottenburg-Wilmersdorf,310,,3,80,,1054,735,319,0,551,4,14,537,353,184
04W311,,04,Charlottenburg-Wilmersdorf,311,,3,80,,1414,1031,383,0,808,3,15,793,483,310
04W312,,04,Charlottenburg-Wilmersdorf,312,,3,80,,1225,832,393,0,605,3,7,598,402,196
04W313,,04,Charlottenburg-Wilmersdorf,313,,3,80,,1496,951,545,0,686,5,18,668,409,259
04W314,,04,Charlottenburg-Wilmersdorf,314,,3,80,,1419,983,436,0,739,0,12,727,429,298
04W315,,04,Charlottenburg-Wilmersdorf,315,,3,80,,1451,1010,441,0,800,0,8,792,479,313
04W316,,04,Charlottenburg-Wilmersdorf,316,,3,80,,1230,817,413,0,623,10,4,619,412,207
04W317,,04,Charlottenburg-Wilmersdorf,317,,3,80,,1010,657,353,0,501,5,4,497,329,168
04W318,,04,Charlottenburg-Wilmersdorf,318,,3,80,,1132,750,382,0,612,5,10,602,348,254
04W319,,04,Charlottenburg-Wilmersdorf,319,,3,80,,908,588,320,0,481,1,12,469,282,187
04W320,,04,Charlottenburg-Wilmersdorf,320,,3,80,,1569,1072,497,0,745,10,11,734,496,238
04W321,,04,Charlottenburg-Wilmersdorf,321,,3,80,,1292,912,380,0,586,2,9,577,400,177
04W322,,04,Charlottenburg-Wilmersdorf,322,,3,80,,1187,744,443,0,599,9,8,591,360,231
04W323,,04,Charlottenburg-Wilmersdorf,323,,3,80,,1541,1063,478,0,784,6,35,749,519,230
04W324,,04,Charlottenburg-Wilmersdorf,324,,3,80,,1000,674,326,0,505,6,13,492,356,136
04W401,,04,Charlottenburg-Wilmersdorf,401,,4,80,,1464,988,476,0,680,0,14,666,452,214
04W402,,04,Charlottenburg-Wilmersdorf,402,,4,80,,1107,784,323,0,517,2,16,501,374,127
04W403,,04,Charlottenburg-Wilmersdorf,403,,4,80,,1577,1039,538,0,597,4,8,589,429,160
04W404,,04,Charlottenburg-Wilmersdorf,404,,4,80,,1052,819,233,0,601,0,2,599,413,186
04W405,,04,Charlottenburg-Wilmersdorf,405,,4,80,,1101,757,344,0,564,3,15,549,371,178
04W406,,04,Charlottenburg-Wilmersdorf,406,,4,80,,1081,777,304,0,509,1,3,506,387,119
04W407,,04,Charlottenburg-Wilmersdorf,407,,4,80,,1481,1078,403,0,737,0,15,722,490,232
04W408,,04,Charlottenburg-Wilmersdorf,408,,4,80,,1362,965,397,0,637,0,15,622,440,182
04W409,,04,Charlottenburg-Wilmersdorf,409,,4,80,,1268,846,422,0,631,0,18,613,405,208
04W410,,04,Charlottenburg-Wilmersdorf,410,,4,80,,1294,987,307,0,615,0,18,597,463,134
04W411,,04,Charlottenburg-Wilmersdorf,411,,4,80,,1407,982,425,0,757,2,12,745,477,268
04W412,,04,Charlottenburg-Wilmersdorf,412,,4,80,,1413,983,430,0,731,0,17,714,512,202
04W413,,04,Charlottenburg-Wilmersdorf,413,,4,80,,1182,805,377,0,569,0,9,560,379,181
04W414,,04,Charlottenburg-Wilmersdorf,414,,4,80,,1395,907,488,0,678,0,6,672,467,205
04W415,,04,Charlottenburg-Wilmersdorf,415,,4,80,,1540,1013,527,0,705,0,10,695,494,201
04W416,,04,Charlottenburg-Wilmersdorf,416,,4,80,,1446,1017,429,0,662,7,12,650,457,193
04W417,,04,Charlottenburg-Wilmersdorf,417,,4,80,,1113,762,351,0,557,0,8,549,386,163
04W418,,04,Charlottenburg-Wilmersdorf,418,,4,80,,1363,865,498,0,646,6,13,633,461,172
04W419,,04,Charlottenburg-Wilmersdorf,419,,4,80,,1270,848,422,0,626,0,9,617,440,177
04W420,,04,Charlottenburg-Wilmersdorf,420,,4,80,,1186,792,394,0,553,0,15,538,401,137
04W421,,04,Charlottenburg-Wilmersdorf,421,,4,80,,1096,711,385,0,465,0,4,461,333,128
04W422,,04,Charlottenburg-Wilmersdorf,422,,4,80,,918,545,373,0,418,9,3,415,307,108
04W423,,04,Charlottenburg-Wilmersdorf,423,,4,80,,1182,770,412,0,509,3,18,491,396,95
04W424,,04,Charlottenburg-Wilmersdorf,424,,4,80,,1213,850,363,0,634,0,10,624,489,135
04W425,,04,Charlottenburg-Wilmersdorf,425,,4,80,,1511,963,548,0,734,0,14,720,523,197
04W501,,04,Charlottenburg-Wilmersdorf,501,,5,80,,947,590,357,0,463,0,5,458,338,120
04W502,,04,Charlottenburg-Wilmersdorf,502,,5,80,,1145,698,447,0,505,0,10,495,398,97
04W503,,04,Charlottenburg-Wilmersdorf,503,,5,80,,919,617,302,0,426,0,11,415,321,94
04W504,,04,Charlottenburg-Wilmersdorf,504,,5,80,,1310,910,400,0,512,0,5,507,394,113
04W505,,04,Charlottenburg-Wilmersdorf,505,,5,80,,1134,834,300,0,600,0,12,588,435,153
04W506,,04,Charlottenburg-Wilmersdorf,506,,5,80,,1453,1022,431,0,744,0,6,738,541,197
04W507,,04,Charlottenburg-Wilmersdorf,507,,5,80,,993,669,324,0,480,0,6,474,344,130
04W508,,04,Charlottenburg-Wilmersdorf,508,,5,80,,1184,843,341,0,632,0,10,622,440,182
04W509,,04,Charlottenburg-Wilmersdorf,509,,5,80,,1378,918,460,0,727,0,19,708,474,234
04W510,,04,Charlottenburg-Wilmersdorf,510,,5,80,,1475,1023,452,0,786,0,22,764,538,226
04W511,,04,Charlottenburg-Wilmersdorf,511,,5,80,,1218,832,386,0,561,0,10,551,427,124
04W512,,04,Charlottenburg-Wilmersdorf,512,,5,80,,1083,792,291,0,539,3,18,521,394,127
04W513,,04,Charlottenburg-Wilmersdorf,513,,5,80,,1444,913,531,0,644,0,12,632,438,194
04W514,,04,Charlottenburg-Wilmersdorf,514,,5,80,,1150,746,404,0,504,5,7,497,351,146
04W515,,04,Charlottenburg-Wilmersdorf,515,,5,80,,1183,753,430,0,552,8,8,544,381,163
04W516,,04,Charlottenburg-Wilmersdorf,516,,5,80,,956,636,320,0,485,1,8,477,328,149
04W517,,04,Charlottenburg-Wilmersdorf,517,,5,80,,1579,1150,429,0,806,3,20,786,585,201
04W518,,04,Charlottenburg-Wilmersdorf,518,,5,80,,1384,967,417,0,669,4,31,638,461,177
04W519,,04,Charlottenburg-Wilmersdorf,519,,5,80,,1280,925,355,0,676,5,20,656,459,197
04W520,,04,Charlottenburg-Wilmersdorf,520,,5,80,,1350,944,406,0,716,5,19,697,505,192
04W521,,04,Charlottenburg-Wilmersdorf,521,,5,80,,1005,639,366,0,465,5,9,456,346,110
04W522,,04,Charlottenburg-Wilmersdorf,522,,5,80,,1276,786,490,0,551,0,5,546,442,104
04W523,,04,Charlottenburg-Wilmersdorf,523,,5,80,,1073,678,395,0,525,5,5,520,396,124
04W524,,04,Charlottenburg-Wilmersdorf,524,,5,80,,1360,753,607,0,578,5,7,571,456,115
04W525,,04,Charlottenburg-Wilmersdorf,525,,5,80,,1128,632,496,0,491,0,12,479,366,113
04W601,,04,Charlottenburg-Wilmersdorf,601,,6,80,,1052,715,337,0,510,4,13,497,340,157
04W602,,04,Charlottenburg-Wilmersdorf,602,,6,80,,1065,714,351,0,517,0,6,511,360,151
04W603,,04,Charlottenburg-Wilmersdorf,603,,6,80,,1140,807,333,0,461,0,3,458,307,151
04W604,,04,Charlottenburg-Wilmersdorf,604,,6,80,,1085,756,329,0,473,0,10,463,315,148
04W605,,04,Charlottenburg-Wilmersdorf,605,,6,80,,1046,732,314,0,515,0,5,510,339,171
04W606,,04,Charlottenburg-Wilmersdorf,606,,6,80,,1281,919,362,0,667,0,29,638,434,204
04W607,,04,Charlottenburg-Wilmersdorf,607,,6,80,,1163,741,422,0,535,0,15,520,348,172
04W608,,04,Charlottenburg-Wilmersdorf,608,,6,80,,1241,802,439,0,555,0,6,549,387,162
04W609,,04,Charlottenburg-Wilmersdorf,609,,6,80,,1173,821,352,0,571,0,8,563,387,176
04W610,,04,Charlottenburg-Wilmersdorf,610,,6,80,,1124,700,424,0,549,0,18,531,341,190
04W611,,04,Charlottenburg-Wilmersdorf,611,,6,80,,1004,695,309,0,556,0,18,538,351,187
04W612,,04,Charlottenburg-Wilmersdorf,612,,6,80,,1383,977,406,0,723,5,21,702,469,233
04W613,,04,Charlottenburg-Wilmersdorf,613,,6,80,,1311,832,479,0,614,0,13,601,370,231
04W614,,04,Charlottenburg-Wilmersdorf,614,,6,80,,1135,791,344,0,603,0,13,590,372,218
04W615,,04,Charlottenburg-Wilmersdorf,615,,6,80,,1131,789,342,0,603,0,5,598,410,188
04W616,,04,Charlottenburg-Wilmersdorf,616,,6,80,,1025,648,377,0,489,7,9,480,275,205
04W617,,04,Charlottenburg-Wilmersdorf,617,,6,80,,1320,914,406,0,679,0,6,673,444,229
04W618,,04,Charlottenburg-Wilmersdorf,618,,6,80,,1179,817,362,0,603,0,13,590,368,222
04W619,,04,Charlottenburg-Wilmersdorf,619,,6,80,,1137,789,348,0,563,9,6,557,333,224
04W620,,04,Charlottenburg-Wilmersdorf,620,,6,80,,1519,994,525,0,653,5,16,637,413,224
04W621,,04,Charlottenburg-Wilmersdorf,621,,6,80,,1536,1110,426,0,827,5,12,815,497,318
04W622,,04,Charlottenburg-Wilmersdorf,622,,6,80,,1545,1035,510,0,773,3,16,757,476,281
04W623,,04,Charlottenburg-Wilmersdorf,623,,6,80,,1088,766,322,0,571,8,14,557,344,213
04W624,,04,Charlottenburg-Wilmersdorf,624,,6,80,,1228,858,370,0,722,0,8,714,407,307
04W625,,04,Charlottenburg-Wilmersdorf,625,,6,80,,1225,882,343,0,665,0,11,654,384,270
04W626,,04,Charlottenburg-Wilmersdorf,626,,6,80,,1388,1017,371,0,749,0,15,734,480,254
04W701,,04,Charlottenburg-Wilmersdorf,701,,7,80,,1258,862,396,0,595,2,4,591,387,204
04W702,,04,Charlottenburg-Wilmersdorf,702,,7,80,,1139,789,350,0,540,5,7,533,387,146
04W703,,04,Charlottenburg-Wilmersdorf,703,,7,80,,1174,830,344,0,566,3,16,550,350,200
04W704,,04,Charlottenburg-Wilmersdorf,704,,7,80,,1420,984,436,0,703,6,9,694,489,205
04W705,,04,Charlottenburg-Wilmersdorf,705,,7,80,,1401,926,475,0,700,3,16,684,432,252
04W706,,04,Charlottenburg-Wilmersdorf,706,,7,80,,1596,1129,467,0,915,16,13,902,535,367
04W707,,04,Charlottenburg-Wilmersdorf,707,,7,80,,1419,1036,383,0,768,9,25,743,448,295
04W708,,04,Charlottenburg-Wilmersdorf,708,,7,80,,1348,1004,344,0,735,5,22,713,481,232
04W709,,04,Charlottenburg-Wilmersdorf,709,,7,80,,1449,1003,446,0,691,0,18,673,470,203
04W710,,04,Charlottenburg-Wilmersdorf,710,,7,80,,1555,1040,515,0,854,5,21,833,505,328
04W711,,04,Charlottenburg-Wilmersdorf,711,,7,80,,1438,866,572,0,666,1,12,654,406,248
04W712,,04,Charlottenburg-Wilmersdorf,712,,7,80,,1432,912,520,0,740,2,12,728,449,279
04W713,,04,Charlottenburg-Wilmersdorf,713,,7,80,,1301,851,450,0,669,3,6,663,413,250
04W714,,04,Charlottenburg-Wilmersdorf,714,,7,80,,1388,957,431,0,741,4,10,731,476,255
04W715,,04,Charlottenburg-Wilmersdorf,715,,7,80,,1652,1133,519,0,802,8,6,796,532,264
04W716,,04,Charlottenburg-Wilmersdorf,716,,7,80,,1459,972,487,0,737,0,16,721,454,267
04W717,,04,Charlottenburg-Wilmersdorf,717,,7,80,,1505,1001,504,0,822,7,14,808,428,380
04W718,,04,Charlottenburg-Wilmersdorf,718,,7,80,,1424,910,514,0,716,6,14,702,499,203
04W719,,04,Charlottenburg-Wilmersdorf,719,,7,80,,1016,772,244,0,494,1,6,488,345,143
04W720,,04,Charlottenburg-Wilmersdorf,720,,7,80,,1248,808,440,0,547,3,5,542,380,162
04W721,,04,Charlottenburg-Wilmersdorf,721,,7,80,,1247,856,391,0,708,9,13,695,452,243
04W722,,04,Charlottenburg-Wilmersdorf,722,,7,80,,919,567,352,0,452,0,13,439,307,132
04W723,,04,Charlottenburg-Wilmersdorf,723,,7,80,,1205,809,396,0,633,0,10,623,435,188
04W724,,04,Charlottenburg-Wilmersdorf,724,,7,80,,1527,998,529,0,754,8,14,740,477,263
04W801,,04,Charlottenburg-Wilmersdorf,801,,1,80,,1352,902,450,0,617,0,10,607,386,221
04W802,,04,Charlottenburg-Wilmersdorf,802,,1,80,,1182,759,423,0,549,3,5,544,385,159
04W803,,04,Charlottenburg-Wilmersdorf,803,,1,80,,1169,869,300,0,601,3,21,580,415,165
04W804,,04,Charlottenburg-Wilmersdorf,804,,1,80,,1607,1187,420,0,790,6,13,777,509,268
04W805,,04,Charlottenburg-Wilmersdorf,805,,1,80,,1337,958,379,0,658,2,10,648,460,188
04W806,,04,Charlottenburg-Wilmersdorf,806,,1,80,,1312,834,478,0,560,4,7,553,351,202
05W101,,05,Spandau,101,,1,78,,855,547,308,0,311,4,4,307,159,148
05W102,,05,Spandau,102,,1,78,,921,617,304,0,452,0,4,448,275,173
05W103,,05,Spandau,103,,1,78,,1085,769,316,0,608,6,19,589,218,371
05W104,,05,Spandau,104,,1,78,,934,788,146,0,474,0,6,468,271,197
05W105,,05,Spandau,105,,1,78,,1067,736,331,0,611,2,4,607,191,416
05W106,,05,Spandau,106,,1,78,,1133,734,399,0,528,3,7,521,159,362
05W107,,05,Spandau,107,,1,78,,898,655,243,0,463,0,4,459,258,201
05W108,,05,Spandau,108,,1,78,,1148,896,252,0,509,2,5,504,287,217
05W109,,05,Spandau,109,,1,78,,746,630,116,0,294,0,13,281,90,191
05W110,,05,Spandau,110,,1,78,,922,692,230,0,466,1,2,464,217,247
05W111,,05,Spandau,111,,1,78,,1240,948,292,0,632,1,12,620,338,282
05W112,,05,Spandau,112,,1,78,,1055,778,277,0,529,1,4,525,248,277
05W113,,05,Spandau,113,,1,78,,1051,750,301,0,559,2,7,552,186,366
05W114,,05,Spandau,114,,1,78,,913,685,228,0,468,3,7,461,207,254
05W115,,05,Spandau,115,,1,78,,1064,929,135,0,584,1,11,573,289,284
05W116,,05,Spandau,116,,1,78,,822,696,126,0,421,0,0,421,197,224
05W117,,05,Spandau,117,,1,78,,979,832,147,0,496,1,2,494,286,208
05W118,,05,Spandau,118,,1,78,,1233,965,268,0,575,2,12,563,322,241
05W119,,05,Spandau,119,,1,78,,1285,885,400,0,586,3,9,577,360,217
05W120,,05,Spandau,120,,1,78,,1199,1005,194,0,664,2,13,651,368,283
05W121,,05,Spandau,121,,1,78,,1087,899,188,0,623,4,5,618,359,259
05W122,,05,Spandau,122,,1,78,,993,768,225,0,428,0,1,427,250,177
05W123,,05,Spandau,123,,1,78,,860,651,209,0,430,1,2,428,212,216
05W124,,05,Spandau,124,,1,78,,1364,1074,290,0,702,0,7,695,349,346
05W125,,05,Spandau,125,,1,78,,1001,844,157,0,487,0,4,483,278,205
05W126,,05,Spandau,126,,1,78,,1180,978,202,0,515,4,5,510,302,208
05W127,,05,Spandau,127,,1,78,,957,847,110,0,496,1,10,486,298,188
05W128,,05,Spandau,128,,1,78,,905,774,131,0,318,5,12,306,166,140
05W129,,05,Spandau,129,,1,78,,1017,846,171,0,537,0,12,525,293,232
05W130,,05,Spandau,130,,1,78,,1064,908,156,0,533,0,7,526,284,242
05W131,,05,Spandau,131,,1,78,,1239,1070,169,0,607,1,13,594,298,296
05W132,,05,Spandau,132,,1,78,,1324,1058,266,0,550,3,10,540,268,272
05W201,,05,Spandau,201,,2,78,,1327,1016,311,0,692,3,4,688,382,306
05W202,,05,Spandau,202,,2,78,,1482,1220,262,0,779,1,11,768,404,364
05W203,,05,Spandau,203,,2,78,,1245,1087,158,0,584,1,7,577,360,217
05W204,,05,Spandau,204,,2,78,,958,795,163,0,445,0,5,440,298,142
05W205,,05,Spandau,205,,2,78,,1021,798,223,0,474,0,6,468,284,184
05W206,,05,Spandau,206,,2,78,,1371,1055,316,0,648,1,4,644,396,248
05W207,,05,Spandau,207,,2,78,,1075,905,170,0,413,0,4,409,245,164
05W208,,05,Spandau,208,,2,78,,1134,979,155,0,546,0,13,533,290,243
05W209,,05,Spandau,209,,2,78,,1052,783,269,0,482,1,2,480,215,265
05W210,,05,Spandau,210,,2,78,,1220,1046,174,0,544,3,7,537,308,229
05W211,,05,Spandau,211,,2,78,,1543,1287,256,0,837,3,13,824,434,390
05W212,,05,Spandau,212,,2,78,,909,739,169,1,478,0,9,469,298,171
05W213,,05,Spandau,213,,2,78,,1033,786,247,0,603,0,0,603,218,385
05W214,,05,Spandau,214,,2,78,,808,713,95,0,343,1,11,332,195,137
05W215,,05,Spandau,215,,2,78,,1601,1291,310,0,673,2,12,661,389,272
05W216,,05,Spandau,216,,2,78,,1588,1172,416,0,752,0,14,738,407,331
05W217,,05,Spandau,217,,2,78,,881,697,184,0,458,1,10,448,291,157
05W218,,05,Spandau,218,,2,78,,1011,811,200,0,555,0,9,546,285,261
05W219,,05,Spandau,219,,2,78,,1250,990,260,0,659,0,3,656,355,301
05W220,,05,Spandau,220,,2,78,,1061,780,281,0,473,1,10,463,311,152
05W221,,05,Spandau,221,,2,78,,849,641,208,0,464,3,14,450,275,175
05W222,,05,Spandau,222,,2,78,,865,675,190,0,436,0,3,433,248,185
05W223,,05,Spandau,223,,2,78,,1125,898,227,0,566,1,6,560,342,218
05W224,,05,Spandau,224,,2,78,,958,776,182,0,415,1,5,410,247,163
05W225,,05,Spandau,225,,2,78,,999,849,150,0,491,1,8,483,233,250
05W226,,05,Spandau,226,,2,78,,906,650,255,1,530,1,4,526,393,133
05W227,,05,Spandau,227,,2,78,,1298,984,314,0,502,0,4,498,276,222
05W301,,05,Spandau,301,,3,78,,1015,739,276,0,498,0,10,488,300,188
05W302,,05,Spandau,302,,3,78,,929,774,155,0,451,1,11,440,332,108
05W303,,05,Spandau,303,,3,78,,970,588,382,0,435,1,4,431,281,150
05W304,,05,Spandau,304,,3,78,,1556,1124,432,0,822,4,11,811,175,636
05W305,,05,Spandau,305,,3,78,,1044,941,103,0,614,6,4,610,367,243
05W306,,05,Spandau,306,,3,78,,901,595,306,0,406,3,2,404,277,127
05W307,,05,Spandau,307,,3,78,,1345,1113,232,0,631,2,12,619,352,267
05W308,,05,Spandau,308,,3,78,,1228,954,274,0,614,0,11,603,321,282
05W309,,05,Spandau,309,,3,78,,1364,1078,286,0,654,2,2,652,421,231
05W310,,05,Spandau,310,,3,78,,1270,1013,257,0,638,2,12,626,438,188
05W311,,05,Spandau,311,,3,78,,1201,939,261,1,621,5,5,616,417,199
05W312,,05,Spandau,312,,3,78,,970,733,237,0,480,1,9,471,323,148
05W313,,05,Spandau,313,,3,78,,1390,1096,294,0,662,2,6,656,434,222
05W314,,05,Spandau,314,,3,78,,1225,948,277,0,633,4,5,628,412,216
05W315,,05,Spandau,315,,3,78,,1128,754,374,0,636,2,6,630,302,328
05W316,,05,Spandau,316,,3,78,,1365,1061,304,0,673,0,9,664,452,212
05W317,,05,Spandau,317,,3,78,,1121,970,151,0,567,0,6,561,342,219
05W318,,05,Spandau,318,,3,78,,1225,945,280,0,648,1,14,634,453,181
05W319,,05,Spandau,319,,3,78,,670,603,67,0,351,0,14,337,252,85
05W320,,05,Spandau,320,,3,78,,1016,825,191,0,505,5,3,502,329,173
05W321,,05,Spandau,321,,3,78,,1169,910,259,0,561,4,11,550,371,179
05W322,,05,Spandau,322,,3,78,,1161,934,227,0,588,3,15,573,392,181
05W323,,05,Spandau,323,,3,78,,909,668,241,0,416,2,3,413,256,157
05W324,,05,Spandau,324,,3,78,,887,738,149,0,479,1,3,476,326,150
05W325,,05,Spandau,325,,3,78,,1290,1000,290,0,669,2,11,658,403,255
05W326,,05,Spandau,326,,3,78,,1096,802,294,0,470,1,11,459,313,146
05W327,,05,Spandau,327,,3,78,,1049,842,207,0,591,1,6,585,379,206
05W328,,05,Spandau,328,,3,78,,1243,929,314,0,632,2,9,623,456,167
05W329,,05,Spandau,329,,3,78,,1020,783,237,0,472,3,6,466,342,124
05W401,,05,Spandau,401,,4,78,,1026,710,316,0,560,4,4,556,171,385
05W402,,05,Spandau,402,,4,78,,725,496,229,0,383,2,0,383,125,258
05W403,,05,Spandau,403,,4,78,,958,683,275,0,540,1,5,535,142,393
05W404,,05,Spandau,404,,4,78,,1027,846,181,0,627,2,6,621,330,291
05W405,,05,Spandau,405,,4,78,,1083,759,324,0,600,1,5,595,242,353
05W406,,05,Spandau,406,,4,78,,1106,779,327,0,520,1,3,517,322,195
05W407,,05,Spandau,407,,4,78,,968,645,323,0,508,1,3,505,265,240
05W408,,05,Spandau,408,,4,78,,952,851,101,0,421,1,14,407,279,128
05W409,,05,Spandau,409,,4,78,,1133,835,298,0,639,3,8,631,384,247
05W410,,05,Spandau,410,,4,78,,1442,1134,308,0,682,2,7,675,342,333
05W411,,05,Spandau,411,,4,78,,1055,883,172,0,590,4,8,582,403,179
05W412,,05,Spandau,412,,4,78,,1399,1119,280,0,717,0,10,707,479,228
05W413,,05,Spandau,413,,4,78,,1528,1182,346,0,765,3,20,745,422,323
05W414,,05,Spandau,414,,4,78,,860,708,152,0,443,0,5,438,312,126
05W415,,05,Spandau,415,,4,78,,1411,1140,271,0,628,2,9,619,441,178
05W416,,05,Spandau,416,,4,78,,1247,799,448,0,596,2,4,592,137,455
05W417,,05,Spandau,417,,4,78,,1372,979,393,0,766,8,7,759,410,349
05W418,,05,Spandau,418,,4,78,,805,621,184,0,324,0,7,317,182,135
05W419,,05,Spandau,419,,4,78,,1096,797,299,0,618,1,8,610,161,449
05W420,,05,Spandau,420,,4,78,,1122,706,416,0,559,2,4,555,111,444
05W421,,05,Spandau,421,,4,78,,1300,1113,187,0,601,0,10,591,427,164
05W422,,05,Spandau,422,,4,78,,1035,915,120,0,471,1,8,463,343,120
05W423,,05,Spandau,423,,4,78,,897,686,211,0,467,0,3,464,197,267
05W424,,05,Spandau,424,,4,78,,1387,1081,306,0,685,2,16,669,311,358
05W425,,05,Spandau,425,,4,78,,1420,1093,327,0,799,5,8,791,416,375
05W426,,05,Spandau,426,,4,78,,1117,897,220,0,703,2,5,698,427,271
05W427,,05,Spandau,427,,4,78,,888,768,120,0,421,3,7,414,283,131
05W428,,05,Spandau,428,,4,78,,1117,820,297,0,641,0,10,631,245,386
05W429,,05,Spandau,429,,4,78,,945,709,236,0,528,1,6,522,234,288
05W501,,05,Spandau,501,,5,78,,1130,834,296,0,545,2,17,528,359,169
05W502,,05,Spandau,502,,5,78,,1216,922,294,0,653,3,13,640,431,209
05W503,,05,Spandau,503,,5,78,,837,521,316,0,454,5,11,443,266,177
05W504,,05,Spandau,504,,5,78,,958,651,307,0,526,4,10,516,329,187
05W505,,05,Spandau,505,,5,78,,1127,622,505,0,452,1,16,436,275,161
05W506,,05,Spandau,506,,5,78,,1137,792,345,0,642,3,14,628,378,250
05W507,,05,Spandau,507,,5,78,,1007,719,288,0,576,0,8,568,368,200
05W508,,05,Spandau,508,,5,78,,941,611,330,0,508,3,10,498,328,170
05W509,,05,Spandau,509,,5,78,,1142,780,362,0,596,2,10,586,402,184
05W510,,05,Spandau,510,,5,78,,985,672,313,0,585,7,4,581,408,173
05W511,,05,Spandau,511,,5,78,,948,591,357,0,505,3,10,495,332,163
05W512,,05,Spandau,512,,5,78,,923,584,339,0,494,0,13,481,314,167
05W513,,05,Spandau,513,,5,78,,1421,1074,347,0,924,1,9,915,620,295
05W514,,05,Spandau,514,,5,78,,1140,945,195,0,479,0,13,466,346,120
05W515,,05,Spandau,515,,5,78,,1116,711,405,0,549,5,15,534,352,182
05W516,,05,Spandau,516,,5,78,,1204,820,384,0,643,8,7,636,454,182
05W517,,05,Spandau,517,,5,78,,1071,830,241,0,554,5,14,540,393,147
05W518,,05,Spandau,518,,5,78,,927,575,352,0,508,1,6,502,345,157
05W519,,05,Spandau,519,,5,78,,1065,770,295,0,506,0,5,501,330,171
05W520,,05,Spandau,520,,5,78,,1252,971,281,0,580,3,17,563,412,151
05W521,,05,Spandau,521,,5,78,,1274,1088,186,0,558,1,9,549,394,155
05W522,,05,Spandau,522,,5,78,,1023,638,385,0,537,1,7,530,333,197
05W523,,05,Spandau,523,,5,78,,1508,1060,448,0,921,8,11,910,632,278
05W524,,05,Spandau,524,,5,78,,1030,669,361,0,579,2,5,574,355,219
05W525,,05,Spandau,525,,5,78,,825,512,313,0,429,3,14,415,250,165
05W526,,05,Spandau,526,,5,78,,1212,847,365,0,645,6,11,634,429,205
05W527,,05,Spandau,527,,5,78,,1513,1306,207,0,555,0,27,528,375,153
05W528,,05,Spandau,528,,5,78,,908,658,250,0,491,1,6,485,336,149
05W529,,05,Spandau,529,,5,78,,900,580,320,0,469,7,4,465,323,142
05W530,,05,Spandau,530,,5,78,,1057,827,230,0,561,1,12,549,372,177
06W101,,06,Steglitz-Zehlendorf,101,,1,79,,1857,1104,753,0,867,0,13,854,536,318
06W102,,06,Steglitz-Zehlendorf,102,,1,79,,1752,1060,692,0,851,0,18,833,502,331
06W103,,06,Steglitz-Zehlendorf,103,,1,79,,1800,1269,531,0,934,0,18,916,582,334
06W104,,06,Steglitz-Zehlendorf,104,,1,79,,1991,1323,668,0,1045,0,26,1019,573,446
06W105,,06,Steglitz-Zehlendorf,105,,1,79,,1589,1101,488,0,813,0,15,798,550,248
06W106,,06,Steglitz-Zehlendorf,106,,1,79,,1675,1131,544,0,771,0,10,761,449,312
06W107,,06,Steglitz-Zehlendorf,107,,1,79,,1848,1291,557,0,992,0,21,971,616,355
06W108,,06,Steglitz-Zehlendorf,108,,1,79,,1960,1199,761,0,906,0,7,899,542,357
06W109,,06,Steglitz-Zehlendorf,109,,1,79,,1943,1230,713,0,940,0,19,921,531,390
06W110,,06,Steglitz-Zehlendorf,110,,1,79,,1808,1134,674,0,873,10,26,847,545,302
06W111,,06,Steglitz-Zehlendorf,111,,1,79,,1888,1368,520,0,939,0,23,916,598,318
06W112,,06,Steglitz-Zehlendorf,112,,1,79,,1619,1092,527,0,858,7,21,837,508,329
06W113,,06,Steglitz-Zehlendorf,113,,1,79,,1825,1292,533,0,798,0,11,787,516,271
06W114,,06,Steglitz-Zehlendorf,114,,1,79,,1835,1179,656,0,867,0,19,848,545,303
06W115,,06,Steglitz-Zehlendorf,115,,1,79,,1536,1033,503,0,766,0,18,748,458,290
06W116,,06,Steglitz-Zehlendorf,116,,1,79,,1969,1244,725,0,964,0,13,951,551,400
06W117,,06,Steglitz-Zehlendorf,117,,1,79,,1723,1021,702,0,803,0,13,790,526,264
06W118,,06,Steglitz-Zehlendorf,118,,1,79,,1765,1111,654,0,840,0,21,819,512,307
06W201,,06,Steglitz-Zehlendorf,201,,2,79,,1906,1325,581,0,1027,0,32,995,581,414
06W202,,06,Steglitz-Zehlendorf,202,,2,79,,1712,1194,518,0,876,0,19,857,541,316
06W203,,06,Steglitz-Zehlendorf,203,,2,79,,1919,1337,582,0,928,0,25,903,577,326
06W204,,06,Steglitz-Zehlendorf,204,,2,79,,1663,1160,503,0,890,0,18,872,524,348
06W205,,06,Steglitz-Zehlendorf,205,,2,79,,1704,1136,568,0,755,0,18,737,459,278
06W206,,06,Steglitz-Zehlendorf,206,,2,79,,1612,1014,598,0,698,0,13,685,451,234
06W207,,06,Steglitz-Zehlendorf,207,,2,79,,1535,1082,453,0,738,0,12,726,424,302
06W208,,06,Steglitz-Zehlendorf,208,,2,79,,1557,1129,428,0,808,0,11,797,562,235
06W209,,06,Steglitz-Zehlendorf,209,,2,79,,1867,1174,693,0,821,0,14,807,528,279
06W210,,06,Steglitz-Zehlendorf,210,,2,79,,1716,1047,669,0,764,0,18,746,459,287
06W211,,06,Steglitz-Zehlendorf,211,,2,79,,1687,1011,676,0,731,0,13,718,464,254
06W212,,06,Steglitz-Zehlendorf,212,,2,79,,1881,1256,625,0,837,0,18,819,546,273
06W213,,06,Steglitz-Zehlendorf,213,,2,79,,2074,1475,599,0,1031,0,27,1004,633,371
06W214,,06,Steglitz-Zehlendorf,214,,2,79,,1940,1379,561,0,1008,0,20,988,606,382
06W215,,06,Steglitz-Zehlendorf,215,,2,79,,1718,1248,470,0,904,0,17,887,586,301
06W216,,06,Steglitz-Zehlendorf,216,,2,79,,1639,1113,526,0,819,0,17,802,508,294
06W217,,06,Steglitz-Zehlendorf,217,,2,79,,1944,1362,582,0,1077,0,16,1061,674,387
06W218,,06,Steglitz-Zehlendorf,218,,2,79,,1634,1074,560,0,658,0,10,648,447,201
06W301,,06,Steglitz-Zehlendorf,301,,3,79,,1886,1188,698,0,939,0,17,922,548,374
06W302,,06,Steglitz-Zehlendorf,302,,3,79,,1748,1035,713,0,828,0,18,810,481,329
06W303,,06,Steglitz-Zehlendorf,303,,3,79,,1829,1270,559,0,968,0,15,953,609,344
06W304,,06,Steglitz-Zehlendorf,304,,3,79,,1841,1151,690,0,957,0,17,940,552,388
06W305,,06,Steglitz-Zehlendorf,305,,3,79,,1616,986,630,0,810,0,16,794,462,332
06W306,,06,Steglitz-Zehlendorf,306,,3,79,,1973,1206,767,0,889,0,15,874,555,319
06W307,,06,Steglitz-Zehlendorf,307,,3,79,,1729,1043,686,0,762,0,19,743,482,261
06W308,,06,Steglitz-Zehlendorf,308,,3,79,,1743,1006,737,0,864,0,16,848,557,291
06W309,,06,Steglitz-Zehlendorf,309,,3,79,,1828,1126,702,0,865,0,22,843,532,311
06W310,,06,Steglitz-Zehlendorf,310,,3,79,,1768,1141,627,0,914,0,9,905,543,362
06W311,,06,Steglitz-Zehlendorf,311,,3,79,,1749,1135,614,0,887,0,10,877,582,295
06W312,,06,Steglitz-Zehlendorf,312,,3,79,,1810,1057,753,0,917,0,19,898,578,320
06W313,,06,Steglitz-Zehlendorf,313,,3,79,,1788,1114,674,0,879,0,17,862,581,281
06W314,,06,Steglitz-Zehlendorf,314,,3,79,,2729,1801,928,0,1424,0,18,1406,966,440
06W315,,06,Steglitz-Zehlendorf,315,,3,79,,1658,963,695,0,795,0,16,779,539,240
06W316,,06,Steglitz-Zehlendorf,316,,3,79,,1935,1309,626,0,972,0,23,949,647,302
06W317,,06,Steglitz-Zehlendorf,317,,3,79,,1936,1376,560,0,858,0,17,841,600,241
06W318,,06,Steglitz-Zehlendorf,318,,3,79,,2032,1258,774,0,898,0,34,864,609,255
06W401,,06,Steglitz-Zehlendorf,401,,4,79,,1895,1299,596,0,994,0,23,971,649,322
06W402,,06,Steglitz-Zehlendorf,402,,4,79,,1661,1096,565,0,801,0,20,781,538,243
06W403,,06,Steglitz-Zehlendorf,403,,4,79,,1628,1046,582,0,729,0,16,713,468,245
06W404,,06,Steglitz-Zehlendorf,404,,4,79,,1982,1284,698,0,1029,0,16,1013,664,349
06W405,,06,Steglitz-Zehlendorf,405,,4,79,,1780,1157,623,0,940,0,17,923,599,324
06W406,,06,Steglitz-Zehlendorf,406,,4,79,,1938,1247,691,0,941,0,34,907,598,309
06W407,,06,Steglitz-Zehlendorf,407,,4,79,,1946,1332,614,0,926,0,20,906,614,292
06W408,,06,Steglitz-Zehlendorf,408,,4,79,,1814,1096,718,0,864,0,19,845,546,299
06W409,,06,Steglitz-Zehlendorf,409,,4,79,,1776,1152,624,0,834,0,16,818,593,225
06W410,,06,Steglitz-Zehlendorf,410,,4,79,,1638,1213,425,0,864,0,23,841,583,258
06W411,,06,Steglitz-Zehlendorf,411,,4,79,,1695,1149,546,0,877,0,11,866,612,254
06W412,,06,Steglitz-Zehlendorf,412,,4,79,,1473,1080,393,0,805,0,16,789,562,227
06W413,,06,Steglitz-Zehlendorf,413,,4,79,,1749,1176,573,0,787,0,21,766,528,238
06W414,,06,Steglitz-Zehlendorf,414,,4,79,,1596,1338,258,0,720,0,26,694,507,187
06W415,,06,Steglitz-Zehlendorf,415,,4,79,,1578,1143,435,0,727,0,14,713,493,220
06W416,,06,Steglitz-Zehlendorf,416,,4,79,,1773,1074,699,0,777,0,9,768,517,251
06W417,,06,Steglitz-Zehlendorf,417,,4,79,,1676,1050,626,0,859,0,18,841,584,257
06W501,,06,Steglitz-Zehlendorf,501,,5,79,,1779,1178,601,0,788,0,18,770,501,269
06W502,,06,Steglitz-Zehlendorf,502,,5,79,,1639,1241,398,0,860,0,25,835,581,254
06W503,,06,Steglitz-Zehlendorf,503,,5,79,,1385,906,479,0,663,0,9,654,418,236
06W504,,06,Steglitz-Zehlendorf,504,,5,79,,1489,963,526,0,755,0,23,732,499,233
06W505,,06,Steglitz-Zehlendorf,505,,5,79,,1838,1151,687,0,953,0,25,928,580,348
06W506,,06,Steglitz-Zehlendorf,506,,5,79,,1676,1114,562,0,725,0,12,713,501,212
06W507,,06,Steglitz-Zehlendorf,507,,5,79,,1686,1299,387,0,863,0,17,846,602,244
06W508,,06,Steglitz-Zehlendorf,508,,5,79,,1839,1304,535,0,867,0,23,844,617,227
06W509,,06,Steglitz-Zehlendorf,509,,5,79,,1733,1139,594,0,849,0,20,829,632,197
06W510,,06,Steglitz-Zehlendorf,510,,5,79,,1946,1430,516,0,1071,0,24,1047,733,314
06W511,,06,Steglitz-Zehlendorf,511,,5,79,,1561,991,570,0,726,0,11,715,468,247
06W512,,06,Steglitz-Zehlendorf,512,,5,79,,1518,1194,324,0,715,0,17,698,463,235
06W513,,06,Steglitz-Zehlendorf,513,,5,79,,1998,1488,510,0,1018,0,8,1010,746,264
06W514,,06,Steglitz-Zehlendorf,514,,5,79,,1834,1165,669,0,966,0,17,949,625,324
06W515,,06,Steglitz-Zehlendorf,515,,5,79,,1580,1033,547,0,816,0,12,804,512,292
06W516,,06,Steglitz-Zehlendorf,516,,5,79,,1778,1382,396,0,769,0,19,750,535,215
06W517,,06,Steglitz-Zehlendorf,517,,5,79,,1694,1196,498,0,661,0,10,651,472,179
06W518,,06,Steglitz-Zehlendorf,518,,5,79,,1686,1289,397,0,768,0,20,748,543,205
06W601,,06,Steglitz-Zehlendorf,601,,6,79,,1335,777,558,0,635,0,8,627,373,254
06W602,,06,Steglitz-Zehlendorf,602,,6,79,,1530,978,552,0,800,0,9,791,521,270
06W603,,06,Steglitz-Zehlendorf,603,,6,79,,1506,943,563,0,741,0,16,725,457,268
06W604,,06,Steglitz-Zehlendorf,604,,6,79,,1822,1074,748,0,901,0,13,888,465,423
06W605,,06,Steglitz-Zehlendorf,605,,6,79,,1664,1116,548,0,922,0,8,914,608,306
06W606,,06,Steglitz-Zehlendorf,606,,6,79,,1231,720,511,0,538,0,3,535,411,124
06W607,,06,Steglitz-Zehlendorf,607,,6,79,,1475,814,661,0,669,0,4,665,451,214
06W608,,06,Steglitz-Zehlendorf,608,,6,79,,2022,1275,747,0,1037,0,19,1018,714,304
06W609,,06,Steglitz-Zehlendorf,609,,6,79,,1755,1052,703,0,889,0,18,871,522,349
06W610,,06,Steglitz-Zehlendorf,610,,6,79,,1155,622,533,0,539,0,7,532,392,140
06W611,,06,Steglitz-Zehlendorf,611,,6,79,,1530,963,567,0,761,0,15,746,478,268
06W612,,06,Steglitz-Zehlendorf,612,,6,79,,1840,1197,643,0,906,8,16,890,577,313
06W613,,06,Steglitz-Zehlendorf,613,,6,79,,1751,939,812,0,832,0,14,818,453,365
06W614,,06,Steglitz-Zehlendorf,614,,6,79,,1916,1154,762,0,902,0,22,880,553,327
06W615,,06,Steglitz-Zehlendorf,615,,6,79,,1746,1119,627,0,783,0,16,767,523,244
06W616,,06,Steglitz-Zehlendorf,616,,6,79,,1962,1350,612,0,1052,0,23,1029,687,342
06W617,,06,Steglitz-Zehlendorf,617,,6,79,,1775,1278,497,0,978,0,22,956,677,279
06W618,,06,Steglitz-Zehlendorf,618,,6,79,,1749,1071,678,0,818,0,16,802,509,293
06W619,,06,Steglitz-Zehlendorf,619,,6,79,,1459,955,504,0,754,0,39,715,449,266
06W701,,06,Steglitz-Zehlendorf,701,,7,79,,1638,1040,598,0,863,0,14,849,577,272
06W702,,06,Steglitz-Zehlendorf,702,,7,79,,1992,1201,791,0,993,0,12,981,671,310
06W703,,06,Steglitz-Zehlendorf,703,,7,79,,1422,883,539,0,666,0,4,662,449,213
06W704,,06,Steglitz-Zehlendorf,704,,7,79,,1447,910,537,0,684,0,16,668,473,195
06W705,,06,Steglitz-Zehlendorf,705,,7,79,,1442,805,637,0,592,0,4,588,393,195
06W706,,06,Steglitz-Zehlendorf,706,,7,79,,1819,1085,734,0,931,0,15,916,617,299
06W707,,06,Steglitz-Zehlendorf,707,,7,79,,1753,939,814,0,793,0,6,787,540,247
06W708,,06,Steglitz-Zehlendorf,708,,7,79,,1331,874,457,0,661,0,18,643,415,228
06W709,,06,Steglitz-Zehlendorf,709,,7,79,,1752,972,780,0,843,0,17,826,578,248
06W710,,06,Steglitz-Zehlendorf,710,,7,79,,1728,1004,724,0,820,0,23,797,568,229
06W711,,06,Steglitz-Zehlendorf,711,,7,79,,1714,1069,645,0,861,0,16,845,538,307
06W712,,06,Steglitz-Zehlendorf,712,,7,79,,1611,1071,540,0,911,0,13,898,547,351
06W713,,06,Steglitz-Zehlendorf,713,,7,79,,1586,903,683,0,773,0,12,761,520,241
06W714,,06,Steglitz-Zehlendorf,714,,7,79,,1306,815,491,0,602,0,8,594,382,212
06W715,,06,Steglitz-Zehlendorf,715,,7,79,,1480,850,630,0,708,0,10,698,464,234
06W716,,06,Steglitz-Zehlendorf,716,,7,79,,1360,739,621,0,620,0,5,615,416,199
06W717,,06,Steglitz-Zehlendorf,717,,7,79,,1166,770,396,0,613,0,15,598,397,201
06W718,,06,Steglitz-Zehlendorf,718,,7,79,,1842,1192,650,0,948,0,23,925,645,280
06W719,,06,Steglitz-Zehlendorf,719,,7,79,,1686,1031,655,0,832,0,23,809,502,307
07W101,,07,Tempelhof-Schöneberg,101,,1,81,,1816,1273,543,0,728,6,19,709,546,163
07W102,,07,Tempelhof-Schöneberg,102,,1,81,,1988,1400,588,0,868,3,13,855,583,272
07W103,,07,Tempelhof-Schöneberg,103,,1,81,,1891,1457,434,0,912,9,23,889,568,321
07W104,,07,Tempelhof-Schöneberg,104,,1,81,,1849,1436,413,0,887,4,31,856,489,367
07W105,,07,Tempelhof-Schöneberg,105,,1,81,,1914,1311,603,0,852,8,14,838,554,284
07W106,,07,Tempelhof-Schöneberg,106,,1,81,,1713,1145,568,0,820,16,16,804,485,319
07W107,,07,Tempelhof-Schöneberg,107,,1,81,,1697,1060,637,0,818,9,19,799,418,381
07W108,,07,Tempelhof-Schöneberg,108,,1,81,,1816,1380,436,0,859,5,12,847,507,340
07W109,,07,Tempelhof-Schöneberg,109,,1,81,,1893,1183,710,0,876,13,18,858,500,358
07W110,,07,Tempelhof-Schöneberg,110,,1,81,,2051,1429,622,0,1048,9,19,1029,657,372
07W111,,07,Tempelhof-Schöneberg,111,,1,81,,1771,1210,561,0,931,6,31,900,525,375
07W112,,07,Tempelhof-Schöneberg,112,,1,81,,2061,1301,760,0,1057,16,30,1027,513,514
07W113,,07,Tempelhof-Schöneberg,113,,1,81,,1955,1334,621,0,1009,14,17,992,532,460
07W114,,07,Tempelhof-Schöneberg,114,,1,81,,1792,1340,452,0,896,13,23,873,460,413
07W115,,07,Tempelhof-Schöneberg,115,,1,81,,1738,1186,552,0,826,9,24,802,370,432
07W116,,07,Tempelhof-Schöneberg,116,,1,81,,1976,1218,758,0,881,0,13,868,546,322
07W117,,07,Tempelhof-Schöneberg,117,,1,81,,1935,1351,584,0,931,3,28,903,539,364
07W118,,07,Tempelhof-Schöneberg,118,,1,81,,1942,1273,669,0,951,8,27,924,450,474
07W201,,07,Tempelhof-Schöneberg,201,,2,81,,1899,1185,714,0,983,3,18,965,539,426
07W202,,07,Tempelhof-Schöneberg,202,,2,81,,1950,1281,669,0,953,14,26,927,544,383
07W203,,07,Tempelhof-Schöneberg,203,,2,81,,2016,1311,705,0,1087,15,23,1064,537,527
07W204,,07,Tempelhof-Schöneberg,204,,2,81,,2004,1325,679,0,879,8,19,860,437,423
07W205,,07,Tempelhof-Schöneberg,205,,2,81,,1782,1297,485,0,919,15,17,902,448,454
07W206,,07,Tempelhof-Schöneberg,206,,2,81,,2217,1488,729,0,1041,9,18,1023,524,499
07W207,,07,Tempelhof-Schöneberg,207,,2,81,,2263,1466,797,0,1114,19,25,1089,506,583
07W208,,07,Tempelhof-Schöneberg,208,,2,81,,1934,1232,702,0,892,5,10,882,513,369
07W209,,07,Tempelhof-Schöneberg,209,,2,81,,1751,1234,517,0,819,2,12,807,499,308
07W210,,07,Tempelhof-Schöneberg,210,,2,81,,2052,1462,590,0,1089,14,30,1059,531,528
07W211,,07,Tempelhof-Schöneberg,211,,2,81,,1999,1509,490,0,948,0,37,911,475,436
07W212,,07,Tempelhof-Schöneberg,212,,2,81,,1423,979,444,0,779,12,18,761,296,465
07W213,,07,Tempelhof-Schöneberg,213,,2,81,,1675,1077,598,0,818,12,20,798,338,460
07W214,,07,Tempelhof-Schöneberg,214,,2,81,,1775,1159,616,0,834,11,19,815,371,444
07W215,,07,Tempelhof-Schöneberg,215,,2,81,,2040,1480,560,0,932,9,30,902,510,392
07W216,,07,Tempelhof-Schöneberg,216,,2,81,,2048,1506,542,0,953,4,16,937,608,329
07W217,,07,Tempelhof-Schöneberg,217,,2,81,,1577,1197,380,0,717,12,21,696,452,244
07W301,,07,Tempelhof-Schöneberg,301,,3,81,,1998,1218,780,0,943,11,13,930,493,437
07W302,,07,Tempelhof-Schöneberg,302,,3,81,,1824,1244,580,0,1041,9,16,1025,532,493
07W303,,07,Tempelhof-Schöneberg,303,,3,81,,1688,1057,631,0,851,12,16,835,425,410
07W304,,07,Tempelhof-Schöneberg,304,,3,81,,1464,940,524,0,720,4,10,710,385,325
07W305,,07,Tempelhof-Schöneberg,305,,3,81,,1857,1091,766,0,900,10,13,887,431,456
07W306,,07,Tempelhof-Schöneberg,306,,3,81,,1761,1130,631,0,941,9,13,928,487,441
07W307,,07,Tempelhof-Schöneberg,307,,3,81,,1945,1192,753,0,907,10,12,895,448,447
07W308,,07,Tempelhof-Schöneberg,308,,3,81,,1726,1103,623,0,865,7,18,847,405,442
07W309,,07,Tempelhof-Schöneberg,309,,3,81,,1680,1137,543,0,957,10,25,932,484,448
07W310,,07,Tempelhof-Schöneberg,310,,3,81,,1868,1104,764,0,890,6,16,874,448,426
07W311,,07,Tempelhof-Schöneberg,311,,3,81,,1686,1134,552,0,910,10,26,884,450,434
07W312,,07,Tempelhof-Schöneberg,312,,3,81,,1441,1026,415,0,788,0,20,768,389,379
07W313,,07,Tempelhof-Schöneberg,313,,3,81,,1833,1182,651,0,935,7,12,923,503,420
07W314,,07,Tempelhof-Schöneberg,314,,3,81,,1698,1179,519,0,922,6,21,901,500,401
07W315,,07,Tempelhof-Schöneberg,315,,3,81,,1936,1251,685,0,991,12,18,973,489,484
07W316,,07,Tempelhof-Schöneberg,316,,3,81,,1956,1555,401,0,940,3,19,921,571,350
07W317,,07,Tempelhof-Schöneberg,317,,3,81,,1846,1320,526,0,882,7,23,859,517,342
07W318,,07,Tempelhof-Schöneberg,318,,3,81,,1798,1358,440,0,890,5,17,873,546,327
07W319,,07,Tempelhof-Schöneberg,319,,3,81,,2087,1302,785,0,864,2,14,850,571,279
07W401,,07,Tempelhof-Schöneberg,401,,4,81,,1764,1189,575,0,911,14,20,891,480,411
07W402,,07,Tempelhof-Schöneberg,402,,4,81,,1874,1214,660,0,912,13,23,889,389,500
07W403,,07,Tempelhof-Schöneberg,403,,4,81,,1995,1517,478,0,1071,8,33,1038,665,373
07W404,,07,Tempelhof-Schöneberg,404,,4,81,,1764,1135,629,0,922,10,16,906,400,506
07W405,,07,Tempelhof-Schöneberg,405,,4,81,,1924,1399,525,0,827,5,14,813,513,300
07W406,,07,Tempelhof-Schöneberg,406,,4,81,,1979,1549,430,0,994,3,10,984,631,353
07W407,,07,Tempelhof-Schöneberg,407,,4,81,,1804,1332,472,0,837,1,20,817,560,257
07W408,,07,Tempelhof-Schöneberg,408,,4,81,,1918,1275,643,0,962,4,24,938,508,430
07W409,,07,Tempelhof-Schöneberg,409,,4,81,,1922,1288,634,0,837,4,18,819,490,329
07W410,,07,Tempelhof-Schöneberg,410,,4,81,,2189,1505,684,0,969,5,15,954,613,341
07W411,,07,Tempelhof-Schöneberg,411,,4,81,,2056,1428,628,0,913,4,25,888,551,337
07W412,,07,Tempelhof-Schöneberg,412,,4,81,,1864,1311,553,0,958,6,20,938,544,394
07W413,,07,Tempelhof-Schöneberg,413,,4,81,,2000,1413,587,0,990,3,14,976,563,413
07W414,,07,Tempelhof-Schöneberg,414,,4,81,,2123,1351,772,0,840,9,13,827,554,273
07W415,,07,Tempelhof-Schöneberg,415,,4,81,,1887,1420,467,0,932,7,23,909,538,371
07W416,,07,Tempelhof-Schöneberg,416,,4,81,,2310,1554,756,0,1051,3,27,1024,640,384
07W417,,07,Tempelhof-Schöneberg,417,,4,81,,1691,1232,459,0,894,4,24,870,510,360
07W501,,07,Tempelhof-Schöneberg,501,,5,81,,2320,1658,662,0,1084,12,22,1062,738,324
07W502,,07,Tempelhof-Schöneberg,502,,5,81,,1937,1496,441,0,895,1,23,872,626,246
07W503,,07,Tempelhof-Schöneberg,503,,5,81,,1857,1307,550,0,936,7,15,921,627,294
07W504,,07,Tempelhof-Schöneberg,504,,5,81,,2195,1773,422,0,973,5,37,936,601,335
07W505,,07,Tempelhof-Schöneberg,505,,5,81,,1971,1491,480,0,998,4,15,983,668,315
07W506,,07,Tempelhof-Schöneberg,506,,5,81,,2096,1556,540,0,1061,5,23,1038,702,336
07W507,,07,Tempelhof-Schöneberg,507,,5,81,,2131,1462,669,0,860,7,23,837,591,246
07W508,,07,Tempelhof-Schöneberg,508,,5,81,,1908,1439,469,0,943,4,13,930,632,298
07W509,,07,Tempelhof-Schöneberg,509,,5,81,,1987,1413,574,0,952,2,12,940,675,265
07W510,,07,Tempelhof-Schöneberg,510,,5,81,,1746,1180,566,0,754,9,13,741,537,204
07W511,,07,Tempelhof-Schöneberg,511,,5,81,,1830,1386,444,0,867,7,20,847,594,253
07W512,,07,Tempelhof-Schöneberg,512,,5,81,,1657,1288,369,0,820,2,21,799,587,212
07W513,,07,Tempelhof-Schöneberg,513,,5,81,,1928,1397,531,0,798,2,21,777,553,224
07W514,,07,Tempelhof-Schöneberg,514,,5,81,,2155,1530,625,0,1012,7,32,980,660,320
07W515,,07,Tempelhof-Schöneberg,515,,5,81,,1952,1540,412,0,893,0,9,884,646,238
07W516,,07,Tempelhof-Schöneberg,516,,5,81,,2116,1525,591,0,1106,1,26,1080,755,325
07W517,,07,Tempelhof-Schöneberg,517,,5,81,,2013,1325,688,0,1010,2,14,996,676,320
07W601,,07,Tempelhof-Schöneberg,601,,6,81,,1928,1377,551,0,922,7,31,891,588,303
07W602,,07,Tempelhof-Schöneberg,602,,6,81,,2228,1609,619,0,1199,3,39,1160,799,361
07W603,,07,Tempelhof-Schöneberg,603,,6,81,,2110,1422,688,0,1078,3,17,1061,711,350
07W604,,07,Tempelhof-Schöneberg,604,,6,81,,2127,1291,836,0,951,1,13,938,655,283
07W605,,07,Tempelhof-Schöneberg,605,,6,81,,2020,1486,534,0,951,4,19,932,680,252
07W606,,07,Tempelhof-Schöneberg,606,,6,81,,1738,1227,511,0,997,1,17,980,624,356
07W607,,07,Tempelhof-Schöneberg,607,,6,81,,2031,1474,557,0,1075,1,27,1048,740,308
07W608,,07,Tempelhof-Schöneberg,608,,6,81,,1140,812,328,0,577,4,13,564,438,126
07W609,,07,Tempelhof-Schöneberg,609,,6,81,,2582,1926,656,0,1140,4,26,1114,808,306
07W610,,07,Tempelhof-Schöneberg,610,,6,81,,1329,848,481,0,449,1,13,436,336,100
07W611,,07,Tempelhof-Schöneberg,611,,6,81,,2033,1595,438,0,1025,2,16,1009,734,275
07W612,,07,Tempelhof-Schöneberg,612,,6,81,,1555,1238,317,0,711,2,17,694,523,171
07W613,,07,Tempelhof-Schöneberg,613,,6,81,,2129,1723,406,0,941,0,26,915,678,237
07W614,,07,Tempelhof-Schöneberg,614,,6,81,,2176,1619,557,0,1034,5,8,1026,752,274
07W615,,07,Tempelhof-Schöneberg,615,,6,81,,1778,1229,549,0,865,3,18,847,597,250
07W616,,07,Tempelhof-Schöneberg,616,,6,81,,2280,1426,854,0,1055,6,19,1036,727,309
07W617,,07,Tempelhof-Schöneberg,617,,6,81,,1931,1238,693,0,1033,4,10,1023,711,312
07W701,,07,Tempelhof-Schöneberg,701,,7,81,,1973,1354,619,0,1052,11,16,1036,747,289
07W702,,07,Tempelhof-Schöneberg,702,,7,81,,2010,1346,664,0,1049,1,24,1025,746,279
07W703,,07,Tempelhof-Schöneberg,703,,7,81,,2120,1462,658,0,1161,4,34,1127,858,269
07W704,,07,Tempelhof-Schöneberg,704,,7,81,,2318,1615,703,0,1105,4,27,1078,777,301
07W705,,07,Tempelhof-Schöneberg,705,,7,81,,1883,1335,548,0,951,2,13,938,697,241
07W706,,07,Tempelhof-Schöneberg,706,,7,81,,1790,1190,600,0,826,2,12,814,566,248
07W707,,07,Tempelhof-Schöneberg,707,,7,81,,1962,1289,673,0,977,1,18,959,693,266
07W708,,07,Tempelhof-Schöneberg,708,,7,81,,2037,1553,484,0,1005,0,34,971,735,236
07W709,,07,Tempelhof-Schöneberg,709,,7,81,,1823,1213,610,0,934,5,17,917,647,270
07W710,,07,Tempelhof-Schöneberg,710,,7,81,,1784,1260,524,0,787,2,20,767,604,163
07W711,,07,Tempelhof-Schöneberg,711,,7,81,,1527,1100,427,0,698,6,11,687,519,168
07W712,,07,Tempelhof-Schöneberg,712,,7,81,,1899,1296,603,0,854,4,17,837,650,187
07W713,,07,Tempelhof-Schöneberg,713,,7,81,,1753,1243,510,0,797,4,24,773,567,206
07W714,,07,Tempelhof-Schöneberg,714,,7,81,,1686,1273,413,0,793,3,20,773,598,175
07W715,,07,Tempelhof-Schöneberg,715,,7,81,,1734,1232,502,0,913,7,12,901,664,237
07W716,,07,Tempelhof-Schöneberg,716,,7,81,,1470,1000,470,0,723,2,10,713,513,200
07W717,,07,Tempelhof-Schöneberg,717,,7,81,,1641,1046,595,0,801,7,13,788,563,225
07W718,,07,Tempelhof-Schöneberg,718,,7,81,,1704,1149,555,0,854,3,10,844,642,202
08W101,,08,Neukölln,101,,1,82,,1040,693,347,0,503,8,22,481,186,295
08W102,,08,Neukölln,102,,1,82,,1128,744,384,0,549,12,21,528,219,309
08W103,,08,Neukölln,103,,1,82,,1347,882,465,0,656,17,27,629,269,360
08W104,,08,Neukölln,104,,1,82,,1260,896,364,0,592,10,2,590,257,333
08W105,,08,Neukölln,105,,1,82,,1188,795,393,0,571,4,17,554,241,313
08W106,,08,Neukölln,106,,1,82,,1221,810,411,0,609,8,36,573,213,360
08W107,,08,Neukölln,107,,1,82,,1427,1035,392,0,646,5,26,620,251,369
08W108,,08,Neukölln,108,,1,82,,1054,792,262,0,568,8,6,562,196,366
08W109,,08,Neukölln,109,,1,82,,1160,869,291,0,616,1,15,601,242,359
08W110,,08,Neukölln,110,,1,82,,1131,798,333,0,526,6,17,509,219,290
08W111,,08,Neukölln,111,,1,82,,1008,727,281,0,464,4,28,436,196,240
08W112,,08,Neukölln,112,,1,82,,1401,988,413,0,577,5,20,557,256,301
08W113,,08,Neukölln,113,,1,82,,1446,1056,390,0,715,5,18,697,294,403
08W114,,08,Neukölln,114,,1,82,,1159,830,329,0,573,4,16,557,227,330
08W115,,08,Neukölln,115,,1,82,,1134,808,326,0,583,7,13,570,232,338
08W116,,08,Neukölln,116,,1,82,,842,571,271,0,349,10,9,340,224,116
08W117,,08,Neukölln,117,,1,82,,1228,908,320,0,518,5,27,491,251,240
08W118,,08,Neukölln,118,,1,82,,1481,1032,449,0,713,7,19,694,274,420
08W119,,08,Neukölln,119,,1,82,,1241,928,313,0,652,7,21,631,263,368
08W120,,08,Neukölln,120,,1,82,,1198,886,312,0,601,5,21,580,299,281
08W121,,08,Neukölln,121,,1,82,,1184,931,253,0,529,8,11,518,289,229
08W122,,08,Neukölln,122,,1,82,,1432,1164,268,0,592,6,19,573,264,309
08W123,,08,Neukölln,123,,1,82,,1478,1087,391,0,729,13,22,707,302,405
08W201,,08,Neukölln,201,,2,82,,1486,1055,431,0,724,8,17,707,287,420
08W202,,08,Neukölln,202,,2,82,,1336,1026,310,0,639,14,25,614,309,305
08W203,,08,Neukölln,203,,2,82,,1405,1038,367,0,720,0,31,689,275,414
08W204,,08,Neukölln,204,,2,82,,1245,903,342,0,574,2,23,551,241,310
08W205,,08,Neukölln,205,,2,82,,1355,948,407,0,586,10,11,575,249,326
08W206,,08,Neukölln,206,,2,82,,1340,966,374,0,588,16,23,565,257,308
08W207,,08,Neukölln,207,,2,82,,1435,1061,374,0,678,8,24,654,264,390
08W208,,08,Neukölln,208,,2,82,,1227,895,332,0,567,10,28,539,228,311
08W209,,08,Neukölln,209,,2,82,,1447,1104,343,0,778,12,10,768,335,433
08W210,,08,Neukölln,210,,2,82,,1325,966,359,0,653,5,18,635,283,352
08W211,,08,Neukölln,211,,2,82,,1201,914,287,0,605,6,21,584,252,332
08W212,,08,Neukölln,212,,2,82,,1329,1001,328,0,670,10,31,639,260,379
08W213,,08,Neukölln,213,,2,82,,1127,1012,115,0,490,0,26,464,273,191
08W214,,08,Neukölln,214,,2,82,,1111,893,218,0,469,5,13,456,286,170
08W215,,08,Neukölln,215,,2,82,,1194,821,373,0,558,2,20,538,243,295
08W216,,08,Neukölln,216,,2,82,,1305,882,423,0,521,7,25,496,222,274
08W217,,08,Neukölln,217,,2,82,,1178,774,404,0,466,1,7,459,195,264
08W218,,08,Neukölln,218,,2,82,,1317,961,356,0,586,4,25,561,247,314
08W219,,08,Neukölln,219,,2,82,,1213,950,263,0,593,4,22,571,320,251
08W220,,08,Neukölln,220,,2,82,,1217,900,317,0,609,4,23,586,242,344
08W221,,08,Neukölln,221,,2,82,,1172,876,296,0,599,3,13,586,243,343
08W222,,08,Neukölln,222,,2,82,,1549,1170,379,0,754,6,25,729,322,407
08W301,,08,Neukölln,301,,3,82,,1316,961,355,0,617,5,15,602,244,358
08W302,,08,Neukölln,302,,3,82,,1099,804,295,0,480,3,24,456,192,264
08W303,,08,Neukölln,303,,3,82,,1384,1052,331,1,686,10,22,664,306,358
08W304,,08,Neukölln,304,,3,82,,1463,1078,385,0,688,1,25,663,275,388
08W305,,08,Neukölln,305,,3,82,,1187,875,312,0,632,3,23,609,250,359
08W306,,08,Neukölln,306,,3,82,,1487,1088,399,0,693,12,21,672,273,399
08W307,,08,Neukölln,307,,3,82,,1034,788,246,0,485,3,19,466,239,227
08W308,,08,Neukölln,308,,3,82,,1463,1122,341,0,687,12,24,663,302,361
08W309,,08,Neukölln,309,,3,82,,1101,826,275,0,522,3,17,505,206,299
08W310,,08,Neukölln,310,,3,82,,1487,1084,403,0,739,9,28,711,295,416
08W311,,08,Neukölln,311,,3,82,,1293,947,346,0,601,7,14,587,247,340
08W312,,08,Neukölln,312,,3,82,,1586,1134,452,0,664,3,27,637,252,385
08W313,,08,Neukölln,313,,3,82,,1028,803,225,0,421,2,18,403,184,219
08W314,,08,Neukölln,314,,3,82,,1046,864,182,0,511,7,20,491,259,232
08W315,,08,Neukölln,315,,3,82,,1268,925,343,0,445,1,12,433,230,203
08W316,,08,Neukölln,316,,3,82,,1078,852,226,0,406,0,16,390,198,192
08W317,,08,Neukölln,317,,3,82,,1098,827,271,0,493,3,22,471,265,206
08W318,,08,Neukölln,318,,3,82,,1101,822,279,0,315,5,11,304,151,153
08W319,,08,Neukölln,319,,3,82,,1009,887,122,0,402,1,5,397,271,126
08W320,,08,Neukölln,320,,3,82,,1105,1018,87,0,429,2,11,418,290,128
08W321,,08,Neukölln,321,,3,82,,1133,998,135,0,458,0,20,438,312,126
08W322,,08,Neukölln,322,,3,82,,1190,994,196,0,531,7,20,511,350,161
08W323,,08,Neukölln,323,,3,82,,1369,1100,269,0,678,9,8,670,417,253
08W324,,08,Neukölln,324,,3,82,,1379,1265,114,0,539,2,9,530,373,157
08W401,,08,Neukölln,401,,4,82,,1485,1230,255,0,649,0,13,636,324,312
08W402,,08,Neukölln,402,,4,82,,1393,1105,288,0,580,3,10,570,338,232
08W403,,08,Neukölln,403,,4,82,,1343,954,389,0,573,3,10,563,361,202
08W404,,08,Neukölln,404,,4,82,,1362,1074,288,0,542,0,13,529,396,133
08W405,,08,Neukölln,405,,4,82,,1396,1056,340,0,556,4,13,543,389,154
08W406,,08,Neukölln,406,,4,82,,1466,1117,349,0,784,1,7,777,497,280
08W407,,08,Neukölln,407,,4,82,,1435,1205,230,0,631,2,17,614,413,201
08W408,,08,Neukölln,408,,4,82,,1158,915,243,0,480,5,20,460,290,170
08W409,,08,Neukölln,409,,4,82,,1436,1054,381,1,706,0,22,684,469,215
08W410,,08,Neukölln,410,,4,82,,1071,728,343,0,439,7,16,423,294,129
08W411,,08,Neukölln,411,,4,82,,1379,1007,372,0,634,2,17,617,380,237
08W412,,08,Neukölln,412,,4,82,,1426,968,458,0,743,6,14,729,387,342
08W413,,08,Neukölln,413,,4,82,,1603,1084,519,0,685,6,8,677,430,247
08W414,,08,Neukölln,414,,4,82,,1325,993,332,0,514,3,15,499,382,117
08W415,,08,Neukölln,415,,4,82,,1043,777,266,0,456,5,14,442,320,122
08W416,,08,Neukölln,416,,4,82,,999,714,285,0,518,2,16,502,305,197
08W417,,08,Neukölln,417,,4,82,,1113,791,322,0,488,2,11,477,343,134
08W418,,08,Neukölln,418,,4,82,,1437,991,446,0,645,0,4,641,423,218
08W419,,08,Neukölln,419,,4,82,,1056,783,273,0,481,3,11,470,349,121
08W420,,08,Neukölln,420,,4,82,,1463,1055,408,0,739,3,7,732,480,252
08W421,,08,Neukölln,421,,4,82,,1028,736,292,0,555,1,10,545,375,170
08W422,,08,Neukölln,422,,4,82,,1226,785,441,0,603,8,10,593,414,179
08W423,,08,Neukölln,423,,4,82,,1188,799,389,0,567,3,17,550,391,159
08W501,,08,Neukölln,501,,5,82,,1152,851,301,0,461,2,12,449,295,154
08W502,,08,Neukölln,502,,5,82,,1409,998,411,0,765,3,8,757,495,262
08W503,,08,Neukölln,503,,5,82,,1214,863,351,0,553,1,7,546,362,184
08W504,,08,Neukölln,504,,5,82,,1442,1104,338,0,743,2,19,724,544,180
08W505,,08,Neukölln,505,,5,82,,1373,983,390,0,701,5,21,680,492,188
08W506,,08,Neukölln,506,,5,82,,1368,1029,339,0,707,0,18,689,532,157
08W507,,08,Neukölln,507,,5,82,,1073,720,353,0,562,6,8,554,392,162
08W508,,08,Neukölln,508,,5,82,,1271,755,516,0,523,3,11,512,348,164
08W509,,08,Neukölln,509,,5,82,,1112,705,407,0,517,2,2,515,387,128
08W510,,08,Neukölln,510,,5,82,,1586,1204,382,0,890,5,22,868,596,272
08W511,,08,Neukölln,511,,5,82,,1468,1145,323,0,695,6,19,676,503,173
08W512,,08,Neukölln,512,,5,82,,1079,732,347,0,564,3,8,556,388,168
08W513,,08,Neukölln,513,,5,82,,960,604,356,0,507,6,7,500,330,170
08W514,,08,Neukölln,514,,5,82,,1028,736,292,0,515,3,12,503,354,149
08W515,,08,Neukölln,515,,5,82,,1160,847,313,0,596,2,4,592,444,148
08W516,,08,Neukölln,516,,5,82,,1136,859,277,0,594,1,18,576,412,164
08W517,,08,Neukölln,517,,5,82,,1350,1080,270,0,697,1,17,680,474,206
08W518,,08,Neukölln,518,,5,82,,1232,862,370,0,576,2,17,559,422,137
08W519,,08,Neukölln,519,,5,82,,1033,714,319,0,504,2,14,490,357,133
08W520,,08,Neukölln,520,,5,82,,1386,1108,278,0,554,5,14,540,379,161
08W521,,08,Neukölln,521,,5,82,,1219,887,332,0,611,2,15,596,416,180
08W522,,08,Neukölln,522,,5,82,,1433,952,481,0,679,1,19,660,469,191
08W601,,08,Neukölln,601,,6,82,,1598,1301,297,0,732,3,16,716,528,188
08W602,,08,Neukölln,602,,6,82,,1709,1118,591,0,637,3,8,629,442,187
08W603,,08,Neukölln,603,,6,82,,1113,787,326,0,464,0,5,459,322,137
08W604,,08,Neukölln,604,,6,82,,1280,978,302,0,584,2,15,569,412,157
08W605,,08,Neukölln,605,,6,82,,1301,935,366,0,562,9,5,557,398,159
08W606,,08,Neukölln,606,,6,82,,1178,857,321,0,545,2,14,531,385,146
08W607,,08,Neukölln,607,,6,82,,1257,844,413,0,481,0,12,469,328,141
08W608,,08,Neukölln,608,,6,82,,1763,1308,455,0,749,2,32,717,507,210
08W609,,08,Neukölln,609,,6,82,,1558,1186,372,0,641,1,11,630,460,170
08W610,,08,Neukölln,610,,6,82,,1027,736,291,0,475,1,10,465,334,131
08W611,,08,Neukölln,611,,6,82,,1565,1222,343,0,594,1,15,579,446,133
08W612,,08,Neukölln,612,,6,82,,1243,1058,185,0,516,0,31,485,341,144
08W613,,08,Neukölln,613,,6,82,,1441,1156,285,0,706,0,20,686,493,193
08W614,,08,Neukölln,614,,6,82,,1016,773,243,0,395,3,5,390,297,93
08W615,,08,Neukölln,615,,6,82,,1652,1288,364,0,677,3,17,660,458,202
08W616,,08,Neukölln,616,,6,82,,1191,890,301,0,461,5,8,453,305,148
08W617,,08,Neukölln,617,,6,82,,1318,923,395,0,654,3,8,646,466,180
08W618,,08,Neukölln,618,,6,82,,1215,987,228,0,536,4,19,517,389,128
08W619,,08,Neukölln,619,,6,82,,1401,1152,249,0,625,4,21,604,458,146
08W620,,08,Neukölln,620,,6,82,,1566,1328,238,0,635,5,9,626,447,179
08W621,,08,Neukölln,621,,6,82,,864,722,142,0,405,2,6,399,296,103
08W622,,08,Neukölln,622,,6,82,,1325,1041,284,0,576,0,10,566,423,143
08W701,,08,Neukölln,701,,7,82,,1486,975,511,0,734,1,8,726,514,212
08W702,,08,Neukölln,702,,7,82,,1412,941,471,0,744,7,4,740,514,226
08W703,,08,Neukölln,703,,7,82,,1177,801,376,0,558,1,13,545,397,148
08W704,,08,Neukölln,704,,7,82,,1535,1102,433,0,801,4,11,790,563,227
08W705,,08,Neukölln,705,,7,82,,1268,871,397,0,710,3,16,694,484,210
08W706,,08,Neukölln,706,,7,82,,1549,1097,452,0,912,6,33,879,597,282
08W707,,08,Neukölln,707,,7,82,,1419,997,422,0,688,5,19,669,474,195
08W708,,08,Neukölln,708,,7,82,,1397,1025,372,0,713,4,12,701,504,197
08W709,,08,Neukölln,709,,7,82,,1474,1100,374,0,737,7,14,723,513,210
08W710,,08,Neukölln,710,,7,82,,1460,1037,423,0,805,1,23,782,576,206
08W711,,08,Neukölln,711,,7,82,,1505,1199,306,0,824,3,16,808,574,234
08W712,,08,Neukölln,712,,7,82,,1518,1161,357,0,796,0,15,781,561,220
08W713,,08,Neukölln,713,,7,82,,1470,1035,435,0,805,6,14,791,562,229
08W714,,08,Neukölln,714,,7,82,,1408,907,501,0,659,4,14,645,459,186
08W715,,08,Neukölln,715,,7,82,,1492,1020,472,0,817,4,23,794,522,272
08W716,,08,Neukölln,716,,7,82,,1640,1145,495,0,844,0,17,827,602,225
08W717,,08,Neukölln,717,,7,82,,1542,1216,326,0,881,6,18,863,618,245
08W718,,08,Neukölln,718,,7,82,,1673,1332,341,0,869,4,17,852,612,240
08W719,,08,Neukölln,719,,7,82,,1527,1106,421,0,733,5,15,718,500,218
09W101,,09,Treptow-Köpenick,101,,1,84,,1469,1077,392,0,818,12,30,788,315,473
09W102,,09,Treptow-Köpenick,102,,1,84,,1849,1249,600,0,884,13,29,855,397,458
09W103,,09,Treptow-Köpenick,103,,1,84,,1988,1465,523,0,1092,0,31,1061,416,645
09W104,,09,Treptow-Köpenick,104,,1,84,,1353,997,356,0,791,13,37,754,340,414
09W105,,09,Treptow-Köpenick,105,,1,84,,1296,917,379,0,632,14,15,617,272,345
09W106,,09,Treptow-Köpenick,106,,1,84,,1993,1216,777,0,939,18,27,912,348,564
09W107,,09,Treptow-Köpenick,107,,1,84,,2084,1557,527,0,1048,18,24,1024,518,506
09W108,,09,Treptow-Köpenick,108,,1,84,,2059,1524,535,0,980,5,22,958,450,508
09W109,,09,Treptow-Köpenick,109,,1,84,,1914,1461,453,0,952,3,27,925,429,496
09W110,,09,Treptow-Köpenick,110,,1,84,,2093,1559,534,0,903,5,16,887,470,417
09W111,,09,Treptow-Köpenick,111,,1,84,,1925,1441,484,0,952,12,19,933,499,434
09W112,,09,Treptow-Köpenick,112,,1,84,,1640,1263,377,0,945,2,28,917,448,469
09W113,,09,Treptow-Köpenick,113,,1,84,,1593,1164,429,0,846,11,28,818,413,405
09W114,,09,Treptow-Köpenick,114,,1,84,,2221,1633,588,0,992,8,23,969,434,535
09W115,,09,Treptow-Köpenick,115,,1,84,,1672,1267,405,0,852,3,17,835,472,363
09W116,,09,Treptow-Köpenick,116,,1,84,,2208,1591,617,0,1059,10,30,1029,533,496
09W117,,09,Treptow-Köpenick,117,,1,84,,1952,1313,639,0,942,1,16,926,514,412
09W118,,09,Treptow-Köpenick,118,,1,84,,1272,1004,268,0,650,6,15,635,372,263
09W119,,09,Treptow-Köpenick,119,,1,84,,1223,905,318,0,675,2,9,666,369,297
09W201,,09,Treptow-Köpenick,201,,2,84,,2118,1530,588,0,1119,11,21,1098,579,519
09W202,,09,Treptow-Köpenick,202,,2,84,,2038,1514,524,0,1120,4,25,1095,589,506
09W203,,09,Treptow-Köpenick,203,,2,84,,1945,1463,482,0,1071,12,23,1048,598,450
09W204,,09,Treptow-Köpenick,204,,2,84,,2177,1630,547,0,1161,5,27,1134,667,467
09W205,,09,Treptow-Köpenick,205,,2,84,,1512,1172,340,0,793,7,18,775,469,306
09W206,,09,Treptow-Köpenick,206,,2,84,,1712,1286,426,0,872,6,18,854,507,347
09W207,,09,Treptow-Köpenick,207,,2,84,,1489,1071,418,0,739,6,32,707,423,284
09W208,,09,Treptow-Köpenick,208,,2,84,,1395,929,466,0,749,6,12,737,418,319
09W209,,09,Treptow-Köpenick,209,,2,84,,1350,995,355,0,711,2,15,696,391,305
09W210,,09,Treptow-Köpenick,210,,2,84,,1771,1397,374,0,893,4,9,884,515,369
09W211,,09,Treptow-Köpenick,211,,2,84,,2277,1627,650,0,1089,8,16,1073,585,488
09W212,,09,Treptow-Köpenick,212,,2,84,,2130,1565,565,0,1051,4,26,1025,525,500
09W213,,09,Treptow-Köpenick,213,,2,84,,2286,1857,429,0,1169,6,42,1127,662,465
09W214,,09,Treptow-Köpenick,214,,2,84,,2268,1833,435,0,1025,1,30,995,572,423
09W215,,09,Treptow-Köpenick,215,,2,84,,1325,1061,264,0,687,0,16,671,388,283
09W216,,09,Treptow-Köpenick,216,,2,84,,1494,1200,293,1,852,8,25,827,432,395
09W217,,09,Treptow-Köpenick,217,,2,84,,2046,1575,471,0,1039,12,19,1020,540,480
09W218,,09,Treptow-Köpenick,218,,2,84,,1198,964,234,0,640,2,4,636,354,282
09W219,,09,Treptow-Köpenick,219,,2,84,,1271,1032,239,0,706,0,29,677,412,265
09W220,,09,Treptow-Köpenick,220,,2,84,,1758,1354,404,0,915,7,14,901,484,417
09W221,,09,Treptow-Köpenick,221,,2,84,,2067,1548,519,0,946,2,22,924,549,375
09W301,,09,Treptow-Köpenick,301,,3,84,,1747,1329,418,0,977,3,30,947,545,402
09W302,,09,Treptow-Köpenick,302,,3,84,,1894,1321,573,0,1007,4,34,973,529,444
09W303,,09,Treptow-Köpenick,303,,3,84,,2807,2043,764,0,1399,6,28,1371,777,594
09W304,,09,Treptow-Köpenick,304,,3,84,,1754,1403,351,0,1001,0,20,981,567,414
09W305,,09,Treptow-Köpenick,305,,3,84,,1941,1451,490,0,879,5,19,860,444,416
09W306,,09,Treptow-Köpenick,306,,3,84,,1907,1448,459,0,1030,9,22,1008,589,419
09W307,,09,Treptow-Köpenick,307,,3,84,,1621,1320,301,0,832,0,9,823,483,340
09W308,,09,Treptow-Köpenick,308,,3,84,,2047,1542,505,0,1138,14,27,1111,660,451
09W309,,09,Treptow-Köpenick,309,,3,84,,1351,984,367,0,726,8,8,718,431,287
09W310,,09,Treptow-Köpenick,310,,3,84,,1586,1123,463,0,938,6,23,915,570,345
09W311,,09,Treptow-Köpenick,311,,3,84,,1888,1364,524,0,1103,11,25,1078,624,454
09W312,,09,Treptow-Köpenick,312,,3,84,,1477,1154,323,0,905,3,12,893,539,354
09W313,,09,Treptow-Köpenick,313,,3,84,,1988,1628,360,0,1130,3,12,1118,706,412
09W314,,09,Treptow-Köpenick,314,,3,84,,1881,1526,355,0,932,3,32,900,593,307
09W315,,09,Treptow-Köpenick,315,,3,84,,1402,1011,391,0,784,6,16,768,463,305
09W316,,09,Treptow-Köpenick,316,,3,84,,1681,1272,409,0,945,7,11,934,563,371
09W317,,09,Treptow-Köpenick,317,,3,84,,1112,819,293,0,620,0,6,614,349,265
09W318,,09,Treptow-Köpenick,318,,3,84,,1839,1629,210,0,814,8,21,793,509,284
09W319,,09,Treptow-Köpenick,319,,3,84,,847,595,252,0,442,3,11,431,258,173
09W320,,09,Treptow-Köpenick,320,,3,84,,1950,1668,282,0,989,6,15,974,589,385
09W401,,09,Treptow-Köpenick,401,,4,84,,1995,1502,493,0,1105,4,5,1100,812,288
09W402,,09,Treptow-Köpenick,402,,4,84,,1704,1210,494,0,939,3,5,934,766,168
09W403,,09,Treptow-Köpenick,403,,4,84,,2173,1492,681,0,1108,9,12,1096,730,366
09W404,,09,Treptow-Köpenick,404,,4,84,,1574,1177,397,0,935,1,18,917,735,182
09W405,,09,Treptow-Köpenick,405,,4,84,,1865,1286,579,0,1013,1,15,998,865,133
09W406,,09,Treptow-Köpenick,406,,4,84,,1896,1462,434,0,984,0,24,960,567,393
09W407,,09,Treptow-Köpenick,407,,4,84,,1487,1162,325,0,806,7,22,784,432,352
09W408,,09,Treptow-Köpenick,408,,4,84,,1322,973,349,0,688,3,13,675,382,293
09W409,,09,Treptow-Köpenick,409,,4,84,,1694,1217,477,0,739,1,11,728,423,305
09W410,,09,Treptow-Köpenick,410,,4,84,,1536,1379,157,0,728,3,18,710,481,229
09W411,,09,Treptow-Köpenick,411,,4,84,,1326,983,343,0,741,5,17,724,428,296
09W412,,09,Treptow-Köpenick,412,,4,84,,2251,1702,549,0,1266,15,4,1262,789,473
09W413,,09,Treptow-Köpenick,413,,4,84,,1308,920,388,0,739,7,5,734,502,232
09W414,,09,Treptow-Köpenick,414,,4,84,,1483,1035,448,0,860,3,15,845,720,125
09W415,,09,Treptow-Köpenick,415,,4,84,,793,545,248,0,466,6,3,463,429,34
09W416,,09,Treptow-Köpenick,416,,4,84,,827,624,203,0,517,11,2,515,414,101
09W417,,09,Treptow-Köpenick,417,,4,84,,389,259,130,0,213,1,3,210,161,49
09W418,,09,Treptow-Köpenick,418,,4,84,,2455,1740,715,0,1308,8,23,1285,685,600
09W419,,09,Treptow-Köpenick,419,,4,84,,1537,1232,305,0,850,7,21,829,486,343
09W420,,09,Treptow-Köpenick,420,,4,84,,1153,863,290,0,570,3,10,560,352,208
09W421,,09,Treptow-Köpenick,421,,4,84,,1856,1456,400,0,1006,2,17,989,551,438
09W422,,09,Treptow-Köpenick,422,,4,84,,1774,1183,591,0,892,2,20,872,514,358
09W501,,09,Treptow-Köpenick,501,,5,84,,1521,1171,350,0,797,4,16,781,456,325
09W502,,09,Treptow-Köpenick,502,,5,84,,2113,1670,443,0,1084,5,17,1067,652,415
09W503,,09,Treptow-Köpenick,503,,5,84,,1228,921,307,0,666,1,7,659,384,275
09W504,,09,Treptow-Köpenick,504,,5,84,,1837,1390,447,0,1007,4,20,987,539,448
09W505,,09,Treptow-Köpenick,505,,5,84,,1201,908,293,0,716,2,16,700,406,294
09W506,,09,Treptow-Köpenick,506,,5,84,,1291,1018,273,0,665,0,17,648,422,226
09W507,,09,Treptow-Köpenick,507,,5,84,,885,720,165,0,470,0,16,454,287,167
09W508,,09,Treptow-Köpenick,508,,5,84,,1408,1126,282,0,677,0,16,661,443,218
09W509,,09,Treptow-Köpenick,509,,5,84,,1572,1252,320,0,822,2,26,796,518,278
09W510,,09,Treptow-Köpenick,510,,5,84,,1334,1108,226,0,639,3,10,629,403,226
09W511,,09,Treptow-Köpenick,511,,5,84,,1601,1164,437,0,918,3,11,907,581,326
09W512,,09,Treptow-Köpenick,512,,5,84,,2165,1588,577,0,1095,3,20,1075,694,381
09W513,,09,Treptow-Köpenick,513,,5,84,,2096,1489,607,0,1045,2,27,1018,642,376
09W514,,09,Treptow-Köpenick,514,,5,84,,2122,1627,495,0,1125,2,20,1105,667,438
09W515,,09,Treptow-Köpenick,515,,5,84,,1998,1374,624,0,1123,6,17,1106,703,403
09W516,,09,Treptow-Köpenick,516,,5,84,,1979,1437,542,0,1112,2,18,1094,921,173
09W517,,09,Treptow-Köpenick,517,,5,84,,1996,1496,500,0,1240,0,13,1227,1031,196
09W518,,09,Treptow-Köpenick,518,,5,84,,1567,1127,440,0,877,2,2,875,750,125
09W601,,09,Treptow-Köpenick,601,,6,84,,1992,1457,535,0,1044,7,38,1006,615,391
09W602,,09,Treptow-Köpenick,602,,6,84,,1495,1100,395,0,852,0,25,827,514,313
09W603,,09,Treptow-Köpenick,603,,6,84,,1497,1105,392,0,871,6,23,848,519,329
09W604,,09,Treptow-Köpenick,604,,6,84,,2026,1449,577,0,1201,0,30,1171,762,409
09W605,,09,Treptow-Köpenick,605,,6,84,,2160,1535,625,0,1175,12,22,1153,727,426
09W606,,09,Treptow-Köpenick,606,,6,84,,1952,1451,501,0,1119,10,19,1100,683,417
09W607,,09,Treptow-Köpenick,607,,6,84,,1615,1185,430,0,876,6,18,858,552,306
09W608,,09,Treptow-Köpenick,608,,6,84,,2289,1526,763,0,1122,10,35,1087,680,407
09W609,,09,Treptow-Köpenick,609,,6,84,,1618,1189,429,0,894,0,7,887,501,386
09W610,,09,Treptow-Köpenick,610,,6,84,,1365,1044,321,0,839,5,20,819,450,369
09W611,,09,Treptow-Köpenick,611,,6,84,,1711,1266,445,0,970,7,26,944,529,415
09W612,,09,Treptow-Köpenick,612,,6,84,,2144,1602,542,0,1267,3,53,1214,644,570
09W613,,09,Treptow-Köpenick,613,,6,84,,1303,987,316,0,641,0,22,619,335,284
09W614,,09,Treptow-Köpenick,614,,6,84,,2651,1938,713,0,1444,6,33,1411,805,606
09W615,,09,Treptow-Köpenick,615,,6,84,,1219,750,469,0,622,3,6,616,443,173
09W616,,09,Treptow-Köpenick,616,,6,84,,1558,1083,475,0,843,12,10,833,568,265
09W617,,09,Treptow-Köpenick,617,,6,84,,1893,1353,540,0,1110,6,17,1093,861,232
09W618,,09,Treptow-Köpenick,618,,6,84,,1491,1114,377,0,829,5,11,818,599,219
09W619,,09,Treptow-Köpenick,619,,6,84,,1379,1018,361,0,834,5,10,824,670,154
10W101,,10,Marzahn-Hellersdorf,101,,1,85,,1808,1594,214,0,805,1,14,791,461,330
10W102,,10,Marzahn-Hellersdorf,102,,1,85,,1067,871,196,0,549,1,16,533,283,250
10W103,,10,Marzahn-Hellersdorf,103,,1,85,,1235,1070,165,0,506,2,13,493,288,205
10W104,,10,Marzahn-Hellersdorf,104,,1,85,,1384,1210,174,0,698,1,16,682,369,313
10W105,,10,Marzahn-Hellersdorf,105,,1,85,,1316,1152,164,0,627,0,15,612,335,277
10W106,,10,Marzahn-Hellersdorf,106,,1,85,,1309,1173,136,0,632,0,14,618,388,230
10W107,,10,Marzahn-Hellersdorf,107,,1,85,,1656,1406,250,0,808,2,18,790,470,320
10W108,,10,Marzahn-Hellersdorf,108,,1,85,,1664,1480,184,0,701,0,20,681,412,269
10W109,,10,Marzahn-Hellersdorf,109,,1,85,,1674,1440,234,0,698,4,14,684,423,261
10W110,,10,Marzahn-Hellersdorf,110,,1,85,,1750,1557,193,0,822,2,16,806,481,325
10W111,,10,Marzahn-Hellersdorf,111,,1,85,,1979,1673,306,0,943,2,25,918,537,381
10W112,,10,Marzahn-Hellersdorf,112,,1,85,,1633,1422,211,0,795,1,18,777,484,293
10W113,,10,Marzahn-Hellersdorf,113,,1,85,,1737,1528,209,0,772,3,22,750,450,300
10W114,,10,Marzahn-Hellersdorf,114,,1,85,,1934,1587,347,0,876,0,25,851,439,412
10W115,,10,Marzahn-Hellersdorf,115,,1,85,,2106,1718,388,0,1152,5,19,1133,568,565
10W116,,10,Marzahn-Hellersdorf,116,,1,85,,1686,1407,279,0,717,2,19,698,424,274
10W117,,10,Marzahn-Hellersdorf,117,,1,85,,1826,1528,298,0,937,1,22,915,554,361
10W118,,10,Marzahn-Hellersdorf,118,,1,85,,1466,1289,177,0,676,2,12,664,405,259
10W119,,10,Marzahn-Hellersdorf,119,,1,85,,1565,1261,304,0,755,1,16,739,408,331
10W120,,10,Marzahn-Hellersdorf,120,,1,85,,1378,1138,240,0,607,0,18,589,357,232
10W201,,10,Marzahn-Hellersdorf,201,,2,85,,1839,1429,410,0,921,1,15,906,498,408
10W202,,10,Marzahn-Hellersdorf,202,,2,85,,1880,1590,290,0,848,0,4,844,472,372
10W203,,10,Marzahn-Hellersdorf,203,,2,85,,2004,1646,358,0,945,4,29,916,507,409
10W204,,10,Marzahn-Hellersdorf,204,,2,85,,2117,1642,475,0,1049,1,42,1007,509,498
10W205,,10,Marzahn-Hellersdorf,205,,2,85,,1952,1584,368,0,867,4,18,849,493,356
10W206,,10,Marzahn-Hellersdorf,206,,2,85,,1669,1275,394,0,720,0,12,708,408,300
10W207,,10,Marzahn-Hellersdorf,207,,2,85,,1703,1364,339,0,881,3,8,873,469,404
10W208,,10,Marzahn-Hellersdorf,208,,2,85,,1781,1462,319,0,885,2,16,869,481,388
10W209,,10,Marzahn-Hellersdorf,209,,2,85,,1690,1449,241,0,817,2,10,807,447,360
10W210,,10,Marzahn-Hellersdorf,210,,2,85,,1927,1577,350,0,901,3,22,879,471,408
10W211,,10,Marzahn-Hellersdorf,211,,2,85,,1418,1210,208,0,679,3,22,657,371,286
10W212,,10,Marzahn-Hellersdorf,212,,2,85,,1520,1154,366,0,770,0,16,754,346,408
10W213,,10,Marzahn-Hellersdorf,213,,2,85,,1849,1505,344,0,878,0,10,868,517,351
10W214,,10,Marzahn-Hellersdorf,214,,2,85,,1702,1293,409,0,930,1,21,909,434,475
10W215,,10,Marzahn-Hellersdorf,215,,2,85,,1635,1252,383,0,870,0,25,845,456,389
10W216,,10,Marzahn-Hellersdorf,216,,2,85,,1932,1475,457,0,1037,1,24,1013,505,508
10W217,,10,Marzahn-Hellersdorf,217,,2,85,,1597,1320,277,0,730,0,8,722,438,284
10W218,,10,Marzahn-Hellersdorf,218,,2,85,,1431,1102,329,0,751,2,22,729,376,353
10W219,,10,Marzahn-Hellersdorf,219,,2,85,,1283,1071,212,0,564,2,15,549,319,230
10W220,,10,Marzahn-Hellersdorf,220,,2,85,,1489,1202,287,0,779,2,28,751,406,345
10W301,,10,Marzahn-Hellersdorf,301,,3,85,,1924,1553,371,0,1094,2,30,1064,563,501
10W302,,10,Marzahn-Hellersdorf,302,,3,85,,1656,1492,164,0,720,5,17,703,433,270
10W303,,10,Marzahn-Hellersdorf,303,,3,85,,1291,1163,128,0,571,0,19,552,361,191
10W304,,10,Marzahn-Hellersdorf,304,,3,85,,1427,1262,165,0,574,0,6,568,351,217
10W305,,10,Marzahn-Hellersdorf,305,,3,85,,1706,1536,170,0,776,1,3,773,509,264
10W306,,10,Marzahn-Hellersdorf,306,,3,85,,2105,1849,256,0,1003,0,28,975,588,387
10W307,,10,Marzahn-Hellersdorf,307,,3,85,,1968,1698,270,0,924,2,24,900,571,329
10W308,,10,Marzahn-Hellersdorf,308,,3,85,,1435,1240,195,0,710,0,18,692,404,288
10W309,,10,Marzahn-Hellersdorf,309,,3,85,,2063,1723,340,0,933,1,11,922,562,360
10W310,,10,Marzahn-Hellersdorf,310,,3,85,,1472,1286,186,0,759,0,17,742,452,290
10W311,,10,Marzahn-Hellersdorf,311,,3,85,,1413,1219,194,0,648,0,13,635,493,142
10W312,,10,Marzahn-Hellersdorf,312,,3,85,,1044,892,152,0,454,2,13,441,290,151
10W313,,10,Marzahn-Hellersdorf,313,,3,85,,1483,1320,163,0,540,0,13,527,363,164
10W314,,10,Marzahn-Hellersdorf,314,,3,85,,1513,1317,196,0,730,1,20,710,407,303
10W315,,10,Marzahn-Hellersdorf,315,,3,85,,1921,1650,271,0,746,2,14,732,479,253
10W316,,10,Marzahn-Hellersdorf,316,,3,85,,1674,1435,239,0,765,2,9,756,430,326
10W317,,10,Marzahn-Hellersdorf,317,,3,85,,1821,1423,398,0,867,0,19,848,511,337
10W318,,10,Marzahn-Hellersdorf,318,,3,85,,1750,1441,309,0,827,0,12,815,506,309
10W319,,10,Marzahn-Hellersdorf,319,,3,85,,1966,1513,453,0,974,3,16,958,576,382
10W320,,10,Marzahn-Hellersdorf,320,,3,85,,1724,1406,318,0,902,2,19,883,549,334
10W401,,10,Marzahn-Hellersdorf,401,,4,85,,2006,1620,386,0,975,2,29,946,520,426
10W402,,10,Marzahn-Hellersdorf,402,,4,85,,1938,1607,331,0,1013,0,26,987,554,433
10W403,,10,Marzahn-Hellersdorf,403,,4,85,,1694,1365,329,0,817,3,14,803,428,375
10W404,,10,Marzahn-Hellersdorf,404,,4,85,,2125,1617,508,0,936,3,25,911,474,437
10W405,,10,Marzahn-Hellersdorf,405,,4,85,,1996,1570,426,0,1047,2,30,1017,577,440
10W406,,10,Marzahn-Hellersdorf,406,,4,85,,2050,1570,480,0,1028,0,38,990,506,484
10W407,,10,Marzahn-Hellersdorf,407,,4,85,,1921,1362,559,0,1040,8,30,1010,443,567
10W408,,10,Marzahn-Hellersdorf,408,,4,85,,1704,1180,524,0,903,5,18,885,405,480
10W409,,10,Marzahn-Hellersdorf,409,,4,85,,1762,1120,642,0,829,0,11,818,422,396
10W410,,10,Marzahn-Hellersdorf,410,,4,85,,1376,1140,236,0,602,3,24,578,327,251
10W411,,10,Marzahn-Hellersdorf,411,,4,85,,1396,1046,350,0,818,0,17,801,367,434
10W412,,10,Marzahn-Hellersdorf,412,,4,85,,1607,1339,268,0,750,0,25,725,401,324
10W413,,10,Marzahn-Hellersdorf,413,,4,85,,1840,1189,651,0,955,2,19,936,443,493
10W414,,10,Marzahn-Hellersdorf,414,,4,85,,1881,1249,632,0,1006,3,16,990,453,537
10W415,,10,Marzahn-Hellersdorf,415,,4,85,,2182,1580,602,0,1128,11,22,1106,545,561
10W416,,10,Marzahn-Hellersdorf,416,,4,85,,1734,1103,631,0,888,0,10,878,403,475
10W417,,10,Marzahn-Hellersdorf,417,,4,85,,1912,1392,520,0,1128,2,19,1109,553,556
10W418,,10,Marzahn-Hellersdorf,418,,4,85,,1242,968,274,0,772,7,18,754,368,386
10W419,,10,Marzahn-Hellersdorf,419,,4,85,,1585,1281,304,0,912,0,16,896,436,460
10W501,,10,Marzahn-Hellersdorf,501,,5,85,,1979,1378,601,0,1105,4,33,1072,543,529
10W502,,10,Marzahn-Hellersdorf,502,,5,85,,2075,1379,696,0,1115,0,20,1095,580,515
10W503,,10,Marzahn-Hellersdorf,503,,5,85,,2077,1533,544,0,1249,3,20,1229,588,641
10W504,,10,Marzahn-Hellersdorf,504,,5,85,,2152,1522,630,0,1230,4,21,1209,615,594
10W505,,10,Marzahn-Hellersdorf,505,,5,85,,1975,1395,580,0,1059,6,19,1040,573,467
10W506,,10,Marzahn-Hellersdorf,506,,5,85,,1874,1292,582,0,1084,11,12,1072,571,501
10W507,,10,Marzahn-Hellersdorf,507,,5,85,,1768,1301,467,0,1072,10,30,1042,504,538
10W508,,10,Marzahn-Hellersdorf,508,,5,85,,1671,1194,477,0,941,3,11,930,450,480
10W509,,10,Marzahn-Hellersdorf,509,,5,85,,1647,1133,514,0,907,8,14,893,422,471
10W510,,10,Marzahn-Hellersdorf,510,,5,85,,2051,1451,600,0,1173,10,18,1155,551,604
10W511,,10,Marzahn-Hellersdorf,511,,5,85,,2068,1411,657,0,1108,3,30,1078,492,586
10W512,,10,Marzahn-Hellersdorf,512,,5,85,,1746,1295,451,0,1007,0,27,980,472,508
10W513,,10,Marzahn-Hellersdorf,513,,5,85,,1677,1202,475,0,957,3,15,942,420,522
10W514,,10,Marzahn-Hellersdorf,514,,5,85,,2112,1547,565,0,1232,5,19,1213,553,660
10W515,,10,Marzahn-Hellersdorf,515,,5,85,,2007,1389,618,0,1102,1,11,1091,490,601
10W516,,10,Marzahn-Hellersdorf,516,,5,85,,2104,1537,567,0,1293,12,15,1278,572,706
10W517,,10,Marzahn-Hellersdorf,517,,5,85,,2083,1389,694,0,1111,6,23,1088,464,624
10W601,,10,Marzahn-Hellersdorf,601,,6,85,,1679,1477,202,0,811,3,16,795,505,290
10W602,,10,Marzahn-Hellersdorf,602,,6,85,,1959,1671,288,0,914,0,16,898,569,329
10W603,,10,Marzahn-Hellersdorf,603,,6,85,,1937,1591,346,0,953,4,17,936,585,351
10W604,,10,Marzahn-Hellersdorf,604,,6,85,,1547,1280,267,0,839,1,12,827,463,364
10W605,,10,Marzahn-Hellersdorf,605,,6,85,,1185,1004,181,0,578,0,21,557,316,241
10W606,,10,Marzahn-Hellersdorf,606,,6,85,,2001,1614,387,0,1033,1,19,1014,554,460
10W607,,10,Marzahn-Hellersdorf,607,,6,85,,2065,1694,371,0,1007,1,24,983,590,393
10W608,,10,Marzahn-Hellersdorf,608,,6,85,,1666,1367,299,0,773,1,20,753,451,302
10W609,,10,Marzahn-Hellersdorf,609,,6,85,,1609,1295,314,0,840,1,20,820,456,364
10W610,,10,Marzahn-Hellersdorf,610,,6,85,,1914,1469,445,0,1031,8,23,1008,540,468
10W611,,10,Marzahn-Hellersdorf,611,,6,85,,1865,1539,326,0,911,0,16,895,486,409
10W612,,10,Marzahn-Hellersdorf,612,,6,85,,1851,1363,488,0,1048,1,17,1031,535,496
10W613,,10,Marzahn-Hellersdorf,613,,6,85,,1875,1479,396,0,985,3,21,964,495,469
10W614,,10,Marzahn-Hellersdorf,614,,6,85,,2009,1377,632,0,1116,0,18,1098,515,583
10W615,,10,Marzahn-Hellersdorf,615,,6,85,,1898,1650,248,0,939,3,14,925,581,344
10W616,,10,Marzahn-Hellersdorf,616,,6,85,,1918,1584,334,0,909,0,28,881,534,347
10W617,,10,Marzahn-Hellersdorf,617,,6,85,,1864,1632,232,0,797,0,18,779,479,300
10W618,,10,Marzahn-Hellersdorf,618,,6,85,,1855,1554,301,0,790,2,23,767,472,295
11W101,,11,Lichtenberg,101,,1,86,,1079,853,226,0,571,1,10,561,198,363
11W102,,11,Lichtenberg,102,,1,86,,1034,768,266,0,618,1,7,611,108,503
11W103,,11,Lichtenberg,103,,1,86,,1059,852,207,0,637,2,4,633,183,450
11W104,,11,Lichtenberg,104,,1,86,,1167,970,197,0,615,1,13,602,244,358
11W105,,11,Lichtenberg,105,,1,86,,983,777,206,0,571,2,6,565,122,443
11W106,,11,Lichtenberg,106,,1,86,,1093,963,130,0,571,1,10,561,290,271
11W107,,11,Lichtenberg,107,,1,86,,894,767,127,0,388,0,11,377,182,195
11W108,,11,Lichtenberg,108,,1,86,,1055,879,176,0,472,1,10,462,227,235
11W109,,11,Lichtenberg,109,,1,86,,1067,897,170,0,548,1,1,547,287,260
11W110,,11,Lichtenberg,110,,1,86,,1137,898,239,0,499,1,1,498,230,268
11W111,,11,Lichtenberg,111,,1,86,,999,742,257,0,533,0,4,529,210,319
11W112,,11,Lichtenberg,112,,1,86,,1236,1021,215,0,564,0,7,557,314,243
11W113,,11,Lichtenberg,113,,1,86,,893,683,210,0,411,1,4,407,205,202
11W114,,11,Lichtenberg,114,,1,86,,998,779,219,0,502,1,7,495,252,243
11W115,,11,Lichtenberg,115,,1,86,,914,713,201,0,463,1,9,454,203,251
11W116,,11,Lichtenberg,116,,1,86,,986,804,182,0,537,1,9,528,251,277
11W117,,11,Lichtenberg,117,,1,86,,1117,949,168,0,480,1,10,470,281,189
11W118,,11,Lichtenberg,118,,1,86,,1044,864,180,0,492,2,29,463,240,223
11W119,,11,Lichtenberg,119,,1,86,,1304,1154,150,0,598,2,14,584,347,237
11W120,,11,Lichtenberg,120,,1,86,,1347,1145,202,0,566,4,22,544,305,239
11W121,,11,Lichtenberg,121,,1,86,,1066,913,153,0,507,1,7,500,294,206
11W122,,11,Lichtenberg,122,,1,86,,1245,1028,217,0,653,2,12,641,340,301
11W123,,11,Lichtenberg,123,,1,86,,1223,977,246,0,644,0,4,640,289,351
11W124,,11,Lichtenberg,124,,1,86,,1050,883,167,0,489,2,10,479,266,213
11W125,,11,Lichtenberg,125,,1,86,,1229,1027,202,0,603,0,11,592,314,278
11W126,,11,Lichtenberg,126,,1,86,,1175,987,188,0,542,0,14,528,291,237
11W127,,11,Lichtenberg,127,,1,86,,1211,994,217,0,634,1,14,620,284,336
11W201,,11,Lichtenberg,201,,2,86,,967,735,232,0,467,7,3,464,160,304
11W202,,11,Lichtenberg,202,,2,86,,1273,1015,258,0,675,4,23,652,294,358
11W203,,11,Lichtenberg,203,,2,86,,1244,1001,243,0,632,2,7,625,284,341
11W204,,11,Lichtenberg,204,,2,86,,1094,894,200,0,525,0,9,516,262,254
11W205,,11,Lichtenberg,205,,2,86,,1146,956,190,0,552,1,3,549,282,267
11W206,,11,Lichtenberg,206,,2,86,,1138,944,194,0,552,3,12,540,288,252
11W207,,11,Lichtenberg,207,,2,86,,1059,895,164,0,510,0,8,502,282,220
11W208,,11,Lichtenberg,208,,2,86,,878,734,144,0,391,1,2,389,227,162
11W209,,11,Lichtenberg,209,,2,86,,960,803,157,0,476,0,10,466,267,199
11W210,,11,Lichtenberg,210,,2,86,,1178,805,373,0,625,4,11,614,231,383
11W211,,11,Lichtenberg,211,,2,86,,1065,719,346,0,577,2,2,575,185,390
11W212,,11,Lichtenberg,212,,2,86,,1116,897,219,0,561,2,13,548,280,268
11W213,,11,Lichtenberg,213,,2,86,,1377,1068,309,0,752,1,12,740,358,382
11W214,,11,Lichtenberg,214,,2,86,,915,691,224,0,497,3,2,495,243,252
11W215,,11,Lichtenberg,215,,2,86,,988,732,256,0,447,0,8,439,239,200
11W216,,11,Lichtenberg,216,,2,86,,1367,1052,315,0,793,2,21,772,341,431
11W217,,11,Lichtenberg,217,,2,86,,1184,889,295,0,621,1,14,607,288,319
11W218,,11,Lichtenberg,218,,2,86,,1635,1356,279,0,799,3,12,787,420,367
11W219,,11,Lichtenberg,219,,2,86,,993,703,290,0,535,1,4,531,228,303
11W220,,11,Lichtenberg,220,,2,86,,1128,784,344,0,656,4,2,654,253,401
11W221,,11,Lichtenberg,221,,2,86,,1193,935,258,0,678,3,8,670,356,314
11W222,,11,Lichtenberg,222,,2,86,,1286,983,303,0,669,2,22,647,299,348
11W223,,11,Lichtenberg,223,,2,86,,1157,970,187,0,611,1,29,582,308,274
11W224,,11,Lichtenberg,224,,2,86,,1420,1000,420,0,777,2,9,768,347,421
11W225,,11,Lichtenberg,225,,2,86,,1218,957,261,0,636,6,23,613,330,283
11W226,,11,Lichtenberg,226,,2,86,,1250,974,276,0,711,5,28,683,323,360
11W227,,11,Lichtenberg,227,,2,86,,1232,995,237,0,697,6,21,676,379,297
11W228,,11,Lichtenberg,228,,2,86,,1175,882,293,0,657,8,10,647,306,341
11W301,,11,Lichtenberg,301,,3,86,,1165,918,247,0,594,2,26,568,308,260
11W302,,11,Lichtenberg,302,,3,86,,917,704,213,0,525,1,10,515,255,260
11W303,,11,Lichtenberg,303,,3,86,,1005,880,125,0,448,0,8,440,259,181
11W304,,11,Lichtenberg,304,,3,86,,1295,1032,263,0,644,4,21,623,358,265
11W305,,11,Lichtenberg,305,,3,86,,1173,935,238,0,624,2,12,612,322,290
11W306,,11,Lichtenberg,306,,3,86,,1430,1121,309,0,679,4,11,668,384,284
11W307,,11,Lichtenberg,307,,3,86,,1717,1271,446,0,911,12,19,892,404,488
11W308,,11,Lichtenberg,308,,3,86,,1366,1090,276,0,736,6,18,718,387,331
11W309,,11,Lichtenberg,309,,3,86,,1225,988,237,0,604,0,14,590,356,234
11W310,,11,Lichtenberg,310,,3,86,,1283,1006,277,0,655,1,9,646,338,308
11W311,,11,Lichtenberg,311,,3,86,,1173,910,263,0,560,1,9,551,317,234
11W312,,11,Lichtenberg,312,,3,86,,1064,827,237,0,474,2,3,471,230,241
11W313,,11,Lichtenberg,313,,3,86,,1332,1060,272,0,732,2,7,725,399,326
11W314,,11,Lichtenberg,314,,3,86,,1258,1065,193,0,659,0,20,639,365,274
11W315,,11,Lichtenberg,315,,3,86,,1207,959,248,0,741,2,9,732,368,364
11W316,,11,Lichtenberg,316,,3,86,,1106,836,270,0,544,2,11,533,279,254
11W317,,11,Lichtenberg,317,,3,86,,799,617,182,0,442,3,11,431,229,202
11W318,,11,Lichtenberg,318,,3,86,,1312,1034,278,0,671,2,12,659,355,304
11W319,,11,Lichtenberg,319,,3,86,,1085,807,278,0,482,0,13,469,255,214
11W320,,11,Lichtenberg,320,,3,86,,1034,737,297,0,470,5,12,458,228,230
11W321,,11,Lichtenberg,321,,3,86,,1052,793,259,0,488,0,10,478,257,221
11W322,,11,Lichtenberg,322,,3,86,,1180,962,218,0,590,1,14,576,312,264
11W323,,11,Lichtenberg,323,,3,86,,1301,1024,277,0,640,3,14,626,334,292
11W324,,11,Lichtenberg,324,,3,86,,975,829,146,0,467,0,14,453,256,197
11W325,,11,Lichtenberg,325,,3,86,,1305,1049,256,0,582,3,13,569,311,258
11W326,,11,Lichtenberg,326,,3,86,,1728,1429,299,0,671,5,15,656,305,351
11W327,,11,Lichtenberg,327,,3,86,,1218,927,291,0,608,7,31,577,306,271
11W328,,11,Lichtenberg,328,,3,86,,1329,1041,288,0,743,3,19,724,362,362
11W329,,11,Lichtenberg,329,,3,86,,1293,1041,252,0,621,3,17,604,304,300
11W401,,11,Lichtenberg,401,,4,86,,1200,912,288,0,575,6,25,550,291,259
11W402,,11,Lichtenberg,402,,4,86,,1231,943,288,0,680,9,15,665,336,329
11W403,,11,Lichtenberg,403,,4,86,,1341,994,347,0,659,4,8,651,331,320
11W404,,11,Lichtenberg,404,,4,86,,1019,769,250,0,556,1,14,542,256,286
11W405,,11,Lichtenberg,405,,4,86,,1171,881,290,0,548,0,8,540,296,244
11W406,,11,Lichtenberg,406,,4,86,,1307,992,315,0,663,4,16,647,325,322
11W407,,11,Lichtenberg,407,,4,86,,1341,1061,280,0,715,4,26,689,334,355
11W408,,11,Lichtenberg,408,,4,86,,1307,990,317,0,591,1,26,565,273,292
11W409,,11,Lichtenberg,409,,4,86,,1196,955,241,0,593,4,11,582,318,264
11W410,,11,Lichtenberg,410,,4,86,,1254,934,320,0,608,5,22,586,317,269
11W411,,11,Lichtenberg,411,,4,86,,1544,1167,377,0,710,11,17,693,333,360
11W412,,11,Lichtenberg,412,,4,86,,957,678,279,0,473,5,11,462,209,253
11W413,,11,Lichtenberg,413,,4,86,,1498,1028,470,0,749,9,17,732,389,343
11W414,,11,Lichtenberg,414,,4,86,,1221,895,326,0,577,1,9,568,272,296
11W415,,11,Lichtenberg,415,,4,86,,1312,1047,265,0,716,6,35,681,341,340
11W416,,11,Lichtenberg,416,,4,86,,1345,970,375,0,707,4,22,685,342,343
11W417,,11,Lichtenberg,417,,4,86,,1334,974,360,0,654,4,20,634,335,299
11W418,,11,Lichtenberg,418,,4,86,,1256,978,278,0,647,8,12,635,350,285
11W419,,11,Lichtenberg,419,,4,86,,1263,909,354,0,636,4,11,625,328,297
11W420,,11,Lichtenberg,420,,4,86,,1521,1176,345,0,785,1,26,759,361,398
11W421,,11,Lichtenberg,421,,4,86,,1206,856,350,0,566,9,27,539,287,252
11W422,,11,Lichtenberg,422,,4,86,,1300,966,334,0,661,2,14,647,354,293
11W423,,11,Lichtenberg,423,,4,86,,1403,1026,377,0,712,5,18,694,374,320
11W424,,11,Lichtenberg,424,,4,86,,1130,914,216,0,556,2,14,542,312,230
11W425,,11,Lichtenberg,425,,4,86,,1219,916,303,0,656,6,12,644,295,349
11W426,,11,Lichtenberg,426,,4,86,,970,747,223,0,486,4,6,480,250,230
11W427,,11,Lichtenberg,427,,4,86,,1160,901,259,0,600,3,11,589,297,292
11W428,,11,Lichtenberg,428,,4,86,,975,768,207,0,534,7,12,522,280,242
11W501,,11,Lichtenberg,501,,5,86,,1303,1004,299,0,541,3,8,533,276,257
11W502,,11,Lichtenberg,502,,5,86,,1573,1250,323,0,787,1,18,769,459,310
11W503,,11,Lichtenberg,503,,5,86,,1343,1123,220,0,700,2,16,684,413,271
11W504,,11,Lichtenberg,504,,5,86,,1057,815,242,0,471,4,11,460,247,213
11W505,,11,Lichtenberg,505,,5,86,,1067,871,196,0,547,2,8,539,311,228
11W506,,11,Lichtenberg,506,,5,86,,1126,894,232,0,546,2,11,535,301,234
11W507,,11,Lichtenberg,507,,5,86,,958,748,210,0,496,2,19,477,287,190
11W508,,11,Lichtenberg,508,,5,86,,1430,1176,254,0,748,0,15,733,400,333
11W509,,11,Lichtenberg,509,,5,86,,1459,1184,275,0,737,4,18,719,375,344
11W510,,11,Lichtenberg,510,,5,86,,1267,938,329,0,646,8,13,633,333,300
11W511,,11,Lichtenberg,511,,5,86,,1064,808,256,0,568,2,11,557,312,245
11W512,,11,Lichtenberg,512,,5,86,,1242,917,325,0,666,2,9,657,327,330
11W513,,11,Lichtenberg,513,,5,86,,1216,897,319,0,567,4,12,555,291,264
11W514,,11,Lichtenberg,514,,5,86,,1298,956,342,0,582,6,7,575,307,268
11W515,,11,Lichtenberg,515,,5,86,,1125,866,259,0,579,10,15,564,321,243
11W516,,11,Lichtenberg,516,,5,86,,1090,835,255,0,564,3,12,552,290,262
11W517,,11,Lichtenberg,517,,5,86,,1063,763,300,0,580,7,14,566,287,279
11W518,,11,Lichtenberg,518,,5,86,,1259,915,344,0,593,5,22,571,315,256
11W519,,11,Lichtenberg,519,,5,86,,1476,1057,419,0,838,12,25,813,308,505
11W520,,11,Lichtenberg,520,,5,86,,1264,930,334,0,744,12,22,722,284,438
11W521,,11,Lichtenberg,521,,5,86,,1345,961,384,0,694,10,29,665,298,367
11W522,,11,Lichtenberg,522,,5,86,,1051,777,274,0,571,10,15,556,257,299
11W523,,11,Lichtenberg,523,,5,86,,1325,1011,314,0,694,0,5,689,339,350
11W524,,11,Lichtenberg,524,,5,86,,1269,923,346,0,650,5,14,636,346,290
11W525,,11,Lichtenberg,525,,5,86,,1269,988,281,0,629,1,22,607,328,279
11W526,,11,Lichtenberg,526,,5,86,,1286,935,351,0,678,5,20,658,294,364
11W527,,11,Lichtenberg,527,,5,86,,1139,850,289,0,583,3,13,570,275,295
11W528,,11,Lichtenberg,528,,5,86,,1283,972,311,0,672,3,21,651,310,341
11W601,,11,Lichtenberg,601,,6,86,,1269,1005,264,0,660,1,19,641,324,317
11W602,,11,Lichtenberg,602,,6,86,,1299,961,338,0,704,1,22,682,303,379
11W603,,11,Lichtenberg,603,,6,86,,1083,850,233,0,555,1,18,537,289,248
11W604,,11,Lichtenberg,604,,6,86,,1006,738,268,0,515,6,13,502,247,255
11W605,,11,Lichtenberg,605,,6,86,,1228,882,346,0,647,3,13,634,308,326
11W606,,11,Lichtenberg,606,,6,86,,1173,877,296,0,593,0,12,581,298,283
11W607,,11,Lichtenberg,607,,6,86,,1222,945,277,0,628,3,18,610,318,292
11W608,,11,Lichtenberg,608,,6,86,,1087,862,225,0,547,2,14,533,267,266
11W609,,11,Lichtenberg,609,,6,86,,1347,974,373,0,726,4,17,709,359,350
11W610,,11,Lichtenberg,610,,6,86,,1395,1050,345,0,679,0,11,668,377,291
11W611,,11,Lichtenberg,611,,6,86,,1628,1322,306,0,840,4,44,796,435,361
11W612,,11,Lichtenberg,612,,6,86,,1290,1010,280,0,604,0,13,591,291,300
11W613,,11,Lichtenberg,613,,6,86,,1249,886,363,0,723,10,20,703,287,416
11W614,,11,Lichtenberg,614,,6,86,,1174,848,326,0,731,6,11,720,289,431
11W615,,11,Lichtenberg,615,,6,86,,1275,997,278,0,712,14,14,698,349,349
11W616,,11,Lichtenberg,616,,6,86,,1815,1362,453,0,961,5,6,955,487,468
11W617,,11,Lichtenberg,617,,6,86,,981,674,307,0,549,2,7,542,253,289
11W618,,11,Lichtenberg,618,,6,86,,1113,814,299,0,567,2,13,554,260,294
11W619,,11,Lichtenberg,619,,6,86,,1174,865,309,0,670,10,9,661,317,344
11W620,,11,Lichtenberg,620,,6,86,,1059,754,305,0,575,0,17,558,239,319
11W621,,11,Lichtenberg,621,,6,86,,1461,1090,371,0,876,8,14,862,389,473
11W622,,11,Lichtenberg,622,,6,86,,1302,932,370,0,744,5,19,725,319,406
11W623,,11,Lichtenberg,623,,6,86,,1181,861,320,0,714,6,13,701,298,403
11W624,,11,Lichtenberg,624,,6,86,,959,639,320,0,527,3,17,510,215,295
11W625,,11,Lichtenberg,625,,6,86,,1158,857,301,0,709,10,15,694,293,401
11W626,,11,Lichtenberg,626,,6,86,,1281,961,320,0,781,11,13,768,347,421
11W627,,11,Lichtenberg,627,,6,86,,1399,948,451,0,775,9,16,759,299,460
11W628,,11,Lichtenberg,628,,6,86,,1218,826,392,0,687,6,11,676,263,413
11W629,,11,Lichtenberg,629,,6,86,,1144,797,347,0,641,2,19,622,278,344
11W630,,11,Lichtenberg,630,,6,86,,963,708,255,0,632,0,6,626,217,409
12W101,,12,Reinickendorf,101,,1,77,,1186,835,351,0,574,2,4,570,292,278
12W102,,12,Reinickendorf,102,,1,77,,903,725,178,0,417,4,10,407,256,151
12W103,,12,Reinickendorf,103,,1,77,,849,675,174,0,386,1,6,380,245,135
12W104,,12,Reinickendorf,104,,1,77,,914,762,152,0,460,3,8,452,264,188
12W105,,12,Reinickendorf,105,,1,77,,816,658,158,0,355,2,2,353,211,142
12W106,,12,Reinickendorf,106,,1,77,,1142,946,196,0,551,0,9,542,282,260
12W107,,12,Reinickendorf,107,,1,77,,892,737,155,0,508,1,4,504,242,262
12W108,,12,Reinickendorf,108,,1,77,,1223,988,235,0,676,0,12,664,387,277
12W109,,12,Reinickendorf,109,,1,77,,910,734,176,0,399,1,4,395,210,185
12W110,,12,Reinickendorf,110,,1,77,,934,697,237,0,402,1,7,395,208,187
12W111,,12,Reinickendorf,111,,1,77,,1183,979,204,0,593,2,4,589,324,265
12W112,,12,Reinickendorf,112,,1,77,,1232,811,421,0,552,3,3,549,304,245
12W113,,12,Reinickendorf,113,,1,77,,671,514,157,0,317,0,2,315,183,132
12W114,,12,Reinickendorf,114,,1,77,,1747,1465,282,0,801,1,12,789,499,290
12W115,,12,Reinickendorf,115,,1,77,,674,564,110,0,335,2,5,330,179,151
12W116,,12,Reinickendorf,116,,1,77,,1071,846,225,0,519,3,8,511,305,206
12W117,,12,Reinickendorf,117,,1,77,,1587,1194,393,0,677,0,11,666,355,311
12W118,,12,Reinickendorf,118,,1,77,,1470,1182,288,0,570,1,14,556,302,254
12W119,,12,Reinickendorf,119,,1,77,,1317,1081,236,0,691,2,12,679,359,320
12W120,,12,Reinickendorf,120,,1,77,,1360,1127,233,0,674,2,8,666,317,349
12W121,,12,Reinickendorf,121,,1,77,,1189,939,250,0,554,2,9,545,309,236
12W122,,12,Reinickendorf,122,,1,77,,1477,1148,329,0,711,1,6,705,383,322
12W123,,12,Reinickendorf,123,,1,77,,1511,1170,341,0,673,2,7,666,361,305
12W124,,12,Reinickendorf,124,,1,77,,1048,848,200,0,481,0,8,473,282,191
12W125,,12,Reinickendorf,125,,1,77,,1238,1019,219,0,557,1,8,549,323,226
12W126,,12,Reinickendorf,126,,1,77,,1160,925,235,0,565,4,10,555,301,254
12W201,,12,Reinickendorf,201,,2,77,,1096,882,214,0,602,2,1,601,444,157
12W202,,12,Reinickendorf,202,,2,77,,1173,814,359,0,537,0,6,531,323,208
12W203,,12,Reinickendorf,203,,2,77,,1418,957,461,0,715,3,4,711,335,376
12W204,,12,Reinickendorf,204,,2,77,,763,553,210,0,410,2,2,408,223,185
12W205,,12,Reinickendorf,205,,2,77,,782,591,191,0,438,1,5,433,215,218
12W206,,12,Reinickendorf,206,,2,77,,1211,833,378,0,457,2,0,457,232,225
12W207,,12,Reinickendorf,207,,2,77,,1458,1206,252,0,733,1,17,716,494,222
12W208,,12,Reinickendorf,208,,2,77,,1309,1135,174,0,674,2,28,646,428,218
12W209,,12,Reinickendorf,209,,2,77,,1250,944,306,0,542,0,5,537,355,182
12W210,,12,Reinickendorf,210,,2,77,,1466,1051,415,0,703,2,2,701,442,259
12W211,,12,Reinickendorf,211,,2,77,,1227,904,323,0,605,1,9,596,358,238
12W212,,12,Reinickendorf,212,,2,77,,1657,1214,443,0,790,3,7,783,480,303
12W213,,12,Reinickendorf,213,,2,77,,1647,1300,347,0,802,4,14,788,517,271
12W214,,12,Reinickendorf,214,,2,77,,1079,826,253,0,572,7,13,559,344,215
12W215,,12,Reinickendorf,215,,2,77,,1443,1142,301,0,720,4,8,712,419,293
12W216,,12,Reinickendorf,216,,2,77,,1576,1230,346,0,749,0,8,741,466,275
12W217,,12,Reinickendorf,217,,2,77,,1414,1150,264,0,677,4,7,670,379,291
12W218,,12,Reinickendorf,218,,2,77,,1049,854,195,0,409,1,5,404,240,164
12W219,,12,Reinickendorf,219,,2,77,,1106,798,308,0,539,7,0,539,229,310
12W220,,12,Reinickendorf,220,,2,77,,1325,1117,208,0,555,3,13,542,394,148
12W221,,12,Reinickendorf,221,,2,77,,1467,1081,386,0,656,1,5,651,395,256
12W222,,12,Reinickendorf,222,,2,77,,983,828,155,0,423,0,6,417,224,193
12W223,,12,Reinickendorf,223,,2,77,,584,408,176,0,327,2,1,326,85,241
12W224,,12,Reinickendorf,224,,2,77,,354,268,86,0,184,0,1,183,139,44
12W225,,12,Reinickendorf,225,,2,77,,1179,874,305,0,543,1,2,541,320,221
12W301,,12,Reinickendorf,301,,3,77,,1536,1069,466,1,952,8,19,933,602,331
12W302,,12,Reinickendorf,302,,3,77,,1010,706,304,0,574,1,6,568,375,193
12W303,,12,Reinickendorf,303,,3,77,,1134,824,310,0,662,0,17,645,463,182
12W304,,12,Reinickendorf,304,,3,77,,980,629,351,0,455,5,3,452,279,173
12W305,,12,Reinickendorf,305,,3,77,,1405,893,512,0,771,3,10,761,486,275
12W306,,12,Reinickendorf,306,,3,77,,1392,934,458,0,807,3,5,802,558,244
12W307,,12,Reinickendorf,307,,3,77,,1395,969,426,0,809,8,3,806,574,232
12W308,,12,Reinickendorf,308,,3,77,,1274,826,448,0,664,4,7,657,398,259
12W309,,12,Reinickendorf,309,,3,77,,1340,982,358,0,681,1,8,673,453,220
12W310,,12,Reinickendorf,310,,3,77,,1114,770,344,0,650,7,10,640,424,216
12W311,,12,Reinickendorf,311,,3,77,,1258,768,490,0,624,2,10,614,410,204
12W312,,12,Reinickendorf,312,,3,77,,1416,998,418,0,844,3,18,826,541,285
12W313,,12,Reinickendorf,313,,3,77,,1262,788,474,0,642,8,6,636,363,273
12W314,,12,Reinickendorf,314,,3,77,,1824,1261,563,0,999,4,15,984,657,327
12W315,,12,Reinickendorf,315,,3,77,,1249,815,434,0,675,5,9,666,379,287
12W316,,12,Reinickendorf,316,,3,77,,1674,1170,504,0,897,0,15,882,560,322
12W317,,12,Reinickendorf,317,,3,77,,1702,1231,471,0,877,5,9,868,580,288
12W318,,12,Reinickendorf,318,,3,77,,1197,822,375,0,709,7,8,701,359,342
12W319,,12,Reinickendorf,319,,3,77,,1605,1316,289,0,871,1,14,857,618,239
12W320,,12,Reinickendorf,320,,3,77,,960,773,187,0,482,2,4,478,323,155
12W321,,12,Reinickendorf,321,,3,77,,1294,1022,272,0,643,3,10,633,422,211
12W322,,12,Reinickendorf,322,,3,77,,1568,1221,347,0,819,4,10,809,524,285
12W323,,12,Reinickendorf,323,,3,77,,1117,757,360,0,649,5,5,644,258,386
12W324,,12,Reinickendorf,324,,3,77,,254,165,89,0,127,0,0,127,23,104
12W401,,12,Reinickendorf,401,,4,77,,1383,934,449,0,753,7,9,744,476,268
12W402,,12,Reinickendorf,402,,4,77,,1218,875,342,1,632,1,9,623,448,175
12W403,,12,Reinickendorf,403,,4,77,,777,487,290,0,391,3,1,390,250,140
12W404,,12,Reinickendorf,404,,4,77,,1521,1280,241,0,722,0,13,709,558,151
12W405,,12,Reinickendorf,405,,4,77,,1618,1323,295,0,818,3,13,805,579,226
12W406,,12,Reinickendorf,406,,4,77,,1809,1333,476,0,924,6,21,903,600,303
12W407,,12,Reinickendorf,407,,4,77,,1172,820,352,0,689,4,3,686,455,231
12W408,,12,Reinickendorf,408,,4,77,,1372,998,374,0,814,5,8,806,496,310
12W409,,12,Reinickendorf,409,,4,77,,1113,792,321,0,590,4,9,581,414,167
12W410,,12,Reinickendorf,410,,4,77,,1089,833,256,0,621,2,6,615,446,169
12W411,,12,Reinickendorf,411,,4,77,,870,666,204,0,478,0,6,472,338,134
12W412,,12,Reinickendorf,412,,4,77,,1652,1204,448,0,968,8,9,959,644,315
12W413,,12,Reinickendorf,413,,4,77,,1468,971,497,0,799,6,7,792,504,288
12W414,,12,Reinickendorf,414,,4,77,,1448,1023,425,0,736,5,5,731,454,277
12W415,,12,Reinickendorf,415,,4,77,,1684,1161,523,0,775,0,8,767,541,226
12W416,,12,Reinickendorf,416,,4,77,,1825,1426,399,0,1003,6,16,987,706,281
12W417,,12,Reinickendorf,417,,4,77,,1596,1074,522,0,833,7,8,825,466,359
12W418,,12,Reinickendorf,418,,4,77,,1169,965,204,0,580,2,4,576,413,163
12W419,,12,Reinickendorf,419,,4,77,,1578,1182,396,0,758,0,4,754,519,235
12W420,,12,Reinickendorf,420,,4,77,,1027,816,211,0,602,1,8,594,437,157
12W421,,12,Reinickendorf,421,,4,77,,1046,788,258,0,618,4,13,605,399,206
12W422,,12,Reinickendorf,422,,4,77,,1599,1232,367,0,831,2,6,825,532,293
12W423,,12,Reinickendorf,423,,4,77,,1364,1026,338,0,730,3,9,721,497,224
12W424,,12,Reinickendorf,424,,4,77,,772,594,178,0,391,0,5,386,239,147
12W425,,12,Reinickendorf,425,,4,77,,1809,1360,448,1,970,6,1,969,630,339
12W426,,12,Reinickendorf,426,,4,77,,655,486,169,0,350,0,2,348,221,127
12W501,,12,Reinickendorf,501,,5,77,,854,575,279,0,491,2,2,489,299,190
12W502,,12,Reinickendorf,502,,5,77,,1267,889,378,0,711,5,13,698,480,218
12W503,,12,Reinickendorf,503,,5,77,,1722,1259,463,0,1030,5,11,1019,718,301
12W504,,12,Reinickendorf,504,,5,77,,1295,1061,234,0,626,1,35,591,455,136
12W505,,12,Reinickendorf,505,,5,77,,852,628,224,0,470,0,10,460,346,114
12W506,,12,Reinickendorf,506,,5,77,,876,691,185,0,461,1,7,454,338,116
12W507,,12,Reinickendorf,507,,5,77,,841,659,182,0,403,3,6,397,302,95
12W508,,12,Reinickendorf,508,,5,77,,639,565,74,0,292,0,8,284,209,75
12W509,,12,Reinickendorf,509,,5,77,,979,860,119,0,472,0,12,460,360,100
12W510,,12,Reinickendorf,510,,5,77,,761,641,120,0,355,2,5,350,279,71
12W511,,12,Reinickendorf,511,,5,77,,902,770,132,0,389,0,8,381,304,77
12W512,,12,Reinickendorf,512,,5,77,,971,828,143,0,505,0,1,504,394,110
12W513,,12,Reinickendorf,513,,5,77,,1460,1245,215,0,630,0,10,620,465,155
12W514,,12,Reinickendorf,514,,5,77,,1337,1075,262,0,455,0,3,452,324,128
12W515,,12,Reinickendorf,515,,5,77,,854,733,121,0,403,1,1,402,292,110
12W516,,12,Reinickendorf,516,,5,77,,1267,1094,173,0,598,0,7,591,460,131
12W517,,12,Reinickendorf,517,,5,77,,942,775,167,0,418,3,9,409,319,90
12W518,,12,Reinickendorf,518,,5,77,,987,746,241,0,530,0,5,525,383,142
12W519,,12,Reinickendorf,519,,5,77,,1088,881,207,0,546,0,13,533,396,137
12W520,,12,Reinickendorf,520,,5,77,,1026,861,165,0,374,0,15,359,273,86
12W521,,12,Reinickendorf,521,,5,77,,1069,789,280,0,523,0,3,520,371,149
12W522,,12,Reinickendorf,522,,5,77,,811,673,138,0,363,0,1,362,259,103
12W523,,12,Reinickendorf,523,,5,77,,1068,907,161,0,521,0,9,512,378,134
12W524,,12,Reinickendorf,524,,5,77,,1157,1025,132,0,522,0,5,517,399,118
12W525,,12,Reinickendorf,525,,5,77,,805,593,212,0,480,0,5,475,339,136
12W526,,12,Reinickendorf,526,,5,77,,1448,1244,204,0,766,2,4,762,598,164
12W601,,12,Reinickendorf,601,,6,77,,260,211,49,0,163,0,1,162,97,65
12W602,,12,Reinickendorf,602,,6,77,,1389,908,481,0,814,4,9,805,557,248
12W603,,12,Reinickendorf,603,,6,77,,1203,786,417,0,646,0,7,639,433,206
12W604,,12,Reinickendorf,604,,6,77,,1055,698,357,0,598,5,5,593,385,208
12W605,,12,Reinickendorf,605,,6,77,,929,556,373,0,486,8,12,474,301,173
12W606,,12,Reinickendorf,606,,6,77,,1249,808,441,0,710,3,10,700,495,205
12W607,,12,Reinickendorf,607,,6,77,,1020,693,327,0,567,3,5,562,394,168
12W608,,12,Reinickendorf,608,,6,77,,765,504,261,0,415,1,9,406,297,109
12W609,,12,Reinickendorf,609,,6,77,,1453,904,549,0,790,7,7,783,506,277
12W610,,12,Reinickendorf,610,,6,77,,1013,656,357,0,569,5,6,563,383,180
12W611,,12,Reinickendorf,611,,6,77,,841,568,273,0,497,6,7,490,332,158
12W612,,12,Reinickendorf,612,,6,77,,1097,688,409,0,549,3,8,541,354,187
12W613,,12,Reinickendorf,613,,6,77,,1127,721,406,0,600,7,14,586,384,202
12W614,,12,Reinickendorf,614,,6,77,,1426,914,512,0,707,9,8,699,436,263
12W615,,12,Reinickendorf,615,,6,77,,1790,1177,613,0,959,3,14,945,650,295
12W616,,12,Reinickendorf,616,,6,77,,1442,932,510,0,823,3,6,817,550,267
12W617,,12,Reinickendorf,617,,6,77,,1131,759,372,0,630,5,11,619,416,203
12W618,,12,Reinickendorf,618,,6,77,,1433,943,490,0,794,5,13,781,512,269
12W619,,12,Reinickendorf,619,,6,77,,1715,1121,594,0,952,1,16,936,604,332
12W620,,12,Reinickendorf,620,,6,77,,1020,665,355,0,578,4,2,576,373,203
12W621,,12,Reinickendorf,621,,6,77,,932,598,334,0,486,3,2,484,320,164
12W622,,12,Reinickendorf,622,,6,77,,1071,685,386,0,593,3,3,590,381,209
12W623,,12,Reinickendorf,623,,6,77,,891,536,355,0,487,4,7,480,307,173
12W624,,12,Reinickendorf,624,,6,77,,1194,868,326,0,722,4,9,713,473,240
12W625,,12,Reinickendorf,625,,6,77,,1104,773,331,0,661,10,11,650,428,222
01B1A,,01,Mitte,1A,,1,75,O,0,0,0,0,1982,1982,2,1980,1223,757
01B1B,,01,Mitte,1B,,1,75,O,0,0,0,0,1184,1184,5,1179,767,412
01B1C,,01,Mitte,1C,,1,75,O,0,0,0,0,1063,1063,9,1054,611,443
01B1D,,01,Mitte,1D,,1,75,O,0,0,0,0,1433,1433,208,1225,688,537
01B1E,,01,Mitte,1E,,1,75,O,0,0,0,0,1494,1494,5,1489,860,629
01B2A,,01,Mitte,2A,,2,75,O,0,0,0,0,1522,1522,7,1515,925,590
01B2B,,01,Mitte,2B,,2,75,O,0,0,0,0,1334,1334,12,1322,733,589
01B2C,,01,Mitte,2C,,2,75,O,0,0,0,0,1171,1171,10,1161,638,523
01B2D,,01,Mitte,2D,,2,75,O,0,0,0,0,926,926,3,923,440,483
01B2E,,01,Mitte,2E,,2,75,O,0,0,0,0,1104,1104,7,1097,557,540
01B2F,,01,Mitte,2F,,2,75,O,0,0,0,0,1277,1277,10,1267,615,652
01B3A,,01,Mitte,3A,,3,75,W,0,0,0,0,1026,1026,14,1012,587,425
01B3B,,01,Mitte,3B,,3,75,W,0,0,0,0,1490,1490,159,1331,729,602
01B3C,,01,Mitte,3C,,3,75,W,0,0,0,0,1344,1344,134,1210,721,489
01B3D,,01,Mitte,3D,,3,75,W,0,0,0,0,1009,1009,10,999,616,383
01B3E,,01,Mitte,3E,,3,75,W,0,0,0,0,1457,1457,12,1445,990,455
01B3F,,01,Mitte,3F,,3,75,W,0,0,0,0,718,718,1,717,418,299
01B4A,,01,Mitte,4A,,4,75,W,0,0,0,0,1144,1144,8,1136,742,394
01B4B,,01,Mitte,4B,,4,75,W,0,0,0,0,1250,1250,11,1239,725,514
01B4C,,01,Mitte,4C,,4,75,W,0,0,0,0,1061,1061,10,1051,589,462
01B4D,,01,Mitte,4D,,4,75,W,0,0,0,0,1142,1142,12,1130,656,474
01B4E,,01,Mitte,4E,,4,75,W,0,0,0,0,1487,1487,9,1478,792,686
01B5A,,01,Mitte,5A,,5,75,W,0,0,0,0,1101,1101,4,1097,561,536
01B5B,,01,Mitte,5B,,5,75,W,0,0,0,0,1024,1024,3,1021,478,543
01B5C,,01,Mitte,5C,,5,75,W,0,0,0,0,893,893,5,888,460,428
01B5D,,01,Mitte,5D,,5,75,W,0,0,0,0,1288,1288,12,1276,594,682
01B5E,,01,Mitte,5E,,5,75,W,0,0,0,0,855,855,66,789,397,392
01B6A,,01,Mitte,6A,,6,75,W,0,0,0,0,768,768,0,768,303,465
01B6B,,01,Mitte,6B,,6,75,W,0,0,0,0,733,733,3,730,334,396
01B6C,,01,Mitte,6C,,6,75,W,0,0,0,0,1016,1016,6,1010,470,540
01B6D,,01,Mitte,6D,,6,75,W,0,0,0,0,797,797,10,787,410,377
01B6E,,01,Mitte,6E,,6,75,W,0,0,0,0,879,879,79,800,411,389
01B7A,,01,Mitte,7A,,7,75,W,0,0,0,0,1041,1041,10,1031,530,501
01B7B,,01,Mitte,7B,,7,75,W,0,0,0,0,1163,1163,7,1156,619,537
01B7C,,01,Mitte,7C,,7,75,W,0,0,0,0,759,759,9,750,451,299
01B7D,,01,Mitte,7D,,7,75,W,0,0,0,0,571,571,3,568,366,202
01B7E,,01,Mitte,7E,,7,75,W,0,0,0,0,934,934,6,928,548,380
02B1A,,02,Friedrichshain-Kreuzberg,1A,,1,83,W,0,0,0,0,772,772,14,758,374,384
02B1B,,02,Friedrichshain-Kreuzberg,1B,,1,83,W,0,0,0,0,707,707,7,700,307,393
02B1C,,02,Friedrichshain-Kreuzberg,1C,,1,83,W,0,0,0,0,770,770,8,762,359,403
02B1D,,02,Friedrichshain-Kreuzberg,1D,,1,83,W,0,0,0,0,688,688,8,680,281,399
02B1E,,02,Friedrichshain-Kreuzberg,1E,,1,83,W,0,0,0,0,661,661,5,656,289,367
02B1F,,02,Friedrichshain-Kreuzberg,1F,,1,83,W,0,0,0,0,734,734,9,725,325,400
02B1G,,02,Friedrichshain-Kreuzberg,1G,,1,83,W,0,0,0,0,661,661,6,655,276,379
02B1H,,02,Friedrichshain-Kreuzberg,1H,,1,83,W,0,0,0,0,638,638,6,632,244,388
02B1J,,02,Friedrichshain-Kreuzberg,1J,,1,83,W,0,0,0,0,573,573,14,559,241,318
02B1K,,02,Friedrichshain-Kreuzberg,1K,,1,83,W,0,0,0,0,441,441,6,435,169,266
02B1L,,02,Friedrichshain-Kreuzberg,1L,,1,83,W,0,0,0,0,419,419,7,412,196,216
02B1M,,02,Friedrichshain-Kreuzberg,1M,,1,83,W,0,0,0,0,449,449,6,443,226,217
02B1N,,02,Friedrichshain-Kreuzberg,1N,,1,83,W,0,0,0,0,494,494,4,490,234,256
02B2A,,02,Friedrichshain-Kreuzberg,2A,,2,83,W,0,0,0,0,439,439,7,432,192,240
02B2B,,02,Friedrichshain-Kreuzberg,2B,,2,83,W,0,0,0,0,579,579,7,572,261,311
02B2C,,02,Friedrichshain-Kreuzberg,2C,,2,83,W,0,0,0,0,430,430,3,427,180,247
02B2D,,02,Friedrichshain-Kreuzberg,2D,,2,83,W,0,0,0,0,521,521,4,517,198,319
02B2E,,02,Friedrichshain-Kreuzberg,2E,,2,83,W,0,0,0,0,388,388,8,380,165,215
02B2F,,02,Friedrichshain-Kreuzberg,2F,,2,83,W,0,0,0,0,412,412,7,405,143,262
02B2G,,02,Friedrichshain-Kreuzberg,2G,,2,83,W,0,0,0,0,425,425,9,416,180,236
02B2H,,02,Friedrichshain-Kreuzberg,2H,,2,83,O,0,0,0,0,824,824,12,812,381,431
02B2J,,02,Friedrichshain-Kreuzberg,2J,,2,83,O,0,0,0,0,756,756,14,742,303,439
02B2K,,02,Friedrichshain-Kreuzberg,2K,,2,83,O,0,0,0,0,597,597,5,592,302,290
02B2L,,02,Friedrichshain-Kreuzberg,2L,,2,83,O,0,0,0,0,595,595,8,587,278,309
02B2M,,02,Friedrichshain-Kreuzberg,2M,,2,83,O,0,0,0,0,672,672,5,667,314,353
02B2N,,02,Friedrichshain-Kreuzberg,2N,,2,83,O,0,0,0,0,558,558,8,550,245,305
02B3A,,02,Friedrichshain-Kreuzberg,3A,,3,83,W,0,0,0,0,391,391,2,389,242,147
02B3B,,02,Friedrichshain-Kreuzberg,3B,,3,83,W,0,0,0,0,331,331,5,326,166,160
02B3C,,02,Friedrichshain-Kreuzberg,3C,,3,83,W,0,0,0,0,607,607,5,602,376,226
02B3D,,02,Friedrichshain-Kreuzberg,3D,,3,83,W,0,0,0,0,551,551,10,541,337,204
02B3E,,02,Friedrichshain-Kreuzberg,3E,,3,83,W,0,0,0,0,637,637,8,629,277,352
02B3F,,02,Friedrichshain-Kreuzberg,3F,,3,83,W,0,0,0,0,461,461,4,457,270,187
02B3G,,02,Friedrichshain-Kreuzberg,3G,,3,83,W,0,0,0,0,448,448,15,433,207,226
02B3H,,02,Friedrichshain-Kreuzberg,3H,,3,83,W,0,0,0,0,693,693,7,686,246,440
02B3J,,02,Friedrichshain-Kreuzberg,3J,,3,83,W,0,0,0,0,641,641,4,637,275,362
02B4A,,02,Friedrichshain-Kreuzberg,4A,,4,83,O,0,0,0,0,531,531,5,526,262,264
02B4B,,02,Friedrichshain-Kreuzberg,4B,,4,83,O,0,0,0,0,435,435,3,432,194,238
02B4C,,02,Friedrichshain-Kreuzberg,4C,,4,83,O,0,0,0,0,506,506,7,499,243,256
02B4D,,02,Friedrichshain-Kreuzberg,4D,,4,83,O,0,0,0,0,600,600,7,593,291,302
02B4E,,02,Friedrichshain-Kreuzberg,4E,,4,83,O,0,0,0,0,522,522,6,516,229,287
02B4F,,02,Friedrichshain-Kreuzberg,4F,,4,83,O,0,0,0,0,412,412,2,410,208,202
02B4G,,02,Friedrichshain-Kreuzberg,4G,,4,83,O,0,0,0,0,566,566,7,559,251,308
02B4H,,02,Friedrichshain-Kreuzberg,4H,,4,83,O,0,0,0,0,691,691,9,682,315,367
02B4J,,02,Friedrichshain-Kreuzberg,4J,,4,83,O,0,0,0,0,482,482,1,481,249,232
02B4K,,02,Friedrichshain-Kreuzberg,4K,,4,83,O,0,0,0,0,555,555,1,554,250,304
02B4L,,02,Friedrichshain-Kreuzberg,4L,,4,83,O,0,0,0,0,598,598,5,593,271,322
02B4M,,02,Friedrichshain-Kreuzberg,4M,,4,83,O,0,0,0,0,475,475,7,468,214,254
02B4N,,02,Friedrichshain-Kreuzberg,4N,,4,83,O,0,0,0,0,584,584,4,580,299,281
02B5A,,02,Friedrichshain-Kreuzberg,5A,,5,83,O,0,0,0,0,649,649,9,640,318,322
02B5B,,02,Friedrichshain-Kreuzberg,5B,,5,83,O,0,0,0,0,527,527,12,515,210,305
02B5C,,02,Friedrichshain-Kreuzberg,5C,,5,83,O,0,0,0,0,650,650,5,645,311,334
02B5D,,02,Friedrichshain-Kreuzberg,5D,,5,83,O,0,0,0,0,820,820,11,809,377,432
02B5E,,02,Friedrichshain-Kreuzberg,5E,,5,83,O,0,0,0,0,831,831,14,817,371,446
02B5F,,02,Friedrichshain-Kreuzberg,5F,,5,83,O,0,0,0,0,467,467,4,463,229,234
02B5G,,02,Friedrichshain-Kreuzberg,5G,,5,83,O,0,0,0,0,551,551,4,547,258,289
02B5H,,02,Friedrichshain-Kreuzberg,5H,,5,83,O,0,0,0,0,544,544,9,535,251,284
02B5J,,02,Friedrichshain-Kreuzberg,5J,,5,83,O,0,0,0,0,629,629,10,619,267,352
02B5K,,02,Friedrichshain-Kreuzberg,5K,,5,83,O,0,0,0,0,649,649,9,640,269,371
02B5L,,02,Friedrichshain-Kreuzberg,5L,,5,83,O,0,0,0,0,528,528,6,522,244,278
02B5M,,02,Friedrichshain-Kreuzberg,5M,,5,83,O,0,0,0,0,817,817,16,801,378,423
02B5N,,02,Friedrichshain-Kreuzberg,5N,,5,83,O,0,0,0,0,629,629,6,623,308,315
03B1A,,03,Pankow,1A,,1,76,,0,0,0,0,824,824,2,822,406,416
03B1B,,03,Pankow,1B,,1,76,,0,0,0,0,484,484,5,479,254,225
03B1C,,03,Pankow,1C,,1,76,,0,0,0,0,371,371,3,368,215,153
03B1D,,03,Pankow,1D,,1,76,,0,0,0,0,615,615,2,613,349,264
03B1E,,03,Pankow,1E,,1,76,,0,0,0,0,397,397,5,392,208,184
03B1F,,03,Pankow,1F,,1,76,,0,0,0,0,542,542,4,538,266,272
03B1G,,03,Pankow,1G,,1,76,,0,0,0,0,608,608,2,606,308,298
03B1H,,03,Pankow,1H,,1,76,,0,0,0,0,397,397,1,396,238,158
03B1I,,03,Pankow,1I,,1,76,,0,0,0,0,600,600,3,597,271,326
03B1K,,03,Pankow,1K,,1,76,,0,0,0,0,686,686,0,686,321,365
03B1L,,03,Pankow,1L,,1,76,,0,0,0,0,578,578,0,578,314,264
03B2A,,03,Pankow,2A,,2,76,,0,0,0,0,632,632,3,629,350,279
03B2B,,03,Pankow,2B,,2,76,,0,0,0,0,488,488,6,482,270,212
03B2C,,03,Pankow,2C,,2,76,,0,0,0,0,611,611,6,605,355,250
03B2D,,03,Pankow,2D,,2,76,,0,0,0,0,930,930,3,927,465,462
03B2E,,03,Pankow,2E,,2,76,,0,0,0,0,1022,1022,3,1019,416,603
03B2F,,03,Pankow,2F,,2,76,,0,0,0,0,602,602,6,596,311,285
03B2G,,03,Pankow,2G,,2,76,,0,0,0,0,721,721,2,719,334,385
03B2H,,03,Pankow,2H,,2,76,,0,0,0,0,1027,1027,3,1024,437,587
03B2I,,03,Pankow,2I,,2,76,,0,0,0,0,993,993,5,988,313,675
03B3A,,03,Pankow,3A,,3,76,,0,0,0,0,649,649,3,646,273,373
03B3B,,03,Pankow,3B,,3,76,,0,0,0,0,752,752,4,748,288,460
03B3C,,03,Pankow,3C,,3,76,,0,0,0,0,803,803,6,797,281,516
03B3D,,03,Pankow,3D,,3,76,,0,0,0,0,640,640,4,636,156,480
03B3E,,03,Pankow,3E,,3,76,,0,0,0,0,616,616,3,613,196,417
03B3F,,03,Pankow,3F,,3,76,,0,0,0,0,654,654,4,650,199,451
03B3G,,03,Pankow,3G,,3,76,,0,0,0,0,1091,1091,8,1083,207,876
03B3H,,03,Pankow,3H,,3,76,,0,0,0,0,1251,1251,5,1246,292,954
03B3I,,03,Pankow,3I,,3,76,,0,0,0,0,1355,1355,6,1349,302,1047
03B4A,,03,Pankow,4A,,4,76,,0,0,0,0,699,699,4,695,279,416
03B4B,,03,Pankow,4B,,4,76,,0,0,0,0,900,900,6,894,350,544
03B4C,,03,Pankow,4C,,4,76,,0,0,0,0,575,575,6,569,224,345
03B4D,,03,Pankow,4D,,4,76,,0,0,0,0,554,554,4,550,274,276
03B4E,,03,Pankow,4E,,4,76,,0,0,0,0,509,509,7,502,189,313
03B4F,,03,Pankow,4F,,4,76,,0,0,0,0,504,504,2,502,220,282
03B4G,,03,Pankow,4G,,4,76,,0,0,0,0,810,810,4,806,194,612
03B4H,,03,Pankow,4H,,4,76,,0,0,0,0,1085,1085,1,1084,351,733
03B4I,,03,Pankow,4I,,4,76,,0,0,0,0,415,415,1,414,202,212
03B5A,,03,Pankow,5A,,5,76,,0,0,0,0,629,629,1,628,205,423
03B5B,,03,Pankow,5B,,5,76,,0,0,0,0,651,651,2,649,221,428
03B5C,,03,Pankow,5C,,5,76,,0,0,0,0,610,610,4,606,195,411
03B5D,,03,Pankow,5D,,5,76,,0,0,0,0,582,582,6,576,224,352
03B5E,,03,Pankow,5E,,5,76,,0,0,0,0,813,813,3,810,333,477
03B5F,,03,Pankow,5F,,5,76,,0,0,0,0,728,728,3,725,255,470
03B5G,,03,Pankow,5G,,5,76,,0,0,0,0,629,629,3,626,214,412
03B5H,,03,Pankow,5H,,5,76,,0,0,0,0,688,688,8,680,199,481
03B5I,,03,Pankow,5I,,5,76,,0,0,0,0,466,466,1,465,149,316
03B5K,,03,Pankow,5K,,5,76,,0,0,0,0,691,691,4,687,110,577
03B6A,,03,Pankow,6A,,6,76,,0,0,0,0,627,627,5,622,223,399
03B6B,,03,Pankow,6B,,6,76,,0,0,0,0,633,633,9,624,282,342
03B6C,,03,Pankow,6C,,6,76,,0,0,0,0,638,638,2,636,266,370
03B6D,,03,Pankow,6D,,6,76,,0,0,0,0,913,913,4,909,423,486
03B6E,,03,Pankow,6E,,6,76,,0,0,0,0,748,748,8,740,342,398
03B6F,,03,Pankow,6F,,6,76,,0,0,0,0,707,707,7,700,315,385
03B6G,,03,Pankow,6G,,6,76,,0,0,0,0,771,771,2,769,357,412
03B6H,,03,Pankow,6H,,6,76,,0,0,0,0,997,997,11,986,483,503
03B6I,,03,Pankow,6I,,6,76,,0,0,0,0,897,897,5,892,452,440
03B6K,,03,Pankow,6K,,6,76,,0,0,0,0,809,809,5,804,352,452
03B7A,,03,Pankow,7A,,7,76,,0,0,0,0,848,848,2,846,426,420
03B7B,,03,Pankow,7B,,7,76,,0,0,0,0,518,518,4,514,255,259
03B7C,,03,Pankow,7C,,7,83,O,0,0,0,0,632,632,5,627,275,352
03B7D,,03,Pankow,7D,,7,83,O,0,0,0,0,783,783,6,777,406,371
03B7E,,03,Pankow,7E,,7,83,O,0,0,0,0,581,581,1,580,278,302
03B7F,,03,Pankow,7F,,7,76,,0,0,0,0,713,713,3,710,328,382
03B7G,,03,Pankow,7G,,7,76,,0,0,0,0,1024,1024,0,1024,490,534
03B7H,,03,Pankow,7H,,7,76,,0,0,0,0,719,719,3,716,314,402
03B7I,,03,Pankow,7I,,7,76,,0,0,0,0,511,511,3,508,220,288
03B8A,,03,Pankow,8A,,8,83,O,0,0,0,0,635,635,8,627,306,321
03B8B,,03,Pankow,8B,,8,83,O,0,0,0,0,674,674,3,671,339,332
03B8C,,03,Pankow,8C,,8,83,O,0,0,0,0,1049,1049,6,1043,521,522
03B8D,,03,Pankow,8D,,8,83,O,0,0,0,0,751,751,4,747,368,379
03B8E,,03,Pankow,8E,,8,76,,0,0,0,0,764,764,8,756,403,353
03B8F,,03,Pankow,8F,,8,76,,0,0,0,0,773,773,5,768,369,399
03B8G,,03,Pankow,8G,,8,76,,0,0,0,0,971,971,5,966,515,451
03B8H,,03,Pankow,8H,,8,76,,0,0,0,0,688,688,2,686,329,357
03B8I,,03,Pankow,8I,,8,76,,0,0,0,0,906,906,2,904,490,414
03B9A,,03,Pankow,9A,,9,76,,0,0,0,0,516,516,0,516,214,302
03B9B,,03,Pankow,9B,,9,76,,0,0,0,0,677,677,4,673,296,377
03B9C,,03,Pankow,9C,,9,83,O,0,0,0,0,594,594,5,589,264,325
03B9D,,03,Pankow,9D,,9,83,O,0,0,0,0,643,643,5,638,325,313
03B9E,,03,Pankow,9E,,9,83,O,0,0,0,0,768,768,3,765,373,392
03B9F,,03,Pankow,9F,,9,83,O,0,0,0,0,597,597,3,594,291,303
03B9G,,03,Pankow,9G,,9,83,O,0,0,0,0,622,622,4,618,273,345
03B9H,,03,Pankow,9H,,9,83,O,0,0,0,0,739,739,5,734,354,380
03B9I,,03,Pankow,9I,,9,83,O,0,0,0,0,1051,1051,2,1049,455,594
03B9K,,03,Pankow,9K,,9,83,O,0,0,0,0,375,375,3,372,191,181
04B1A,,04,Charlottenburg-Wilmersdorf,1A,,1,78,,0,0,0,0,689,689,4,685,498,187
04B1B,,04,Charlottenburg-Wilmersdorf,1B,,1,78,,0,0,0,0,697,697,3,694,459,235
04B1C,,04,Charlottenburg-Wilmersdorf,1C,,1,78,,0,0,0,0,658,658,8,650,462,188
04B1D,,04,Charlottenburg-Wilmersdorf,1D,,1,78,,0,0,0,0,1004,1004,10,994,745,249
04B1E,,04,Charlottenburg-Wilmersdorf,1E,,1,78,,0,0,0,0,1070,1070,3,1067,741,326
04B2A,,04,Charlottenburg-Wilmersdorf,2A,,2,80,,0,0,0,0,1001,1001,28,973,678,295
04B2B,,04,Charlottenburg-Wilmersdorf,2B,,2,80,,0,0,0,0,815,815,1,814,586,228
04B2C,,04,Charlottenburg-Wilmersdorf,2C,,2,80,,0,0,0,0,641,641,3,638,464,174
04B2D,,04,Charlottenburg-Wilmersdorf,2D,,2,80,,0,0,0,0,894,894,4,890,627,263
04B2E,,04,Charlottenburg-Wilmersdorf,2E,,2,80,,0,0,0,0,939,939,4,935,690,245
04B2F,,04,Charlottenburg-Wilmersdorf,2F,,2,80,,0,0,0,0,774,774,0,774,590,184
04B2G,,04,Charlottenburg-Wilmersdorf,2G,,2,80,,0,0,0,0,958,958,4,954,724,230
04B2H,,04,Charlottenburg-Wilmersdorf,2H,,2,80,,0,0,0,0,949,949,5,944,681,263
04B2J,,04,Charlottenburg-Wilmersdorf,2J,,2,80,,0,0,0,0,1040,1040,9,1031,763,268
04B3A,,04,Charlottenburg-Wilmersdorf,3A,,3,80,,0,0,0,0,1162,1162,10,1152,808,344
04B3B,,04,Charlottenburg-Wilmersdorf,3B,,3,80,,0,0,0,0,956,956,8,948,625,323
04B3C,,04,Charlottenburg-Wilmersdorf,3C,,3,80,,0,0,0,0,995,995,6,989,715,274
04B3D,,04,Charlottenburg-Wilmersdorf,3D,,3,80,,0,0,0,0,932,932,7,925,667,258
04B3E,,04,Charlottenburg-Wilmersdorf,3E,,3,80,,0,0,0,0,1005,1005,4,1001,662,339
04B3F,,04,Charlottenburg-Wilmersdorf,3F,,3,80,,0,0,0,0,1019,1019,9,1010,668,342
04B3G,,04,Charlottenburg-Wilmersdorf,3G,,3,80,,0,0,0,0,891,891,7,884,612,272
04B3H,,04,Charlottenburg-Wilmersdorf,3H,,3,80,,0,0,0,0,801,801,7,794,600,194
04B4A,,04,Charlottenburg-Wilmersdorf,4A,,4,80,,0,0,0,0,891,891,10,881,610,271
04B4B,,04,Charlottenburg-Wilmersdorf,4B,,4,80,,0,0,0,0,1282,1282,9,1273,1008,265
04B4C,,04,Charlottenburg-Wilmersdorf,4C,,4,80,,0,0,0,0,940,940,4,936,671,265
04B4D,,04,Charlottenburg-Wilmersdorf,4D,,4,80,,0,0,0,0,1056,1056,8,1048,755,293
04B4E,,04,Charlottenburg-Wilmersdorf,4E,,4,80,,0,0,0,0,942,942,7,935,681,254
04B4F,,04,Charlottenburg-Wilmersdorf,4F,,4,80,,0,0,0,0,974,974,8,966,710,256
04B4G,,04,Charlottenburg-Wilmersdorf,4G,,4,80,,0,0,0,0,944,944,2,942,740,202
04B4H,,04,Charlottenburg-Wilmersdorf,4H,,4,80,,0,0,0,0,860,860,5,855,670,185
04B5A,,04,Charlottenburg-Wilmersdorf,5A,,5,80,,0,0,0,0,789,789,2,787,640,147
04B5B,,04,Charlottenburg-Wilmersdorf,5B,,5,80,,0,0,0,0,823,823,4,819,628,191
04B5C,,04,Charlottenburg-Wilmersdorf,5C,,5,80,,0,0,0,0,811,811,6,805,565,240
04B5D,,04,Charlottenburg-Wilmersdorf,5D,,5,80,,0,0,0,0,947,947,3,944,707,237
04B5E,,04,Charlottenburg-Wilmersdorf,5E,,5,80,,0,0,0,0,927,927,3,924,668,256
04B5F,,04,Charlottenburg-Wilmersdorf,5F,,5,80,,0,0,0,0,1119,1119,10,1109,876,233
04B5G,,04,Charlottenburg-Wilmersdorf,5G,,5,80,,0,0,0,0,648,648,3,645,510,135
04B5H,,04,Charlottenburg-Wilmersdorf,5H,,5,80,,0,0,0,0,987,987,6,981,839,142
04B5J,,04,Charlottenburg-Wilmersdorf,5J,,5,80,,0,0,0,0,827,827,4,823,655,168
04B6A,,04,Charlottenburg-Wilmersdorf,6A,,6,80,,0,0,0,0,981,981,3,978,734,244
04B6B,,04,Charlottenburg-Wilmersdorf,6B,,6,80,,0,0,0,0,763,763,2,761,529,232
04B6C,,04,Charlottenburg-Wilmersdorf,6C,,6,80,,0,0,0,0,1284,1284,10,1274,915,359
04B6D,,04,Charlottenburg-Wilmersdorf,6D,,6,80,,0,0,0,0,1058,1058,9,1049,685,364
04B6E,,04,Charlottenburg-Wilmersdorf,6E,,6,80,,0,0,0,0,934,934,7,927,589,338
04B6F,,04,Charlottenburg-Wilmersdorf,6F,,6,80,,0,0,0,0,879,879,3,876,586,290
04B6G,,04,Charlottenburg-Wilmersdorf,6G,,6,80,,0,0,0,0,822,822,5,817,473,344
04B6H,,04,Charlottenburg-Wilmersdorf,6H,,6,80,,0,0,0,0,893,893,4,889,616,273
04B7A,,04,Charlottenburg-Wilmersdorf,7A,,7,80,,0,0,0,0,907,907,9,898,636,262
04B7B,,04,Charlottenburg-Wilmersdorf,7B,,7,80,,0,0,0,0,813,813,6,807,606,201
04B7C,,04,Charlottenburg-Wilmersdorf,7C,,7,80,,0,0,0,0,1008,1008,10,998,632,366
04B7D,,04,Charlottenburg-Wilmersdorf,7D,,7,80,,0,0,0,0,1058,1058,9,1049,679,370
04B7E,,04,Charlottenburg-Wilmersdorf,7E,,7,80,,0,0,0,0,1061,1061,9,1052,757,295
04B7F,,04,Charlottenburg-Wilmersdorf,7F,,7,80,,0,0,0,0,1105,1105,7,1098,738,360
04B7G,,04,Charlottenburg-Wilmersdorf,7G,,7,80,,0,0,0,0,1096,1096,2,1094,706,388
04B7H,,04,Charlottenburg-Wilmersdorf,7H,,7,80,,0,0,0,0,861,861,5,856,627,229
04B8A,,04,Charlottenburg-Wilmersdorf,8A,,1,80,,0,0,0,0,988,988,17,971,676,295
04B8B,,04,Charlottenburg-Wilmersdorf,8B,,1,80,,0,0,0,0,1183,1183,10,1173,676,497
05B1A,,05,Spandau,1A,,1,78,,0,0,0,0,780,780,4,776,424,352
05B1B,,05,Spandau,1B,,1,78,,0,0,0,0,639,639,2,637,342,295
05B1C,,05,Spandau,1C,,1,78,,0,0,0,0,942,942,5,937,446,491
05B1D,,05,Spandau,1D,,1,78,,0,0,0,0,716,716,3,713,341,372
05B1E,,05,Spandau,1E,,1,78,,0,0,0,0,787,787,2,785,359,426
05B1F,,05,Spandau,1F,,1,78,,0,0,0,0,770,770,3,767,254,513
05B1G,,05,Spandau,1G,,1,78,,0,0,0,0,760,760,1,759,412,347
05B1H,,05,Spandau,1H,,1,78,,0,0,0,0,722,722,1,721,362,359
05B2A,,05,Spandau,2A,,2,78,,0,0,0,0,694,694,2,692,316,376
05B2B,,05,Spandau,2B,,2,78,,0,0,0,0,718,718,3,715,351,364
05B2C,,05,Spandau,2C,,2,78,,0,0,0,0,716,716,0,716,430,286
05B2D,,05,Spandau,2D,,2,78,,0,0,0,0,715,715,4,711,360,351
05B2E,,05,Spandau,2E,,2,78,,0,0,0,0,611,611,5,606,272,334
05B2F,,05,Spandau,2F,,2,78,,0,0,0,0,709,709,4,705,511,194
05B2G,,05,Spandau,2G,,2,78,,0,0,0,0,751,751,3,748,525,223
05B3A,,05,Spandau,3A,,3,78,,0,0,0,0,687,687,3,684,465,219
05B3B,,05,Spandau,3B,,3,78,,0,0,0,0,701,701,3,698,467,231
05B3C,,05,Spandau,3C,,3,78,,0,0,0,0,669,669,5,664,450,214
05B3D,,05,Spandau,3D,,3,78,,0,0,0,0,905,905,1,904,640,264
05B3E,,05,Spandau,3E,,3,78,,0,0,0,0,777,777,3,774,512,262
05B3F,,05,Spandau,3F,,3,78,,0,0,0,0,807,807,4,803,444,359
05B3G,,05,Spandau,3G,,3,78,,0,0,0,0,793,793,3,790,443,347
05B3H,,05,Spandau,3H,,3,78,,0,0,0,0,875,875,1,874,366,508
05B4A,,05,Spandau,4A,,4,78,,0,0,0,0,980,980,3,977,227,750
05B4B,,05,Spandau,4B,,4,78,,0,0,0,0,552,552,1,551,233,318
05B4C,,05,Spandau,4C,,4,78,,0,0,0,0,872,872,3,869,326,543
05B4D,,05,Spandau,4D,,4,78,,0,0,0,0,673,673,2,671,388,283
05B4E,,05,Spandau,4E,,4,78,,0,0,0,0,675,675,0,675,424,251
05B4F,,05,Spandau,4F,,4,78,,0,0,0,0,817,817,2,815,530,285
05B4G,,05,Spandau,4G,,4,78,,0,0,0,0,892,892,5,887,508,379
05B4H,,05,Spandau,4H,,4,78,,0,0,0,0,845,845,0,845,203,642
05B5A,,05,Spandau,5A,,5,78,,0,0,0,0,747,747,2,745,497,248
05B5B,,05,Spandau,5B,,5,78,,0,0,0,0,737,737,8,729,422,307
05B5C,,05,Spandau,5C,,5,78,,0,0,0,0,766,766,12,754,506,248
05B5D,,05,Spandau,5D,,5,78,,0,0,0,0,642,642,5,637,452,185
05B5E,,05,Spandau,5E,,5,78,,0,0,0,0,618,618,7,611,426,185
05B5F,,05,Spandau,5F,,5,78,,0,0,0,0,871,871,4,867,585,282
05B5G,,05,Spandau,5G,,5,78,,0,0,0,0,905,905,8,897,645,252
05B5H,,05,Spandau,5H,,5,78,,0,0,0,0,709,709,0,709,511,198
05B5I,,05,Spandau,5I,,5,78,,0,0,0,0,547,547,2,545,404,141
05B5J,,05,Spandau,5J,,5,78,,0,0,0,0,490,490,0,490,378,112
05B5K,,05,Spandau,5K,,5,78,,0,0,0,0,568,568,2,566,408,158
05B5L,,05,Spandau,5L,,5,78,,0,0,0,0,614,614,3,611,443,168
06B1A,,06,Steglitz-Zehlendorf,1A,,1,79,,0,0,0,0,1098,1098,17,1081,734,347
06B1B,,06,Steglitz-Zehlendorf,1B,,1,79,,0,0,0,0,1113,1113,5,1108,740,368
06B1C,,06,Steglitz-Zehlendorf,1C,,1,79,,0,0,0,0,913,913,8,905,583,322
06B1D,,06,Steglitz-Zehlendorf,1D,,1,79,,0,0,0,0,782,782,3,779,509,270
06B1E,,06,Steglitz-Zehlendorf,1E,,1,79,,0,0,0,0,816,816,8,808,575,233
06B1F,,06,Steglitz-Zehlendorf,1F,,1,79,,0,0,0,0,804,804,9,795,561,234
06B1G,,06,Steglitz-Zehlendorf,1G,,1,79,,0,0,0,0,1116,1116,13,1103,724,379
06B1H,,06,Steglitz-Zehlendorf,1H,,1,79,,0,0,0,0,970,970,4,966,629,337
06B1I,,06,Steglitz-Zehlendorf,1I,,1,79,,0,0,0,0,1016,1016,6,1010,659,351
06B2A,,06,Steglitz-Zehlendorf,2A,,2,79,,0,0,0,0,968,968,6,962,611,351
06B2B,,06,Steglitz-Zehlendorf,2B,,2,79,,0,0,0,0,802,802,4,798,546,252
06B2C,,06,Steglitz-Zehlendorf,2C,,2,79,,0,0,0,0,708,708,2,706,502,204
06B2D,,06,Steglitz-Zehlendorf,2D,,2,79,,0,0,0,0,911,911,12,899,650,249
06B2E,,06,Steglitz-Zehlendorf,2E,,2,79,,0,0,0,0,863,863,7,856,577,279
06B2F,,06,Steglitz-Zehlendorf,2F,,2,79,,0,0,0,0,805,805,4,801,574,227
06B2G,,06,Steglitz-Zehlendorf,2G,,2,79,,0,0,0,0,1048,1048,10,1038,710,328
06B2H,,06,Steglitz-Zehlendorf,2H,,2,79,,0,0,0,0,738,738,9,729,488,241
06B2I,,06,Steglitz-Zehlendorf,2I,,2,79,,0,0,0,0,893,893,9,884,595,289
06B3A,,06,Steglitz-Zehlendorf,3A,,3,79,,0,0,0,0,1095,1095,4,1091,767,324
06B3B,,06,Steglitz-Zehlendorf,3B,,3,79,,0,0,0,0,972,972,5,967,641,326
06B3C,,06,Steglitz-Zehlendorf,3C,,3,79,,0,0,0,0,950,950,6,944,673,271
06B3D,,06,Steglitz-Zehlendorf,3D,,3,79,,0,0,0,0,1048,1048,7,1041,699,342
06B3E,,06,Steglitz-Zehlendorf,3E,,3,79,,0,0,0,0,1241,1241,1,1240,888,352
06B3F,,06,Steglitz-Zehlendorf,3F,,3,79,,0,0,0,0,1039,1039,4,1035,746,289
06B3G,,06,Steglitz-Zehlendorf,3G,,3,79,,0,0,0,0,1172,1172,10,1162,854,308
06B3H,,06,Steglitz-Zehlendorf,3H,,3,79,,0,0,0,0,1084,1084,9,1075,788,287
06B3I,,06,Steglitz-Zehlendorf,3I,,3,79,,0,0,0,0,1151,1151,8,1143,847,296
06B4A,,06,Steglitz-Zehlendorf,4A,,4,79,,0,0,0,0,875,875,4,871,643,228
06B4B,,06,Steglitz-Zehlendorf,4B,,4,79,,0,0,0,0,934,934,6,928,667,261
06B4C,,06,Steglitz-Zehlendorf,4C,,4,79,,0,0,0,0,1026,1026,6,1020,679,341
06B4D,,06,Steglitz-Zehlendorf,4D,,4,79,,0,0,0,0,805,805,4,801,578,223
06B4E,,06,Steglitz-Zehlendorf,4E,,4,79,,0,0,0,0,1014,1014,8,1006,732,274
06B4F,,06,Steglitz-Zehlendorf,4F,,4,79,,0,0,0,0,889,889,0,889,672,217
06B4G,,06,Steglitz-Zehlendorf,4G,,4,79,,0,0,0,0,876,876,7,869,643,226
06B4H,,06,Steglitz-Zehlendorf,4H,,4,79,,0,0,0,0,846,846,3,843,597,246
06B5A,,06,Steglitz-Zehlendorf,5A,,5,79,,0,0,0,0,750,750,5,745,522,223
06B5B,,06,Steglitz-Zehlendorf,5B,,5,79,,0,0,0,0,981,981,8,973,684,289
06B5C,,06,Steglitz-Zehlendorf,5C,,5,79,,0,0,0,0,649,649,8,641,467,174
06B5D,,06,Steglitz-Zehlendorf,5D,,5,79,,0,0,0,0,845,845,3,842,597,245
06B5E,,06,Steglitz-Zehlendorf,5E,,5,79,,0,0,0,0,748,748,6,742,523,219
06B5F,,06,Steglitz-Zehlendorf,5F,,5,79,,0,0,0,0,580,580,0,580,450,130
06B5G,,06,Steglitz-Zehlendorf,5G,,5,79,,0,0,0,0,701,701,8,693,545,148
06B5H,,06,Steglitz-Zehlendorf,5H,,5,79,,0,0,0,0,785,785,0,785,599,186
06B5I,,06,Steglitz-Zehlendorf,5I,,5,79,,0,0,0,0,553,553,2,551,422,129
06B6A,,06,Steglitz-Zehlendorf,6A,,6,79,,0,0,0,0,882,882,5,877,610,267
06B6B,,06,Steglitz-Zehlendorf,6B,,6,79,,0,0,0,0,872,872,11,861,582,279
06B6C,,06,Steglitz-Zehlendorf,6C,,6,79,,0,0,0,0,1004,1004,4,1000,692,308
06B6D,,06,Steglitz-Zehlendorf,6D,,6,79,,0,0,0,0,1060,1060,7,1053,734,319
06B6E,,06,Steglitz-Zehlendorf,6E,,6,79,,0,0,0,0,1164,1164,8,1156,860,296
06B6F,,06,Steglitz-Zehlendorf,6F,,6,79,,0,0,0,0,1069,1069,10,1059,739,320
06B6G,,06,Steglitz-Zehlendorf,6G,,6,79,,0,0,0,0,880,880,8,872,641,231
06B6H,,06,Steglitz-Zehlendorf,6H,,6,79,,0,0,0,0,1024,1024,11,1013,690,323
06B6I,,06,Steglitz-Zehlendorf,6I,,6,79,,0,0,0,0,1563,1563,5,1558,1256,302
06B7A,,06,Steglitz-Zehlendorf,7A,,7,79,,0,0,0,0,832,832,5,827,614,213
06B7B,,06,Steglitz-Zehlendorf,7B,,7,79,,0,0,0,0,1000,1000,4,996,753,243
06B7C,,06,Steglitz-Zehlendorf,7C,,7,79,,0,0,0,0,819,819,0,819,611,208
06B7D,,06,Steglitz-Zehlendorf,7D,,7,79,,0,0,0,0,1157,1157,3,1154,846,308
06B7E,,06,Steglitz-Zehlendorf,7E,,7,79,,0,0,0,0,891,891,7,884,642,242
06B7F,,06,Steglitz-Zehlendorf,7F,,7,79,,0,0,0,0,908,908,5,903,629,274
06B7G,,06,Steglitz-Zehlendorf,7G,,7,79,,0,0,0,0,1181,1181,1,1180,875,305
06B7H,,06,Steglitz-Zehlendorf,7H,,7,79,,0,0,0,0,1270,1270,10,1260,900,360
06B7I,,06,Steglitz-Zehlendorf,7I,,7,79,,0,0,0,0,1067,1067,8,1059,788,271
07B1A,,07,Tempelhof-Schöneberg,1A,,1,81,,0,0,0,0,860,860,4,856,620,236
07B1B,,07,Tempelhof-Schöneberg,1B,,1,81,,0,0,0,0,630,630,7,623,364,259
07B1C,,07,Tempelhof-Schöneberg,1C,,1,81,,0,0,0,0,762,762,12,750,378,372
07B1D,,07,Tempelhof-Schöneberg,1D,,1,81,,0,0,0,0,781,781,3,778,428,350
07B1E,,07,Tempelhof-Schöneberg,1E,,1,81,,0,0,0,0,1173,1173,1,1172,719,453
07B1F,,07,Tempelhof-Schöneberg,1F,,1,81,,0,0,0,0,1055,1055,1,1054,700,354
07B1G,,07,Tempelhof-Schöneberg,1G,,1,81,,0,0,0,0,1068,1068,11,1057,650,407
07B1H,,07,Tempelhof-Schöneberg,1H,,1,81,,0,0,0,0,989,989,3,986,666,320
07B1I,,07,Tempelhof-Schöneberg,1I,,1,81,,0,0,0,0,883,883,8,875,515,360
07B2A,,07,Tempelhof-Schöneberg,2A,,2,81,,0,0,0,0,1110,1110,13,1097,668,429
07B2B,,07,Tempelhof-Schöneberg,2B,,2,81,,0,0,0,0,1103,1103,20,1083,901,182
07B2C,,07,Tempelhof-Schöneberg,2C,,2,81,,0,0,0,0,791,791,6,785,398,387
07B2D,,07,Tempelhof-Schöneberg,2D,,2,81,,0,0,0,0,732,732,7,725,403,322
07B2E,,07,Tempelhof-Schöneberg,2E,,2,81,,0,0,0,0,803,803,16,787,385,402
07B2F,,07,Tempelhof-Schöneberg,2F,,2,81,,0,0,0,0,821,821,9,812,334,478
07B2G,,07,Tempelhof-Schöneberg,2G,,2,81,,0,0,0,0,956,956,10,946,574,372
07B2H,,07,Tempelhof-Schöneberg,2H,,2,81,,0,0,0,0,950,950,6,944,466,478
07B2I,,07,Tempelhof-Schöneberg,2I,,2,81,,0,0,0,0,604,604,5,599,268,331
07B3A,,07,Tempelhof-Schöneberg,3A,,3,81,,0,0,0,0,1005,1005,11,994,565,429
07B3B,,07,Tempelhof-Schöneberg,3B,,3,81,,0,0,0,0,885,885,7,878,488,390
07B3C,,07,Tempelhof-Schöneberg,3C,,3,81,,0,0,0,0,1077,1077,6,1071,584,487
07B3D,,07,Tempelhof-Schöneberg,3D,,3,81,,0,0,0,0,1043,1043,5,1038,552,486
07B3E,,07,Tempelhof-Schöneberg,3E,,3,81,,0,0,0,0,1139,1139,5,1134,623,511
07B3F,,07,Tempelhof-Schöneberg,3F,,3,81,,0,0,0,0,900,900,4,896,545,351
07B3G,,07,Tempelhof-Schöneberg,3G,,3,81,,0,0,0,0,1164,1164,5,1159,696,463
07B3H,,07,Tempelhof-Schöneberg,3H,,3,81,,0,0,0,0,620,620,6,614,306,308
07B3I,,07,Tempelhof-Schöneberg,3I,,3,81,,0,0,0,0,635,635,9,626,380,246
07B3K,,07,Tempelhof-Schöneberg,3K,,3,81,,0,0,0,0,702,702,3,699,519,180
07B4A,,07,Tempelhof-Schöneberg,4A,,4,81,,0,0,0,0,938,938,7,931,476,455
07B4B,,07,Tempelhof-Schöneberg,4B,,4,81,,0,0,0,0,843,843,7,836,462,374
07B4C,,07,Tempelhof-Schöneberg,4C,,4,81,,0,0,0,0,855,855,16,839,558,281
07B4D,,07,Tempelhof-Schöneberg,4D,,4,81,,0,0,0,0,1055,1055,9,1046,749,297
07B4E,,07,Tempelhof-Schöneberg,4E,,4,81,,0,0,0,0,1069,1069,7,1062,703,359
07B4F,,07,Tempelhof-Schöneberg,4F,,4,81,,0,0,0,0,819,819,6,813,506,307
07B4G,,07,Tempelhof-Schöneberg,4G,,4,81,,0,0,0,0,1018,1018,15,1003,574,429
07B4H,,07,Tempelhof-Schöneberg,4H,,4,81,,0,0,0,0,1010,1010,8,1002,620,382
07B4I,,07,Tempelhof-Schöneberg,4I,,4,81,,0,0,0,0,326,326,2,324,198,126
07B5A,,07,Tempelhof-Schöneberg,5A,,5,81,,0,0,0,0,824,824,4,820,581,239
07B5B,,07,Tempelhof-Schöneberg,5B,,5,81,,0,0,0,0,756,756,9,747,504,243
07B5C,,07,Tempelhof-Schöneberg,5C,,5,81,,0,0,0,0,741,741,4,737,495,242
07B5D,,07,Tempelhof-Schöneberg,5D,,5,81,,0,0,0,0,875,875,8,867,629,238
07B5E,,07,Tempelhof-Schöneberg,5E,,5,81,,0,0,0,0,993,993,5,988,724,264
07B5F,,07,Tempelhof-Schöneberg,5F,,5,81,,0,0,0,0,681,681,3,678,489,189
07B5G,,07,Tempelhof-Schöneberg,5G,,5,81,,0,0,0,0,853,853,6,847,661,186
07B5H,,07,Tempelhof-Schöneberg,5H,,5,81,,0,0,0,0,915,915,6,909,636,273
07B5I,,07,Tempelhof-Schöneberg,5I,,5,81,,0,0,0,0,519,519,3,516,361,155
07B6A,,07,Tempelhof-Schöneberg,6A,,6,81,,0,0,0,0,877,877,12,865,622,243
07B6B,,07,Tempelhof-Schöneberg,6B,,6,81,,0,0,0,0,1202,1202,10,1192,844,348
07B6C,,07,Tempelhof-Schöneberg,6C,,6,81,,0,0,0,0,813,813,10,803,582,221
07B6D,,07,Tempelhof-Schöneberg,6D,,6,81,,0,0,0,0,655,655,1,654,460,194
07B6E,,07,Tempelhof-Schöneberg,6E,,6,81,,0,0,0,0,834,834,1,833,664,169
07B6F,,07,Tempelhof-Schöneberg,6F,,6,81,,0,0,0,0,568,568,6,562,424,138
07B6G,,07,Tempelhof-Schöneberg,6G,,6,81,,0,0,0,0,644,644,1,643,492,151
07B6H,,07,Tempelhof-Schöneberg,6H,,6,81,,0,0,0,0,1059,1059,2,1057,804,253
07B6I,,07,Tempelhof-Schöneberg,6I,,6,81,,0,0,0,0,572,572,0,572,428,144
07B7A,,07,Tempelhof-Schöneberg,7A,,7,81,,0,0,0,0,984,984,8,976,740,236
07B7B,,07,Tempelhof-Schöneberg,7B,,7,81,,0,0,0,0,1018,1018,4,1014,763,251
07B7C,,07,Tempelhof-Schöneberg,7C,,7,81,,0,0,0,0,857,857,4,853,642,211
07B7D,,07,Tempelhof-Schöneberg,7D,,7,81,,0,0,0,0,1008,1008,7,1001,781,220
07B7E,,07,Tempelhof-Schöneberg,7E,,7,81,,0,0,0,0,706,706,7,699,539,160
07B7F,,07,Tempelhof-Schöneberg,7F,,7,81,,0,0,0,0,683,683,7,676,551,125
07B7G,,07,Tempelhof-Schöneberg,7G,,7,81,,0,0,0,0,804,804,6,798,624,174
07B7H,,07,Tempelhof-Schöneberg,7H,,7,81,,0,0,0,0,877,877,11,866,724,142
07B7I,,07,Tempelhof-Schöneberg,7I,,7,81,,0,0,0,0,874,874,5,869,626,243
08B1A,,08,Neukölln,1A,,1,82,,0,0,0,0,1114,1114,16,1098,462,636
08B1B,,08,Neukölln,1B,,1,82,,0,0,0,0,1054,1054,20,1034,415,619
08B1C,,08,Neukölln,1C,,1,82,,0,0,0,0,941,941,12,929,419,510
08B1D,,08,Neukölln,1D,,1,82,,0,0,0,0,1034,1034,21,1013,478,535
08B1E,,08,Neukölln,1E,,1,82,,0,0,0,0,909,909,14,895,452,443
08B1F,,08,Neukölln,1F,,1,82,,0,0,0,0,886,886,15,871,437,434
08B2A,,08,Neukölln,2A,,2,82,,0,0,0,0,469,469,13,456,286,170
08B2B,,08,Neukölln,2B,,2,82,,0,0,0,0,1247,1247,16,1231,547,684
08B2C,,08,Neukölln,2C,,2,82,,0,0,0,0,1197,1197,19,1178,470,708
08B2D,,08,Neukölln,2D,,2,82,,0,0,0,0,1222,1222,13,1209,552,657
08B2E,,08,Neukölln,2E,,2,82,,0,0,0,0,1373,1373,21,1352,612,740
08B3A,,08,Neukölln,3A,,3,82,,0,0,0,0,967,967,15,952,352,600
08B3B,,08,Neukölln,3B,,3,82,,0,0,0,0,937,937,14,923,361,562
08B3C,,08,Neukölln,3C,,3,82,,0,0,0,0,1181,1181,115,1066,451,615
08B3D,,08,Neukölln,3D,,3,82,,0,0,0,0,1005,1005,11,994,520,474
08B3E,,08,Neukölln,3E,,3,82,,0,0,0,0,1003,1003,15,988,663,325
08B4A,,08,Neukölln,4A,,4,82,,0,0,0,0,1121,1121,13,1108,613,495
08B4B,,08,Neukölln,4B,,4,82,,0,0,0,0,1035,1035,11,1024,696,328
08B4C,,08,Neukölln,4C,,4,82,,0,0,0,0,1198,1198,11,1187,809,378
08B4D,,08,Neukölln,4D,,4,82,,0,0,0,0,847,847,5,842,582,260
08B4E,,08,Neukölln,4E,,4,82,,0,0,0,0,1215,1215,4,1211,889,322
08B4F,,08,Neukölln,4F,,4,82,,0,0,0,0,986,986,4,982,732,250
08B5A,,08,Neukölln,5A,,5,82,,0,0,0,0,1060,1060,110,950,709,241
08B5B,,08,Neukölln,5B,,5,82,,0,0,0,0,944,944,2,942,663,279
08B5C,,08,Neukölln,5C,,5,82,,0,0,0,0,1049,1049,4,1045,767,278
08B5D,,08,Neukölln,5D,,5,82,,0,0,0,0,932,932,3,929,712,217
08B5E,,08,Neukölln,5E,,5,82,,0,0,0,0,1114,1114,5,1109,820,289
08B5F,,08,Neukölln,5F,,5,82,,0,0,0,0,810,810,62,748,544,204
08B6A,,08,Neukölln,6A,,6,82,,0,0,0,0,826,826,4,822,595,227
08B6B,,08,Neukölln,6B,,6,82,,0,0,0,0,709,709,1,708,534,174
08B6C,,08,Neukölln,6C,,6,82,,0,0,0,0,870,870,5,865,636,229
08B6D,,08,Neukölln,6D,,6,82,,0,0,0,0,756,756,4,752,564,188
08B6E,,08,Neukölln,6E,,6,82,,0,0,0,0,875,875,11,864,629,235
08B6F,,08,Neukölln,6F,,6,82,,0,0,0,0,716,716,6,710,523,187
08B7A,,08,Neukölln,7A,,7,82,,0,0,0,0,1161,1161,9,1152,830,322
08B7B,,08,Neukölln,7B,,7,82,,0,0,0,0,1012,1012,106,906,676,230
08B7C,,08,Neukölln,7C,,7,82,,0,0,0,0,1062,1062,10,1052,744,308
08B7D,,08,Neukölln,7D,,7,82,,0,0,0,0,860,860,3,857,636,221
08B7E,,08,Neukölln,7E,,7,82,,0,0,0,0,1026,1026,2,1024,737,287
08B7F,,08,Neukölln,7F,,7,82,,0,0,0,0,803,803,2,801,579,222
09B1A,,09,Treptow-Köpenick,1A,,1,84,,0,0,0,0,1319,1319,15,1304,542,762
09B1B,,09,Treptow-Köpenick,1B,,1,84,,0,0,0,0,1858,1858,19,1839,820,1019
09B1C,,09,Treptow-Köpenick,1C,,1,84,,0,0,0,0,1032,1032,0,1032,514,518
09B1D,,09,Treptow-Köpenick,1D,,1,84,,0,0,0,0,1036,1036,9,1027,485,542
09B1E,,09,Treptow-Köpenick,1E,,1,84,,0,0,0,0,1442,1442,14,1428,719,709
09B2A,,09,Treptow-Köpenick,2A,,2,84,,0,0,0,0,1405,1405,11,1394,743,651
09B2B,,09,Treptow-Köpenick,2B,,2,84,,0,0,0,0,1198,1198,0,1198,636,562
09B2C,,09,Treptow-Köpenick,2C,,2,84,,0,0,0,0,802,802,3,799,425,374
09B2D,,09,Treptow-Köpenick,2D,,2,84,,0,0,0,0,788,788,7,781,409,372
09B2E,,09,Treptow-Köpenick,2E,,2,84,,0,0,0,0,1016,1016,14,1002,503,499
09B2F,,09,Treptow-Köpenick,2F,,2,84,,0,0,0,0,1218,1218,18,1200,620,580
09B3A,,09,Treptow-Köpenick,3A,,3,84,,0,0,0,0,1334,1334,16,1318,642,676
09B3B,,09,Treptow-Köpenick,3B,,3,84,,0,0,0,0,1348,1348,14,1334,706,628
09B3C,,09,Treptow-Köpenick,3C,,3,84,,0,0,0,0,1328,1328,5,1323,810,513
09B3D,,09,Treptow-Köpenick,3D,,3,84,,0,0,0,0,1128,1128,5,1123,668,455
09B3E,,09,Treptow-Köpenick,3E,,3,84,,0,0,0,0,824,824,4,820,488,332
09B4A,,09,Treptow-Köpenick,4A,,4,84,,0,0,0,0,1391,1391,11,1380,1328,52
09B4B,,09,Treptow-Köpenick,4B,,4,84,,0,0,0,0,1139,1139,12,1127,672,455
09B4C,,09,Treptow-Köpenick,4C,,4,84,,0,0,0,0,1347,1347,9,1338,687,651
09B4D,,09,Treptow-Köpenick,4D,,4,84,,0,0,0,0,1172,1172,20,1152,614,538
09B4E,,09,Treptow-Köpenick,4E,,4,84,,0,0,0,0,1429,1429,4,1425,1179,246
09B5A,,09,Treptow-Köpenick,5A,,5,84,,0,0,0,0,1068,1068,10,1058,591,467
09B5B,,09,Treptow-Köpenick,5B,,5,84,,0,0,0,0,1126,1126,11,1115,616,499
09B5C,,09,Treptow-Köpenick,5C,,5,84,,0,0,0,0,897,897,11,886,524,362
09B5D,,09,Treptow-Köpenick,5D,,5,84,,0,0,0,0,1281,1281,34,1247,758,489
09B5E,,09,Treptow-Köpenick,5E,,5,84,,0,0,0,0,1109,1109,4,1105,966,139
09B6A,,09,Treptow-Köpenick,6A,,6,84,,0,0,0,0,1339,1339,9,1330,837,493
09B6B,,09,Treptow-Köpenick,6B,,6,84,,0,0,0,0,1376,1376,13,1363,851,512
09B6C,,09,Treptow-Köpenick,6C,,6,84,,0,0,0,0,1148,1148,1,1147,640,507
09B6D,,09,Treptow-Köpenick,6D,,6,84,,0,0,0,0,1193,1193,15,1178,622,556
09B6E,,09,Treptow-Köpenick,6E,,6,84,,0,0,0,0,1502,1502,5,1497,1129,368
10B1A,,10,Marzahn-Hellersdorf,1A,,1,85,,0,0,0,0,386,386,2,384,190,194
10B1B,,10,Marzahn-Hellersdorf,1B,,1,85,,0,0,0,0,321,321,0,321,177,144
10B1C,,10,Marzahn-Hellersdorf,1C,,1,85,,0,0,0,0,454,454,3,451,240,211
10B1D,,10,Marzahn-Hellersdorf,1D,,1,85,,0,0,0,0,438,438,1,437,216,221
10B1E,,10,Marzahn-Hellersdorf,1E,,1,85,,0,0,0,0,640,640,11,629,321,308
10B1F,,10,Marzahn-Hellersdorf,1F,,1,85,,0,0,0,0,570,570,1,569,286,283
10B1G,,10,Marzahn-Hellersdorf,1G,,1,85,,0,0,0,0,315,315,0,315,151,164
10B1H,,10,Marzahn-Hellersdorf,1H,,1,85,,0,0,0,0,396,396,3,393,221,172
10B2A,,10,Marzahn-Hellersdorf,2A,,2,85,,0,0,0,0,515,515,0,515,281,234
10B2B,,10,Marzahn-Hellersdorf,2B,,2,85,,0,0,0,0,495,495,6,489,236,253
10B2C,,10,Marzahn-Hellersdorf,2C,,2,85,,0,0,0,0,400,400,2,398,202,196
10B2D,,10,Marzahn-Hellersdorf,2D,,2,85,,0,0,0,0,513,513,3,510,239,271
10B2E,,10,Marzahn-Hellersdorf,2E,,2,85,,0,0,0,0,372,372,4,368,193,175
10B2F,,10,Marzahn-Hellersdorf,2F,,2,85,,0,0,0,0,412,412,3,409,186,223
10B2G,,10,Marzahn-Hellersdorf,2G,,2,85,,0,0,0,0,501,501,3,498,230,268
10B2H,,10,Marzahn-Hellersdorf,2H,,2,85,,0,0,0,0,277,277,2,275,101,174
10B2J,,10,Marzahn-Hellersdorf,2J,,2,85,,0,0,0,0,295,295,2,293,153,140
10B2K,,10,Marzahn-Hellersdorf,2K,,2,85,,0,0,0,0,325,325,4,321,149,172
10B2L,,10,Marzahn-Hellersdorf,2L,,2,85,,0,0,0,0,426,426,0,426,218,208
10B2M,,10,Marzahn-Hellersdorf,2M,,2,85,,0,0,0,0,343,343,1,342,183,159
10B3A,,10,Marzahn-Hellersdorf,3A,,3,85,,0,0,0,0,360,360,1,359,188,171
10B3B,,10,Marzahn-Hellersdorf,3B,,3,85,,0,0,0,0,306,306,3,303,186,117
10B3C,,10,Marzahn-Hellersdorf,3C,,3,85,,0,0,0,0,448,448,0,448,233,215
10B3D,,10,Marzahn-Hellersdorf,3D,,3,85,,0,0,0,0,390,390,3,387,216,171
10B3E,,10,Marzahn-Hellersdorf,3E,,3,85,,0,0,0,0,473,473,0,473,275,198
10B3F,,10,Marzahn-Hellersdorf,3F,,3,85,,0,0,0,0,482,482,2,480,260,220
10B3G,,10,Marzahn-Hellersdorf,3G,,3,85,,0,0,0,0,515,515,9,506,263,243
10B3H,,10,Marzahn-Hellersdorf,3H,,3,85,,0,0,0,0,556,556,2,554,310,244
10B4A,,10,Marzahn-Hellersdorf,4A,,4,85,,0,0,0,0,276,276,3,273,122,151
10B4B,,10,Marzahn-Hellersdorf,4B,,4,85,,0,0,0,0,576,576,9,567,300,267
10B4C,,10,Marzahn-Hellersdorf,4C,,4,85,,0,0,0,0,323,323,2,321,151,170
10B4D,,10,Marzahn-Hellersdorf,4D,,4,85,,0,0,0,0,513,513,7,506,223,283
10B4E,,10,Marzahn-Hellersdorf,4E,,4,85,,0,0,0,0,337,337,2,335,126,209
10B4F,,10,Marzahn-Hellersdorf,4F,,4,85,,0,0,0,0,406,406,2,404,167,237
10B4G,,10,Marzahn-Hellersdorf,4G,,4,85,,0,0,0,0,529,529,2,527,246,281
10B4H,,10,Marzahn-Hellersdorf,4H,,4,85,,0,0,0,0,448,448,0,448,190,258
10B4J,,10,Marzahn-Hellersdorf,4J,,4,85,,0,0,0,0,443,443,8,435,215,220
10B4K,,10,Marzahn-Hellersdorf,4K,,4,85,,0,0,0,0,574,574,10,564,288,276
10B4L,,10,Marzahn-Hellersdorf,4L,,4,85,,0,0,0,0,458,458,4,454,193,261
10B4M,,10,Marzahn-Hellersdorf,4M,,4,85,,0,0,0,0,441,441,4,437,191,246
10B4N,,10,Marzahn-Hellersdorf,4N,,4,85,,0,0,0,0,425,425,3,422,182,240
10B4P,,10,Marzahn-Hellersdorf,4P,,4,85,,0,0,0,0,537,537,1,536,260,276
10B5A,,10,Marzahn-Hellersdorf,5A,,5,85,,0,0,0,0,443,443,6,437,213,224
10B5B,,10,Marzahn-Hellersdorf,5B,,5,85,,0,0,0,0,480,480,2,478,204,274
10B5C,,10,Marzahn-Hellersdorf,5C,,5,85,,0,0,0,0,407,407,3,404,194,210
10B5D,,10,Marzahn-Hellersdorf,5D,,5,85,,0,0,0,0,453,453,0,453,191,262
10B5E,,10,Marzahn-Hellersdorf,5E,,5,85,,0,0,0,0,399,399,1,398,191,207
10B5F,,10,Marzahn-Hellersdorf,5F,,5,85,,0,0,0,0,410,410,7,403,179,224
10B5G,,10,Marzahn-Hellersdorf,5G,,5,85,,0,0,0,0,335,335,5,330,159,171
10B5H,,10,Marzahn-Hellersdorf,5H,,5,85,,0,0,0,0,333,333,0,333,157,176
10B5J,,10,Marzahn-Hellersdorf,5J,,5,85,,0,0,0,0,349,349,3,346,186,160
10B5K,,10,Marzahn-Hellersdorf,5K,,5,85,,0,0,0,0,399,399,1,398,182,216
10B5L,,10,Marzahn-Hellersdorf,5L,,5,85,,0,0,0,0,443,443,1,442,212,230
10B5M,,10,Marzahn-Hellersdorf,5M,,5,85,,0,0,0,0,319,319,2,317,135,182
10B5N,,10,Marzahn-Hellersdorf,5N,,5,85,,0,0,0,0,423,423,4,419,175,244
10B5P,,10,Marzahn-Hellersdorf,5P,,5,85,,0,0,0,0,516,516,5,511,279,232
10B5Q,,10,Marzahn-Hellersdorf,5Q,,5,85,,0,0,0,0,461,461,1,460,216,244
10B5R,,10,Marzahn-Hellersdorf,5R,,5,85,,0,0,0,0,425,425,3,422,186,236
10B5S,,10,Marzahn-Hellersdorf,5S,,5,85,,0,0,0,0,507,507,4,503,202,301
10B6A,,10,Marzahn-Hellersdorf,6A,,6,85,,0,0,0,0,360,360,5,355,204,151
10B6B,,10,Marzahn-Hellersdorf,6B,,6,85,,0,0,0,0,547,547,7,540,318,222
10B6C,,10,Marzahn-Hellersdorf,6C,,6,85,,0,0,0,0,320,320,5,315,153,162
10B6D,,10,Marzahn-Hellersdorf,6D,,6,85,,0,0,0,0,636,636,0,636,315,321
10B6E,,10,Marzahn-Hellersdorf,6E,,6,85,,0,0,0,0,405,405,2,403,199,204
10B6F,,10,Marzahn-Hellersdorf,6F,,6,85,,0,0,0,0,296,296,6,290,140,150
10B6G,,10,Marzahn-Hellersdorf,6G,,6,85,,0,0,0,0,655,655,6,649,307,342
10B6H,,10,Marzahn-Hellersdorf,6H,,6,85,,0,0,0,0,482,482,2,480,192,288
10B6J,,10,Marzahn-Hellersdorf,6J,,6,85,,0,0,0,0,420,420,6,414,231,183
10B6K,,10,Marzahn-Hellersdorf,6K,,6,85,,0,0,0,0,396,396,5,391,222,169
11B1A,,11,Lichtenberg,1A,,1,86,,0,0,0,0,394,394,2,392,136,256
11B1B,,11,Lichtenberg,1B,,1,86,,0,0,0,0,774,774,0,774,192,582
11B1C,,11,Lichtenberg,1C,,1,86,,0,0,0,0,474,474,2,472,181,291
11B1D,,11,Lichtenberg,1D,,1,86,,0,0,0,0,582,582,5,577,247,330
11B1E,,11,Lichtenberg,1E,,1,86,,0,0,0,0,538,538,2,536,239,297
11B1F,,11,Lichtenberg,1F,,1,86,,0,0,0,0,489,489,1,488,201,287
11B1G,,11,Lichtenberg,1G,,1,86,,0,0,0,0,473,473,2,471,220,251
11B1H,,11,Lichtenberg,1H,,1,86,,0,0,0,0,579,579,8,571,260,311
11B2A,,11,Lichtenberg,2A,,2,86,,0,0,0,0,514,514,1,513,165,348
11B2B,,11,Lichtenberg,2B,,2,86,,0,0,0,0,430,430,0,430,186,244
11B2C,,11,Lichtenberg,2C,,2,86,,0,0,0,0,323,323,0,323,152,171
11B2D,,11,Lichtenberg,2D,,2,86,,0,0,0,0,550,550,1,549,273,276
11B2E,,11,Lichtenberg,2E,,2,86,,0,0,0,0,761,761,5,756,230,526
11B2F,,11,Lichtenberg,2F,,2,86,,0,0,0,0,604,604,7,597,268,329
11B2G,,11,Lichtenberg,2G,,2,86,,0,0,0,0,696,696,6,690,274,416
11B2H,,11,Lichtenberg,2H,,2,86,,0,0,0,0,483,483,1,482,209,273
11B2I,,11,Lichtenberg,2I,,2,86,,0,0,0,0,369,369,4,365,184,181
11B2J,,11,Lichtenberg,2J,,2,86,,0,0,0,0,473,473,2,471,253,218
11B3A,,11,Lichtenberg,3A,,3,86,,0,0,0,0,536,536,22,514,294,220
11B3B,,11,Lichtenberg,3B,,3,86,,0,0,0,0,542,542,4,538,266,272
11B3C,,11,Lichtenberg,3C,,3,86,,0,0,0,0,382,382,1,381,203,178
11B3D,,11,Lichtenberg,3D,,3,86,,0,0,0,0,346,346,3,343,175,168
11B3E,,11,Lichtenberg,3E,,3,86,,0,0,0,0,462,462,1,461,231,230
11B3F,,11,Lichtenberg,3F,,3,86,,0,0,0,0,505,505,2,503,235,268
11B3G,,11,Lichtenberg,3G,,3,86,,0,0,0,0,511,511,6,505,236,269
11B3H,,11,Lichtenberg,3H,,3,86,,0,0,0,0,579,579,2,577,293,284
11B3I,,11,Lichtenberg,3I,,3,86,,0,0,0,0,478,478,0,478,249,229
11B3J,,11,Lichtenberg,3J,,3,86,,0,0,0,0,390,390,6,384,208,176
11B3K,,11,Lichtenberg,3K,,3,86,,0,0,0,0,520,520,1,519,250,269
11B4A,,11,Lichtenberg,4A,,4,86,,0,0,0,0,654,654,5,649,320,329
11B4B,,11,Lichtenberg,4B,,4,86,,0,0,0,0,606,606,0,606,265,341
11B4C,,11,Lichtenberg,4C,,4,86,,0,0,0,0,613,613,5,608,318,290
11B4D,,11,Lichtenberg,4D,,4,86,,0,0,0,0,722,722,7,715,354,361
11B4E,,11,Lichtenberg,4E,,4,86,,0,0,0,0,663,663,9,654,295,359
11B4F,,11,Lichtenberg,4F,,4,86,,0,0,0,0,712,712,9,703,370,333
11B4G,,11,Lichtenberg,4G,,4,86,,0,0,0,0,722,722,7,715,337,378
11B4H,,11,Lichtenberg,4H,,4,86,,0,0,0,0,670,670,6,664,342,322
11B4I,,11,Lichtenberg,4I,,4,86,,0,0,0,0,481,481,4,477,234,243
11B4J,,11,Lichtenberg,4J,,4,86,,0,0,0,0,517,517,5,512,244,268
11B5A,,11,Lichtenberg,5A,,5,86,,0,0,0,0,363,363,5,358,193,165
11B5B,,11,Lichtenberg,5B,,5,86,,0,0,0,0,390,390,2,388,207,181
11B5C,,11,Lichtenberg,5C,,5,86,,0,0,0,0,593,593,4,589,293,296
11B5D,,11,Lichtenberg,5D,,5,86,,0,0,0,0,458,458,4,454,231,223
11B5E,,11,Lichtenberg,5E,,5,86,,0,0,0,0,680,680,4,676,324,352
11B5F,,11,Lichtenberg,5F,,5,86,,0,0,0,0,598,598,3,595,321,274
11B5G,,11,Lichtenberg,5G,,5,86,,0,0,0,0,620,620,6,614,290,324
11B5H,,11,Lichtenberg,5H,,5,86,,0,0,0,0,662,662,6,656,313,343
11B5I,,11,Lichtenberg,5I,,5,86,,0,0,0,0,800,800,7,793,327,466
11B5J,,11,Lichtenberg,5J,,5,86,,0,0,0,0,666,666,4,662,324,338
11B6A,,11,Lichtenberg,6A,,6,86,,0,0,0,0,418,418,4,414,189,225
11B6B,,11,Lichtenberg,6B,,6,86,,0,0,0,0,446,446,4,442,176,266
11B6C,,11,Lichtenberg,6C,,6,86,,0,0,0,0,350,350,4,346,155,191
11B6D,,11,Lichtenberg,6D,,6,86,,0,0,0,0,518,518,4,514,213,301
11B6E,,11,Lichtenberg,6E,,6,86,,0,0,0,0,454,454,4,450,200,250
11B6F,,11,Lichtenberg,6F,,6,86,,0,0,0,0,350,350,5,345,165,180
11B6G,,11,Lichtenberg,6G,,6,86,,0,0,0,0,498,498,2,496,209,287
11B6H,,11,Lichtenberg,6H,,6,86,,0,0,0,0,505,505,5,500,267,233
11B6I,,11,Lichtenberg,6I,,6,86,,0,0,0,0,421,421,0,421,186,235
11B6J,,11,Lichtenberg,6J,,6,86,,0,0,0,0,498,498,4,494,204,290
11B6K,,11,Lichtenberg,6K,,6,86,,0,0,0,0,736,736,5,731,298,433
11B6L,,11,Lichtenberg,6L,,6,86,,0,0,0,0,407,407,4,403,163,240
11B6M,,11,Lichtenberg,6M,,6,86,,0,0,0,0,533,533,8,525,194,331
11B6N,,11,Lichtenberg,6N,,6,86,,0,0,0,0,753,753,8,745,281,464
12B1A,,12,Reinickendorf,1A,,1,77,,0,0,0,0,795,795,7,788,441,347
12B1B,,12,Reinickendorf,1B,,1,77,,0,0,0,0,907,907,5,902,480,422
12B1C,,12,Reinickendorf,1C,,1,77,,0,0,0,0,748,748,3,745,412,333
12B1D,,12,Reinickendorf,1D,,1,77,,0,0,0,0,800,800,3,797,398,399
12B1E,,12,Reinickendorf,1E,,1,77,,0,0,0,0,777,777,6,771,366,405
12B1F,,12,Reinickendorf,1F,,1,77,,0,0,0,0,848,848,0,848,461,387
12B2A,,12,Reinickendorf,2A,,2,77,,0,0,0,0,793,793,17,776,455,321
12B2B,,12,Reinickendorf,2B,,2,77,,0,0,0,0,693,693,2,691,316,375
12B2C,,12,Reinickendorf,2C,,2,77,,0,0,0,0,750,750,5,745,453,292
12B2D,,12,Reinickendorf,2D,,2,77,,0,0,0,0,667,667,2,665,345,320
12B2E,,12,Reinickendorf,2E,,2,77,,0,0,0,0,574,574,2,572,331,241
12B2F,,12,Reinickendorf,2F,,2,77,,0,0,0,0,697,697,0,697,370,327
12B2G,,12,Reinickendorf,2G,,2,77,,0,0,0,0,579,579,1,578,293,285
12B2H,,12,Reinickendorf,2H,,2,77,,0,0,0,0,798,798,0,798,426,372
12B3A,,12,Reinickendorf,3A,,3,77,,0,0,0,0,843,843,2,841,612,229
12B3B,,12,Reinickendorf,3B,,3,77,,0,0,0,0,718,718,5,713,487,226
12B3C,,12,Reinickendorf,3C,,3,77,,0,0,0,0,715,715,3,712,491,221
12B3D,,12,Reinickendorf,3D,,3,77,,0,0,0,0,1144,1144,0,1144,741,403
12B3E,,12,Reinickendorf,3E,,3,77,,0,0,0,0,696,696,6,690,405,285
12B3F,,12,Reinickendorf,3F,,3,77,,0,0,0,0,1084,1084,5,1079,675,404
12B3G,,12,Reinickendorf,3G,,3,77,,0,0,0,0,583,583,4,579,405,174
12B3H,,12,Reinickendorf,3H,,3,77,,0,0,0,0,587,587,1,586,398,188
12B3I,,12,Reinickendorf,3I,,3,77,,0,0,0,0,1090,1090,3,1087,555,532
12B4A,,12,Reinickendorf,4A,,4,77,,0,0,0,0,612,612,1,611,388,223
12B4B,,12,Reinickendorf,4B,,4,77,,0,0,0,0,829,829,4,825,583,242
12B4C,,12,Reinickendorf,4C,,4,77,,0,0,0,0,637,637,0,637,429,208
12B4D,,12,Reinickendorf,4D,,4,77,,0,0,0,0,798,798,5,793,565,228
12B4E,,12,Reinickendorf,4E,,4,77,,0,0,0,0,931,931,1,930,609,321
12B4F,,12,Reinickendorf,4F,,4,77,,0,0,0,0,863,863,6,857,536,321
12B4G,,12,Reinickendorf,4G,,4,77,,0,0,0,0,718,718,0,718,476,242
12B4H,,12,Reinickendorf,4H,,4,77,,0,0,0,0,953,953,3,950,609,341
12B4I,,12,Reinickendorf,4I,,4,77,,0,0,0,0,719,719,3,716,472,244
12B5A,,12,Reinickendorf,5A,,5,77,,0,0,0,0,760,760,6,754,548,206
12B5B,,12,Reinickendorf,5B,,5,77,,0,0,0,0,789,789,3,786,565,221
12B5C,,12,Reinickendorf,5C,,5,77,,0,0,0,0,772,772,4,768,606,162
12B5D,,12,Reinickendorf,5D,,5,77,,0,0,0,0,886,886,4,882,664,218
12B5E,,12,Reinickendorf,5E,,5,77,,0,0,0,0,698,698,2,696,524,172
12B6A,,12,Reinickendorf,6A,,6,77,,0,0,0,0,723,723,2,721,505,216
12B6B,,12,Reinickendorf,6B,,6,77,,0,0,0,0,929,929,5,924,666,258
12B6C,,12,Reinickendorf,6C,,6,77,,0,0,0,0,643,643,3,640,428,212
12B6D,,12,Reinickendorf,6D,,6,77,,0,0,0,0,759,759,2,757,567,190
12B6E,,12,Reinickendorf,6E,,6,77,,0,0,0,0,597,597,0,597,441,156
12B6F,,12,Reinickendorf,6F,,6,77,,0,0,0,0,779,779,7,772,526,246
12B6G,,12,Reinickendorf,6G,,6,77,,0,0,0,0,1025,1025,3,1022,751,271
12B6H,,12,Reinickendorf,6H,,6,77,,0,0,0,0,853,853,8,845,579,266
12B6I,,12,Reinickendorf,6I,,6,77,,0,0,0,0,931,931,2,929,642,287
12B6J,,12,Reinickendorf,6J,,6,77,,0,0,0,0,815,815,4,811,539,272
