address,vote_type,district_id,district_name,electoral_district_id,electoral_district_type,electoral_district_berlin_election_id,electoral_district_federal_election_id,berlin_east_west,eligible_voters,eligible_voters_a1,eligible_voters_a2,eligible_voters_a3,voters,voters_b1,invalid_votes,valid_votes,vote_yes,vote_no
01W100,nan,01,Mitte,100,W,1,75,W,1269,1037,232,0,572,5,13,559,358,201
01W101,nan,01,Mitte,101,W,1,75,O,1490,975,515,0,757,14,3,754,413,341
01W102,nan,01,Mitte,102,W,1,75,O,1306,813,493,0,603,5,10,593,357,236
01W103,nan,01,Mitte,103,W,1,75,O,1555,980,575,0,772,0,13,759,466,293
01W104,nan,01,Mitte,104,W,1,75,O,1241,768,473,0,611,17,16,595,336,259
01W105,nan,01,Mitte,105,W,1,75,O,1049,689,360,0,509,6,15,494,273,221
01W106,nan,01,Mitte,106,W,1,75,O,1407,826,581,0,662,15,8,654,408,246
01W107,nan,01,Mitte,107,W,1,75,O,1111,763,348,0,612,0,8,604,341,263
01W108,nan,01,Mitte,108,W,1,75,O,1004,628,376,0,483,8,7,476,270,206
01W109,nan,01,Mitte,109,W,1,75,W,1133,900,233,0,536,4,16,520,352,168
01W110,nan,01,Mitte,110,W,1,75,O,1552,999,553,0,841,14,13,828,424,404
01W111,nan,01,Mitte,111,W,1,75,O,1010,665,345,0,549,14,6,543,300,243
01W112,nan,01,Mitte,112,W,1,75,O,1194,790,404,0,599,15,16,583,299,284
01W113,nan,01,Mitte,113,W,1,75,O,1172,785,387,0,673,20,19,654,320,334
01W114,nan,01,Mitte,114,W,1,75,O,1447,952,495,0,740,21,18,722,400,322
01W115,nan,01,Mitte,115,W,1,75,O,866,638,228,0,481,7,6,475,293,182
01W116,nan,01,Mitte,116,W,1,75,O,697,452,245,0,378,9,10,368,214,154
01W117,nan,01,Mitte,117,W,1,75,O,1486,1038,448,0,861,12,22,839,415,424
01W118,nan,01,Mitte,118,W,1,75,O,1148,797,351,0,664,0,20,644,316,328
01W119,nan,01,Mitte,119,W,1,75,O,877,603,274,0,506,12,7,499,211,288
01W120,nan,01,Mitte,120,W,1,75,O,1066,679,387,0,544,17,13,531,262,269
01W121,nan,01,Mitte,121,W,1,75,O,1089,683,406,0,554,0,16,538,286,252
01W122,nan,01,Mitte,122,W,1,75,O,1204,787,417,0,643,25,13,630,313,317
01W123,nan,01,Mitte,123,W,1,75,O,1006,693,313,0,520,14,13,507,261,246
01W200,nan,01,Mitte,200,W,2,75,O,896,642,254,0,448,3,9,439,265,174
01W201,nan,01,Mitte,201,W,2,75,O,1114,748,366,0,532,12,3,529,357,172
01W202,nan,01,Mitte,202,W,2,75,O,1131,695,436,0,470,8,8,462,289,173
01W203,nan,01,Mitte,203,W,2,75,O,1071,634,437,0,392,5,8,384,210,174
01W204,nan,01,Mitte,204,W,2,75,O,1931,1184,747,0,832,12,12,820,514,306
01W205,nan,01,Mitte,205,W,2,75,O,1222,859,363,0,563,5,11,552,297,255
01W206,nan,01,Mitte,206,W,2,75,O,1355,886,469,0,561,6,23,538,298,240
01W207,nan,01,Mitte,207,W,2,75,O,1138,727,411,0,531,5,19,512,263,249
01W208,nan,01,Mitte,208,W,2,75,O,894,545,349,0,432,11,8,424,222,202
01W209,nan,01,Mitte,209,W,2,75,O,1235,854,381,0,640,9,21,619,316,303
01W210,nan,01,Mitte,210,W,2,75,O,1135,764,371,0,585,6,16,569,303,266
01W211,nan,01,Mitte,211,W,2,75,O,880,656,224,0,465,3,13,452,226,226
01W212,nan,01,Mitte,212,W,2,75,O,866,594,272,0,480,14,19,461,266,195
01W213,nan,01,Mitte,213,W,2,75,O,640,446,194,0,295,8,8,287,168,119
01W214,nan,01,Mitte,214,W,2,75,O,830,540,290,0,354,4,8,346,168,178
01W215,nan,01,Mitte,215,W,2,75,O,1016,685,331,0,526,1,5,521,268,253
01W216,nan,01,Mitte,216,W,2,75,O,945,646,299,0,491,3,15,476,237,239
01W217,nan,01,Mitte,217,W,2,75,O,1072,773,299,0,449,3,11,438,224,214
01W218,nan,01,Mitte,218,W,2,75,O,1525,1140,385,0,801,14,24,777,403,374
01W219,nan,01,Mitte,219,W,2,75,O,342,273,69,0,172,0,8,164,99,65
01W220,nan,01,Mitte,220,W,2,75,O,785,535,250,0,345,5,12,333,163,170
01W221,nan,01,Mitte,221,W,2,75,O,1491,991,500,0,717,0,17,700,384,316
01W222,nan,01,Mitte,222,W,2,75,O,903,632,271,0,425,5,5,420,214,206
01W223,nan,01,Mitte,223,W,2,75,O,1499,977,522,0,771,10,16,755,327,428
01W224,nan,01,Mitte,224,W,2,75,O,837,586,251,0,402,3,17,385,201,184
01W225,nan,01,Mitte,225,W,2,75,O,1367,928,439,0,677,1,16,661,327,334
01W226,nan,01,Mitte,226,W,2,75,O,758,590,168,0,393,7,18,375,173,202
01W227,nan,01,Mitte,227,W,2,75,O,1362,953,409,0,711,7,10,701,292,409
01W228,nan,01,Mitte,228,W,2,75,O,2280,1500,780,0,1095,12,21,1074,534,540
01W300,nan,01,Mitte,300,W,3,75,W,1302,997,305,0,608,7,12,596,373,223
01W301,nan,01,Mitte,301,W,3,75,W,871,624,247,0,438,0,7,431,241,190
01W302,nan,01,Mitte,302,W,3,75,W,1187,904,283,0,577,5,11,566,364,202
01W303,nan,01,Mitte,303,W,3,75,W,888,696,192,0,427,6,17,410,275,135
01W304,nan,01,Mitte,304,W,3,75,W,942,688,254,0,527,8,5,522,305,217
01W305,nan,01,Mitte,305,W,3,75,W,1043,723,320,0,558,1,17,541,320,221
01W306,nan,01,Mitte,306,W,3,75,W,1356,918,438,0,707,9,9,698,378,320
01W307,nan,01,Mitte,307,W,3,75,W,1137,823,314,0,657,3,19,638,383,255
01W308,nan,01,Mitte,308,W,3,75,W,1145,809,336,0,629,6,8,621,339,282
01W309,nan,01,Mitte,309,W,3,75,W,1268,885,383,0,731,14,17,714,399,315
01W310,nan,01,Mitte,310,W,3,75,W,900,616,284,0,487,4,10,477,285,192
01W311,nan,01,Mitte,311,W,3,75,W,1037,637,400,0,478,6,11,467,272,195
01W312,nan,01,Mitte,312,W,3,75,W,783,494,289,0,380,7,8,372,220,152
01W313,nan,01,Mitte,313,W,3,75,W,825,568,257,0,407,7,6,401,245,156
01W314,nan,01,Mitte,314,W,3,75,W,1085,803,282,0,559,4,11,548,358,190
01W315,nan,01,Mitte,315,W,3,75,W,831,605,226,0,386,5,10,376,233,143
01W316,nan,01,Mitte,316,W,3,75,W,1215,979,236,0,634,6,12,622,448,174
01W317,nan,01,Mitte,317,W,3,75,W,745,563,182,0,387,0,2,385,225,160
01W318,nan,01,Mitte,318,W,3,75,W,1116,724,392,0,545,6,12,533,340,193
01W319,nan,01,Mitte,319,W,3,75,W,998,630,368,0,471,3,6,465,293,172
01W320,nan,01,Mitte,320,W,3,75,W,591,385,206,0,322,4,7,315,168,147
01W321,nan,01,Mitte,321,W,3,75,W,997,667,330,0,465,3,10,455,300,155
01W322,nan,01,Mitte,322,W,3,75,W,1127,771,356,0,487,3,6,481,354,127
01W323,nan,01,Mitte,323,W,3,75,W,1153,806,347,0,597,6,17,580,371,209
01W324,nan,01,Mitte,324,W,3,75,W,1583,1043,540,0,630,0,13,617,423,194
01W325,nan,01,Mitte,325,W,3,75,W,998,763,235,0,403,0,13,390,251,139
01W326,nan,01,Mitte,326,W,3,75,W,1174,840,334,0,593,3,10,583,342,241
01W327,nan,01,Mitte,327,W,3,75,W,1471,1050,421,0,691,14,11,680,357,323
01W400,nan,01,Mitte,400,W,4,75,W,1351,1031,320,0,629,6,14,615,404,211
01W401,nan,01,Mitte,401,W,4,75,W,924,736,188,0,456,5,6,450,278,172
01W402,nan,01,Mitte,402,W,4,75,W,1308,1082,226,0,617,2,14,603,399,204
01W403,nan,01,Mitte,403,W,4,75,W,1010,744,266,0,506,8,18,488,259,229
01W404,nan,01,Mitte,404,W,4,75,W,704,545,159,0,350,4,10,340,208,132
01W405,nan,01,Mitte,405,W,4,75,W,790,622,168,0,407,0,8,399,257,142
01W406,nan,01,Mitte,406,W,4,75,W,847,639,208,0,449,9,22,427,231,196
01W407,nan,01,Mitte,407,W,4,75,W,1191,902,289,0,642,11,11,631,393,238
01W408,nan,01,Mitte,408,W,4,75,W,995,728,267,0,543,7,16,527,273,254
01W409,nan,01,Mitte,409,W,4,75,W,960,696,264,0,494,2,8,486,303,183
01W410,nan,01,Mitte,410,W,4,75,W,1274,929,345,0,686,8,11,675,394,281
01W411,nan,01,Mitte,411,W,4,75,W,1076,799,277,0,522,0,5,517,333,184
01W412,nan,01,Mitte,412,W,4,75,W,894,646,248,0,460,0,17,443,252,191
01W413,nan,01,Mitte,413,W,4,75,W,863,653,210,0,444,5,10,434,263,171
01W414,nan,01,Mitte,414,W,4,75,W,838,641,197,0,420,5,2,418,231,187
01W415,nan,01,Mitte,415,W,4,75,W,861,603,258,0,464,0,13,451,245,206
01W416,nan,01,Mitte,416,W,4,75,W,1075,810,265,0,550,6,16,534,339,195
01W417,nan,01,Mitte,417,W,4,75,W,1168,879,289,0,540,5,8,532,310,222
01W418,nan,01,Mitte,418,W,4,75,W,1119,851,268,0,501,6,7,494,321,173
01W419,nan,01,Mitte,419,W,4,75,W,1268,950,318,0,672,9,11,661,382,279
01W420,nan,01,Mitte,420,W,4,75,W,983,733,250,0,541,11,13,528,305,223
01W421,nan,01,Mitte,421,W,4,75,W,813,638,175,0,434,2,5,429,271,158
01W422,nan,01,Mitte,422,W,4,75,W,1008,710,298,0,447,8,9,438,238,200
01W423,nan,01,Mitte,423,W,4,75,W,876,690,186,0,413,4,12,401,245,156
01W424,nan,01,Mitte,424,W,4,75,W,1229,923,306,0,627,6,17,610,337,273
01W425,nan,01,Mitte,425,W,4,75,W,1316,973,343,0,685,10,11,674,335,339
01W426,nan,01,Mitte,426,W,4,75,W,1268,906,362,0,596,6,13,583,313,270
01W427,nan,01,Mitte,427,W,4,75,W,866,621,245,0,400,0,4,396,207,189
01W428,nan,01,Mitte,428,W,4,75,W,819,559,260,0,360,0,9,351,205,146
01W500,nan,01,Mitte,500,W,5,75,W,1017,717,300,0,464,3,6,458,281,177
01W501,nan,01,Mitte,501,W,5,75,W,834,632,202,0,417,2,7,410,218,192
01W502,nan,01,Mitte,502,W,5,75,W,547,438,109,0,232,0,3,229,128,101
01W503,nan,01,Mitte,503,W,5,75,W,1064,814,250,0,558,0,5,553,199,354
01W504,nan,01,Mitte,504,W,5,75,W,667,535,132,0,308,1,4,304,204,100
01W505,nan,01,Mitte,505,W,5,75,W,956,763,193,0,434,0,5,429,251,178
01W506,nan,01,Mitte,506,W,5,75,W,983,710,273,0,496,1,3,493,226,267
01W507,nan,01,Mitte,507,W,5,75,W,1480,1094,386,0,748,6,8,740,324,416
01W508,nan,01,Mitte,508,W,5,75,W,1211,858,353,0,654,2,3,651,315,336
01W509,nan,01,Mitte,509,W,5,75,W,1125,911,214,0,534,0,4,530,299,231
01W510,nan,01,Mitte,510,W,5,75,W,1057,869,188,0,544,0,10,534,312,222
01W511,nan,01,Mitte,511,W,5,75,W,1118,894,224,0,495,1,6,489,289,200
01W512,nan,01,Mitte,512,W,5,75,W,1027,834,193,0,399,1,9,390,235,155
01W513,nan,01,Mitte,513,W,5,75,W,1357,1073,284,0,698,6,8,690,346,344
01W514,nan,01,Mitte,514,W,5,75,W,1035,813,222,0,487,4,10,477,270,207
01W515,nan,01,Mitte,515,W,5,75,W,1324,1078,246,0,676,7,10,666,386,280
01W516,nan,01,Mitte,516,W,5,75,W,985,777,208,0,457,1,5,452,272,180
01W517,nan,01,Mitte,517,W,5,75,W,1364,1056,308,0,592,4,7,585,305,280
01W518,nan,01,Mitte,518,W,5,75,W,1292,1030,262,0,562,3,6,556,316,240
01W519,nan,01,Mitte,519,W,5,75,W,1314,1009,305,0,674,8,26,648,333,315
01W520,nan,01,Mitte,520,W,5,75,W,1371,1031,340,0,672,3,11,661,329,332
01W521,nan,01,Mitte,521,W,5,75,W,1287,1043,244,0,475,1,6,469,301,168
01W522,nan,01,Mitte,522,W,5,75,W,889,619,270,0,423,1,0,423,207,216
01W523,nan,01,Mitte,523,W,5,75,W,649,492,157,0,369,0,5,364,214,150
01W524,nan,01,Mitte,524,W,5,75,W,853,606,247,0,409,0,12,397,218,179
01W525,nan,01,Mitte,525,W,5,75,W,859,654,205,0,432,5,12,420,201,219
01W526,nan,01,Mitte,526,W,5,75,W,1481,1046,435,0,703,7,10,693,342,351
01W600,nan,01,Mitte,600,W,6,75,W,1457,1146,311,0,619,7,12,607,288,319
01W601,nan,01,Mitte,601,W,6,75,W,792,633,159,0,420,2,10,410,191,219
01W602,nan,01,Mitte,602,W,6,75,W,1040,807,233,0,577,2,1,576,203,373
01W603,nan,01,Mitte,603,W,6,75,W,907,729,178,0,432,4,7,425,191,234
01W604,nan,01,Mitte,604,W,6,75,W,849,703,146,0,353,0,4,349,196,153
01W605,nan,01,Mitte,605,W,6,75,W,1090,860,230,0,497,0,9,488,249,239
01W606,nan,01,Mitte,606,W,6,75,W,835,648,187,0,405,1,13,392,174,218
01W607,nan,01,Mitte,607,W,6,75,W,861,686,175,0,304,3,9,295,131,164
01W608,nan,01,Mitte,608,W,6,75,W,1017,809,208,0,431,6,16,415,189,226
01W609,nan,01,Mitte,609,W,6,75,W,1094,908,186,0,552,2,6,546,264,282
01W610,nan,01,Mitte,610,W,6,75,W,1122,954,168,0,524,9,5,519,266,253
01W611,nan,01,Mitte,611,W,6,75,W,1363,1099,264,0,664,6,9,655,356,299
01W612,nan,01,Mitte,612,W,6,75,W,975,796,179,0,441,4,4,437,218,219
01W613,nan,01,Mitte,613,W,6,75,W,1435,1106,329,0,687,0,12,675,343,332
01W614,nan,01,Mitte,614,W,6,75,W,1180,887,293,0,615,7,12,603,330,273
01W615,nan,01,Mitte,615,W,6,75,W,896,737,159,0,389,0,6,383,212,171
01W616,nan,01,Mitte,616,W,6,75,W,1123,843,280,0,537,4,7,530,228,302
01W617,nan,01,Mitte,617,W,6,75,W,1031,804,227,0,493,5,18,475,262,213
01W618,nan,01,Mitte,618,W,6,75,W,1402,1128,274,0,646,5,18,628,323,305
01W619,nan,01,Mitte,619,W,6,75,W,1221,945,276,0,611,6,20,591,305,286
01W620,nan,01,Mitte,620,W,6,75,W,976,782,194,0,445,1,9,436,256,180
01W621,nan,01,Mitte,621,W,6,75,W,980,851,129,0,419,5,18,401,252,149
01W622,nan,01,Mitte,622,W,6,75,W,662,540,122,0,263,0,8,255,146,109
01W623,nan,01,Mitte,623,W,6,75,W,901,676,225,0,353,3,6,347,164,183
01W624,nan,01,Mitte,624,W,6,75,W,1248,1017,231,0,501,5,23,478,273,205
01W625,nan,01,Mitte,625,W,6,75,W,1017,847,170,0,488,3,12,476,295,181
01W700,nan,01,Mitte,700,W,7,75,W,804,636,168,0,355,0,4,351,233,118
01W701,nan,01,Mitte,701,W,7,75,W,1306,904,402,0,611,5,20,591,267,324
01W702,nan,01,Mitte,702,W,7,75,W,1076,838,238,0,481,5,13,468,281,187
01W703,nan,01,Mitte,703,W,7,75,W,841,661,180,0,406,3,10,396,234,162
01W704,nan,01,Mitte,704,W,7,75,W,849,620,229,0,381,1,11,370,192,178
01W705,nan,01,Mitte,705,W,7,75,W,968,686,282,0,484,7,14,470,221,249
01W706,nan,01,Mitte,706,W,7,75,W,1203,855,348,0,578,10,9,569,283,286
01W707,nan,01,Mitte,707,W,7,75,W,1209,890,319,0,650,7,16,634,340,294
01W708,nan,01,Mitte,708,W,7,75,W,1141,874,267,0,554,2,5,549,303,246
01W709,nan,01,Mitte,709,W,7,75,W,1087,829,258,0,533,5,12,521,272,249
01W710,nan,01,Mitte,710,W,7,75,W,1300,1005,295,0,587,1,15,572,346,226
01W711,nan,01,Mitte,711,W,7,75,W,1056,800,256,0,529,6,9,520,298,222
01W712,nan,01,Mitte,712,W,7,75,W,1255,1010,245,0,576,0,10,566,330,236
01W713,nan,01,Mitte,713,W,7,75,W,919,698,221,0,372,4,5,367,237,130
01W714,nan,01,Mitte,714,W,7,75,W,1091,892,199,0,480,4,14,466,273,193
01W715,nan,01,Mitte,715,W,7,75,W,1182,995,187,0,569,6,11,558,374,184
01W716,nan,01,Mitte,716,W,7,75,W,913,755,158,0,446,0,9,437,299,138
01W717,nan,01,Mitte,717,W,7,75,W,1127,932,195,0,534,4,8,526,356,170
01W718,nan,01,Mitte,718,W,7,75,W,844,758,86,0,366,1,11,355,223,132
01W719,nan,01,Mitte,719,W,7,75,W,985,875,110,0,456,3,19,437,307,130
01W720,nan,01,Mitte,720,W,7,75,W,1198,949,249,0,595,6,18,577,349,228
01W721,nan,01,Mitte,721,W,7,75,W,1116,964,152,0,500,1,16,484,339,145
01W722,nan,01,Mitte,722,W,7,75,W,1023,845,178,0,530,0,17,513,308,205
01W723,nan,01,Mitte,723,W,7,75,W,1044,828,216,0,537,2,6,531,307,224
01W724,nan,01,Mitte,724,W,7,75,W,895,752,143,0,451,0,10,441,292,149
01W725,nan,01,Mitte,725,W,7,75,W,1029,857,172,0,473,7,12,461,322,139
02W101,nan,02,Friedrichshain-Kreuzberg,101,W,1,83,W,1095,681,414,0,504,8,12,492,260,232
02W102,nan,02,Friedrichshain-Kreuzberg,102,W,1,83,W,1760,1162,598,0,918,13,24,894,406,488
02W103,nan,02,Friedrichshain-Kreuzberg,103,W,1,83,W,1704,1115,589,0,864,16,33,831,380,451
02W104,nan,02,Friedrichshain-Kreuzberg,104,W,1,83,W,1533,1039,494,0,821,13,24,797,400,397
02W105,nan,02,Friedrichshain-Kreuzberg,105,W,1,83,W,1743,1176,567,0,859,12,22,837,478,359
02W106,nan,02,Friedrichshain-Kreuzberg,106,W,1,83,W,1851,1267,584,0,973,11,33,940,452,488
02W107,nan,02,Friedrichshain-Kreuzberg,107,W,1,83,W,1500,1026,474,0,697,8,19,678,323,355
02W108,nan,02,Friedrichshain-Kreuzberg,108,W,1,83,W,1814,1236,578,0,938,17,18,920,444,476
02W109,nan,02,Friedrichshain-Kreuzberg,109,W,1,83,W,1502,1064,438,0,812,12,26,786,333,453
02W110,nan,02,Friedrichshain-Kreuzberg,110,W,1,83,W,1414,972,442,0,735,12,24,711,308,403
02W111,nan,02,Friedrichshain-Kreuzberg,111,W,1,83,W,1597,1110,487,0,835,8,26,809,333,476
02W112,nan,02,Friedrichshain-Kreuzberg,112,W,1,83,W,1748,1255,493,0,906,13,5,901,383,518
02W113,nan,02,Friedrichshain-Kreuzberg,113,W,1,83,W,1518,974,544,0,805,10,33,772,290,482
02W114,nan,02,Friedrichshain-Kreuzberg,114,W,1,83,W,1152,774,378,0,631,9,15,616,230,386
02W115,nan,02,Friedrichshain-Kreuzberg,115,W,1,83,W,1329,895,434,0,697,4,4,693,293,400
02W116,nan,02,Friedrichshain-Kreuzberg,116,W,1,83,W,1678,1147,531,0,889,13,36,853,361,492
02W117,nan,02,Friedrichshain-Kreuzberg,117,W,1,83,W,1534,1216,318,0,761,7,19,742,366,376
02W118,nan,02,Friedrichshain-Kreuzberg,118,W,1,83,W,1453,1054,399,0,696,14,33,663,257,406
02W119,nan,02,Friedrichshain-Kreuzberg,119,W,1,83,W,1579,1094,485,0,837,13,36,801,305,496
02W120,nan,02,Friedrichshain-Kreuzberg,120,W,1,83,W,1798,1285,513,0,920,21,31,889,387,502
02W121,nan,02,Friedrichshain-Kreuzberg,121,W,1,83,W,1618,1085,533,0,879,14,25,854,323,531
02W122,nan,02,Friedrichshain-Kreuzberg,122,W,1,83,W,1426,1136,290,0,696,8,23,673,301,372
02W201,nan,02,Friedrichshain-Kreuzberg,201,W,2,83,W,1059,699,360,0,565,15,18,547,190,357
02W202,nan,02,Friedrichshain-Kreuzberg,202,W,2,83,W,1351,1162,189,0,613,4,19,594,333,261
02W203,nan,02,Friedrichshain-Kreuzberg,203,W,2,83,W,1150,853,297,0,579,3,14,565,268,297
02W204,nan,02,Friedrichshain-Kreuzberg,204,W,2,83,W,869,652,217,0,476,8,14,462,202,260
02W205,nan,02,Friedrichshain-Kreuzberg,205,W,2,83,W,1356,954,402,0,738,11,14,724,270,454
02W206,nan,02,Friedrichshain-Kreuzberg,206,W,2,83,W,1374,972,402,0,686,26,30,656,256,400
02W207,nan,02,Friedrichshain-Kreuzberg,207,W,2,83,W,1319,969,350,0,710,5,22,688,252,436
02W208,nan,02,Friedrichshain-Kreuzberg,208,W,2,83,W,1084,760,324,0,595,13,19,576,263,313
02W209,nan,02,Friedrichshain-Kreuzberg,209,W,2,83,W,1171,905,266,0,595,10,33,562,256,306
02W210,nan,02,Friedrichshain-Kreuzberg,210,W,2,83,W,1166,820,346,0,573,10,32,541,199,342
02W211,nan,02,Friedrichshain-Kreuzberg,211,W,2,83,W,1126,847,279,0,588,11,20,568,223,345
02W212,nan,02,Friedrichshain-Kreuzberg,212,W,2,83,W,1207,884,323,0,722,14,23,699,234,465
02W213,nan,02,Friedrichshain-Kreuzberg,213,W,2,83,W,1053,801,252,0,567,9,21,546,254,292
02W214,nan,02,Friedrichshain-Kreuzberg,214,W,2,83,W,1427,1064,363,0,815,13,24,791,321,470
02W215,nan,02,Friedrichshain-Kreuzberg,215,W,2,83,O,1702,1179,523,0,924,12,24,900,387,513
02W216,nan,02,Friedrichshain-Kreuzberg,216,W,2,83,O,1302,867,435,0,680,8,38,642,274,368
02W217,nan,02,Friedrichshain-Kreuzberg,217,W,2,83,O,1660,1111,549,0,938,10,29,909,349,560
02W218,nan,02,Friedrichshain-Kreuzberg,218,W,2,83,O,1711,1174,537,0,901,6,37,864,364,500
02W219,nan,02,Friedrichshain-Kreuzberg,219,W,2,83,O,974,671,303,0,517,6,20,497,195,302
02W220,nan,02,Friedrichshain-Kreuzberg,220,W,2,83,O,1497,1066,431,0,832,7,23,809,338,471
02W221,nan,02,Friedrichshain-Kreuzberg,221,W,2,83,O,1438,1014,424,0,760,5,30,730,330,400
02W222,nan,02,Friedrichshain-Kreuzberg,222,W,2,83,O,1350,884,466,0,724,8,17,707,279,428
02W223,nan,02,Friedrichshain-Kreuzberg,223,W,2,83,O,1697,1266,431,0,868,8,19,849,462,387
02W224,nan,02,Friedrichshain-Kreuzberg,224,W,2,83,O,1423,1042,381,0,775,8,20,755,331,424
02W225,nan,02,Friedrichshain-Kreuzberg,225,W,2,83,O,1445,1018,427,0,768,10,24,744,308,436
02W226,nan,02,Friedrichshain-Kreuzberg,226,W,2,83,O,1474,1042,432,0,887,17,15,872,404,468
02W301,nan,02,Friedrichshain-Kreuzberg,301,W,3,83,W,1199,991,208,0,603,3,10,593,360,233
02W302,nan,02,Friedrichshain-Kreuzberg,302,W,3,83,W,1577,1299,278,0,724,5,37,687,437,250
02W303,nan,02,Friedrichshain-Kreuzberg,303,W,3,83,W,557,478,79,0,251,2,6,245,155,90
02W304,nan,02,Friedrichshain-Kreuzberg,304,W,3,83,W,1378,1093,285,0,654,8,21,633,334,299
02W305,nan,02,Friedrichshain-Kreuzberg,305,W,3,83,W,1294,1106,188,0,607,3,10,597,387,210
02W306,nan,02,Friedrichshain-Kreuzberg,306,W,3,83,W,1380,1107,273,0,665,6,6,659,434,225
02W307,nan,02,Friedrichshain-Kreuzberg,307,W,3,83,W,1557,1261,296,0,739,3,22,717,420,297
02W308,nan,02,Friedrichshain-Kreuzberg,308,W,3,83,W,1048,868,180,0,461,9,12,449,264,185
02W309,nan,02,Friedrichshain-Kreuzberg,309,W,3,83,W,1302,1095,207,0,641,5,15,626,414,212
02W310,nan,02,Friedrichshain-Kreuzberg,310,W,3,83,W,1282,911,371,0,663,6,21,642,344,298
02W311,nan,02,Friedrichshain-Kreuzberg,311,W,3,83,W,1208,850,358,0,643,10,23,620,242,378
02W312,nan,02,Friedrichshain-Kreuzberg,312,W,3,83,W,1647,1197,450,0,863,18,29,834,347,487
02W313,nan,02,Friedrichshain-Kreuzberg,313,W,3,83,W,1247,1037,210,0,556,3,13,543,378,165
02W314,nan,02,Friedrichshain-Kreuzberg,314,W,3,83,W,1467,1228,239,0,588,6,6,582,387,195
02W315,nan,02,Friedrichshain-Kreuzberg,315,W,3,83,W,1458,1153,305,0,623,6,15,608,309,299
02W316,nan,02,Friedrichshain-Kreuzberg,316,W,3,83,W,1220,1089,131,0,520,5,16,504,319,185
02W317,nan,02,Friedrichshain-Kreuzberg,317,W,3,83,W,903,729,174,0,382,4,13,369,218,151
02W318,nan,02,Friedrichshain-Kreuzberg,318,W,3,83,W,1190,956,234,0,590,10,27,563,282,281
02W319,nan,02,Friedrichshain-Kreuzberg,319,W,3,83,W,1251,960,291,0,664,7,22,642,243,399
02W320,nan,02,Friedrichshain-Kreuzberg,320,W,3,83,W,1559,1186,373,0,829,16,31,798,351,447
02W321,nan,02,Friedrichshain-Kreuzberg,321,W,3,83,W,1460,1184,276,0,652,9,31,621,286,335
02W322,nan,02,Friedrichshain-Kreuzberg,322,W,3,83,W,1362,983,379,0,736,9,24,712,289,423
02W323,nan,02,Friedrichshain-Kreuzberg,323,W,3,83,W,1351,955,396,0,696,9,29,667,271,396
02W324,nan,02,Friedrichshain-Kreuzberg,324,W,3,83,W,1258,946,312,0,624,8,25,599,306,293
02W325,nan,02,Friedrichshain-Kreuzberg,325,W,3,83,W,1023,782,241,0,521,6,22,499,197,302
02W401,nan,02,Friedrichshain-Kreuzberg,401,W,4,83,O,1181,810,371,0,591,8,12,579,292,287
02W402,nan,02,Friedrichshain-Kreuzberg,402,W,4,83,O,1118,858,260,0,522,2,12,510,257,253
02W403,nan,02,Friedrichshain-Kreuzberg,403,W,4,83,O,1320,966,354,0,681,1,18,663,343,320
02W404,nan,02,Friedrichshain-Kreuzberg,404,W,4,83,O,1544,1158,386,0,739,7,20,719,356,363
02W405,nan,02,Friedrichshain-Kreuzberg,405,W,4,83,O,1435,1063,372,0,745,3,23,722,360,362
02W406,nan,02,Friedrichshain-Kreuzberg,406,W,4,83,O,831,563,268,0,426,6,13,413,211,202
02W407,nan,02,Friedrichshain-Kreuzberg,407,W,4,83,O,959,621,338,0,563,13,11,552,243,309
02W408,nan,02,Friedrichshain-Kreuzberg,408,W,4,83,O,1362,929,433,0,696,6,22,674,330,344
02W409,nan,02,Friedrichshain-Kreuzberg,409,W,4,83,O,1018,748,270,0,528,12,10,518,252,266
02W410,nan,02,Friedrichshain-Kreuzberg,410,W,4,83,O,1312,985,327,0,752,6,31,721,332,389
02W411,nan,02,Friedrichshain-Kreuzberg,411,W,4,83,O,1355,966,389,0,777,4,21,756,319,437
02W412,nan,02,Friedrichshain-Kreuzberg,412,W,4,83,O,1358,1005,353,0,678,9,26,652,313,339
02W413,nan,02,Friedrichshain-Kreuzberg,413,W,4,83,O,1599,1111,488,0,853,7,17,836,351,485
02W414,nan,02,Friedrichshain-Kreuzberg,414,W,4,83,O,1425,968,457,0,703,11,21,682,296,386
02W415,nan,02,Friedrichshain-Kreuzberg,415,W,4,83,O,1851,1252,599,0,911,6,13,898,438,460
02W416,nan,02,Friedrichshain-Kreuzberg,416,W,4,83,O,1483,1025,458,0,653,5,12,641,314,327
02W417,nan,02,Friedrichshain-Kreuzberg,417,W,4,83,O,1699,1220,479,0,815,5,21,794,378,416
02W418,nan,02,Friedrichshain-Kreuzberg,418,W,4,83,O,1140,818,322,0,582,2,17,565,278,287
02W419,nan,02,Friedrichshain-Kreuzberg,419,W,4,83,O,1653,1218,434,1,910,12,17,893,422,471
02W420,nan,02,Friedrichshain-Kreuzberg,420,W,4,83,O,1401,965,436,0,786,8,11,775,361,414
02W421,nan,02,Friedrichshain-Kreuzberg,421,W,4,83,O,1251,805,446,0,667,10,22,645,251,394
02W422,nan,02,Friedrichshain-Kreuzberg,422,W,4,83,O,1456,1049,407,0,822,9,30,792,328,464
02W423,nan,02,Friedrichshain-Kreuzberg,423,W,4,83,O,948,677,271,0,448,6,8,440,223,217
02W424,nan,02,Friedrichshain-Kreuzberg,424,W,4,83,O,1221,892,329,0,555,6,21,534,272,262
02W425,nan,02,Friedrichshain-Kreuzberg,425,W,4,83,O,1652,1263,389,0,859,7,15,844,440,404
02W426,nan,02,Friedrichshain-Kreuzberg,426,W,4,83,O,872,678,194,0,441,3,16,425,241,184
02W501,nan,02,Friedrichshain-Kreuzberg,501,W,5,83,O,1621,1162,459,0,862,7,28,834,376,458
02W502,nan,02,Friedrichshain-Kreuzberg,502,W,5,83,O,1776,1266,510,0,972,0,25,947,444,503
02W503,nan,02,Friedrichshain-Kreuzberg,503,W,5,83,O,966,708,258,0,565,2,16,549,239,310
02W504,nan,02,Friedrichshain-Kreuzberg,504,W,5,83,O,1512,1051,461,0,779,7,24,755,344,411
02W505,nan,02,Friedrichshain-Kreuzberg,505,W,5,83,O,1656,1167,489,0,836,6,26,810,344,466
02W506,nan,02,Friedrichshain-Kreuzberg,506,W,5,83,O,1838,1248,590,0,933,11,35,898,380,518
02W507,nan,02,Friedrichshain-Kreuzberg,507,W,5,83,O,1568,1060,508,0,865,7,22,843,368,475
02W508,nan,02,Friedrichshain-Kreuzberg,508,W,5,83,O,1807,1242,565,0,993,12,14,979,446,533
02W509,nan,02,Friedrichshain-Kreuzberg,509,W,5,83,O,1471,1010,461,0,804,10,25,779,312,467
02W510,nan,02,Friedrichshain-Kreuzberg,510,W,5,83,O,2064,1418,646,0,1142,10,25,1117,482,635
02W511,nan,02,Friedrichshain-Kreuzberg,511,W,5,83,O,1202,812,390,0,598,4,17,581,255,326
02W512,nan,02,Friedrichshain-Kreuzberg,512,W,5,83,O,1307,918,389,0,661,5,24,637,285,352
02W513,nan,02,Friedrichshain-Kreuzberg,513,W,5,83,O,1271,936,335,0,711,2,26,685,338,347
02W514,nan,02,Friedrichshain-Kreuzberg,514,W,5,83,O,1430,1002,428,0,780,10,29,751,324,427
02W515,nan,02,Friedrichshain-Kreuzberg,515,W,5,83,O,1547,1125,422,0,806,17,25,781,371,410
02W516,nan,02,Friedrichshain-Kreuzberg,516,W,5,83,O,1259,878,381,0,661,4,28,633,291,342
02W517,nan,02,Friedrichshain-Kreuzberg,517,W,5,83,O,1236,843,393,0,666,7,12,654,270,384
02W518,nan,02,Friedrichshain-Kreuzberg,518,W,5,83,O,962,659,303,0,512,10,22,490,195,295
02W519,nan,02,Friedrichshain-Kreuzberg,519,W,5,83,O,1429,966,463,0,793,9,30,763,313,450
02W520,nan,02,Friedrichshain-Kreuzberg,520,W,5,83,O,1657,1094,563,0,807,14,30,777,300,477
02W521,nan,02,Friedrichshain-Kreuzberg,521,W,5,83,O,1521,1022,499,0,785,5,29,756,298,458
02W522,nan,02,Friedrichshain-Kreuzberg,522,W,5,83,O,1398,972,426,0,730,4,12,718,329,389
02W523,nan,02,Friedrichshain-Kreuzberg,523,W,5,83,O,961,631,330,0,481,5,16,465,203,262
02W524,nan,02,Friedrichshain-Kreuzberg,524,W,5,83,O,1323,864,459,0,676,8,19,657,270,387
03W101,nan,03,Pankow,101,W,1,76,nan,2133,1568,565,0,1121,5,27,1094,545,549
03W102,nan,03,Pankow,102,W,1,76,nan,1850,1281,569,0,875,0,13,862,454,408
03W103,nan,03,Pankow,103,W,1,76,nan,1447,1218,229,0,644,1,20,624,327,297
03W104,nan,03,Pankow,104,W,1,76,nan,1508,1161,347,0,672,2,19,653,371,282
03W105,nan,03,Pankow,105,W,1,76,nan,1104,852,252,0,598,1,10,588,309,279
03W106,nan,03,Pankow,106,W,1,76,nan,1408,1236,172,0,635,1,4,631,414,217
03W107,nan,03,Pankow,107,W,1,76,nan,916,766,150,0,457,0,2,455,299,156
03W108,nan,03,Pankow,108,W,1,76,nan,1419,1191,228,0,756,1,24,732,441,291
03W109,nan,03,Pankow,109,W,1,76,nan,1529,1189,340,0,897,3,17,880,504,376
03W110,nan,03,Pankow,110,W,1,76,nan,1488,1232,256,0,823,2,17,806,476,330
03W111,nan,03,Pankow,111,W,1,76,nan,1285,996,289,0,765,3,6,759,406,353
03W112,nan,03,Pankow,112,W,1,76,nan,1323,1003,320,0,734,5,15,719,376,343
03W113,nan,03,Pankow,113,W,1,76,nan,1538,1220,318,0,985,3,19,966,465,501
03W114,nan,03,Pankow,114,W,1,76,nan,1333,943,390,0,775,7,5,770,350,420
03W115,nan,03,Pankow,115,W,1,76,nan,1533,1089,444,0,898,5,14,884,449,435
03W116,nan,03,Pankow,116,W,1,76,nan,1595,1253,342,0,933,7,13,920,540,380
03W117,nan,03,Pankow,117,W,1,76,nan,1504,1266,238,0,793,3,16,777,501,276
03W118,nan,03,Pankow,118,W,1,76,nan,1536,1108,428,0,883,1,12,871,405,466
03W119,nan,03,Pankow,119,W,1,76,nan,1858,1432,426,0,1055,3,7,1048,543,505
03W120,nan,03,Pankow,120,W,1,76,nan,1869,1412,457,0,1040,3,15,1025,488,537
03W121,nan,03,Pankow,121,W,1,76,nan,1881,1413,468,0,1028,6,13,1015,515,500
03W122,nan,03,Pankow,122,W,1,76,nan,1610,1118,492,0,897,6,7,890,456,434
03W123,nan,03,Pankow,123,W,1,76,nan,1525,1218,307,0,946,2,8,938,556,382
03W201,nan,03,Pankow,201,W,2,76,nan,643,560,83,0,454,2,7,447,284,163
03W202,nan,03,Pankow,202,W,2,76,nan,861,717,144,0,543,4,11,532,299,233
03W203,nan,03,Pankow,203,W,2,76,nan,1529,1209,320,0,882,7,6,876,530,346
03W204,nan,03,Pankow,204,W,2,76,nan,1578,1213,365,0,866,2,11,855,516,339
03W205,nan,03,Pankow,205,W,2,76,nan,1428,1060,368,0,755,4,12,743,407,336
03W206,nan,03,Pankow,206,W,2,76,nan,1667,1192,475,0,955,1,20,935,502,433
03W207,nan,03,Pankow,207,W,2,76,nan,1518,1180,338,0,898,7,13,885,489,396
03W208,nan,03,Pankow,208,W,2,76,nan,1666,1197,469,0,881,2,7,874,463,411
03W209,nan,03,Pankow,209,W,2,76,nan,1696,1246,450,0,921,6,7,914,450,464
03W210,nan,03,Pankow,210,W,2,76,nan,1751,1313,438,0,1035,7,13,1022,435,587
03W211,nan,03,Pankow,211,W,2,76,nan,1537,1101,436,0,898,5,5,893,398,495
03W212,nan,03,Pankow,212,W,2,76,nan,1425,1028,397,0,795,6,12,783,364,419
03W213,nan,03,Pankow,213,W,2,76,nan,1685,1188,497,0,915,8,9,906,346,560
03W214,nan,03,Pankow,214,W,2,76,nan,1588,1081,507,0,812,3,6,806,364,442
03W215,nan,03,Pankow,215,W,2,76,nan,1503,1067,436,0,763,6,7,756,430,326
03W216,nan,03,Pankow,216,W,2,76,nan,1624,1168,456,0,818,2,5,813,433,380
03W217,nan,03,Pankow,217,W,2,76,nan,1388,1035,353,0,804,3,16,788,356,432
03W218,nan,03,Pankow,218,W,2,76,nan,2007,1394,613,0,1068,11,20,1048,542,506
03W219,nan,03,Pankow,219,W,2,76,nan,1571,1188,383,0,911,2,11,900,496,404
03W220,nan,03,Pankow,220,W,2,76,nan,1626,1140,486,0,888,3,8,880,290,590
03W221,nan,03,Pankow,221,W,2,76,nan,1654,1037,617,0,786,4,6,780,253,527
03W222,nan,03,Pankow,222,W,2,76,nan,965,777,188,0,535,3,13,522,308,214
03W301,nan,03,Pankow,301,W,3,76,nan,1665,1165,500,0,872,1,8,864,378,486
03W302,nan,03,Pankow,302,W,3,76,nan,1677,1280,397,0,777,6,9,768,325,443
03W303,nan,03,Pankow,303,W,3,76,nan,1672,1300,372,0,854,0,9,845,385,460
03W304,nan,03,Pankow,304,W,3,76,nan,1710,1209,501,0,921,4,7,914,331,583
03W305,nan,03,Pankow,305,W,3,76,nan,1658,1175,483,0,868,6,12,856,351,505
03W306,nan,03,Pankow,306,W,3,76,nan,1737,1169,568,0,890,6,8,882,293,589
03W307,nan,03,Pankow,307,W,3,76,nan,1416,1033,383,0,848,3,11,837,280,557
03W308,nan,03,Pankow,308,W,3,76,nan,1328,921,407,0,641,0,8,633,194,439
03W309,nan,03,Pankow,309,W,3,76,nan,1442,1098,344,0,804,0,3,801,247,554
03W310,nan,03,Pankow,310,W,3,76,nan,1589,1157,432,0,886,0,11,875,262,613
03W311,nan,03,Pankow,311,W,3,76,nan,1064,701,363,0,552,1,6,546,119,427
03W312,nan,03,Pankow,312,W,3,76,nan,1556,1048,508,0,847,0,3,844,175,669
03W313,nan,03,Pankow,313,W,3,76,nan,1455,1027,428,0,833,3,10,823,205,618
03W314,nan,03,Pankow,314,W,3,76,nan,1552,1075,477,0,711,8,7,704,126,578
03W315,nan,03,Pankow,315,W,3,76,nan,1526,1037,489,0,871,4,8,863,202,661
03W316,nan,03,Pankow,316,W,3,76,nan,1745,1225,520,0,1022,5,10,1012,254,758
03W317,nan,03,Pankow,317,W,3,76,nan,1697,1177,520,0,928,4,4,924,231,693
03W318,nan,03,Pankow,318,W,3,76,nan,1568,1089,479,0,786,1,10,776,233,543
03W319,nan,03,Pankow,319,W,3,76,nan,1753,1282,471,0,901,5,14,887,368,519
03W320,nan,03,Pankow,320,W,3,76,nan,1557,1058,499,0,790,4,14,776,140,636
03W321,nan,03,Pankow,321,W,3,76,nan,1588,1141,447,0,888,0,8,880,218,662
03W401,nan,03,Pankow,401,W,4,76,nan,1860,1511,349,0,988,5,14,974,429,545
03W402,nan,03,Pankow,402,W,4,76,nan,1754,1316,438,0,961,6,11,950,359,591
03W403,nan,03,Pankow,403,W,4,76,nan,1928,1385,543,0,996,6,24,972,403,569
03W404,nan,03,Pankow,404,W,4,76,nan,1528,1017,511,0,702,9,24,678,268,410
03W405,nan,03,Pankow,405,W,4,76,nan,1622,1312,310,0,843,8,30,813,410,403
03W406,nan,03,Pankow,406,W,4,76,nan,1747,1270,477,0,892,5,18,874,426,448
03W407,nan,03,Pankow,407,W,4,76,nan,1672,1337,335,0,865,4,12,853,458,395
03W408,nan,03,Pankow,408,W,4,76,nan,1845,1488,357,0,879,1,28,851,425,426
03W409,nan,03,Pankow,409,W,4,76,nan,1330,960,370,0,636,2,9,627,267,360
03W410,nan,03,Pankow,410,W,4,76,nan,1351,1077,274,0,721,3,24,697,350,347
03W411,nan,03,Pankow,411,W,4,76,nan,1694,1245,449,0,941,2,8,933,239,694
03W412,nan,03,Pankow,412,W,4,76,nan,1563,1121,442,0,836,6,6,830,180,650
03W413,nan,03,Pankow,413,W,4,76,nan,1522,1093,429,0,793,4,9,784,238,546
03W414,nan,03,Pankow,414,W,4,76,nan,2148,1371,777,0,1132,2,18,1114,416,698
03W415,nan,03,Pankow,415,W,4,76,nan,1242,911,331,0,712,2,12,700,325,375
03W416,nan,03,Pankow,416,W,4,76,nan,1749,1260,489,0,908,10,12,896,364,532
03W417,nan,03,Pankow,417,W,4,76,nan,1741,1283,458,0,844,2,20,824,398,426
03W418,nan,03,Pankow,418,W,4,76,nan,1010,779,231,0,389,2,6,383,189,194
03W501,nan,03,Pankow,501,W,5,76,nan,1691,1232,459,0,928,3,13,915,339,576
03W502,nan,03,Pankow,502,W,5,76,nan,1326,947,379,0,703,3,15,688,225,463
03W503,nan,03,Pankow,503,W,5,76,nan,1609,1192,417,0,896,3,15,881,281,600
03W504,nan,03,Pankow,504,W,5,76,nan,1380,990,390,0,775,0,10,765,262,503
03W505,nan,03,Pankow,505,W,5,76,nan,1287,989,298,0,657,8,15,642,275,367
03W506,nan,03,Pankow,506,W,5,76,nan,1482,1015,467,0,757,0,16,741,332,409
03W507,nan,03,Pankow,507,W,5,76,nan,1588,1149,439,0,801,0,12,789,337,452
03W508,nan,03,Pankow,508,W,5,76,nan,1463,1042,421,0,760,1,11,749,311,438
03W509,nan,03,Pankow,509,W,5,76,nan,1779,1246,533,0,914,9,17,897,327,570
03W510,nan,03,Pankow,510,W,5,76,nan,1474,1044,430,0,788,2,7,781,276,505
03W511,nan,03,Pankow,511,W,5,76,nan,1628,1156,472,0,918,5,9,909,245,664
03W512,nan,03,Pankow,512,W,5,76,nan,1580,1188,392,0,763,0,14,749,439,310
03W513,nan,03,Pankow,513,W,5,76,nan,1703,1231,472,0,898,0,11,887,279,608
03W514,nan,03,Pankow,514,W,5,76,nan,1569,1266,303,0,853,4,7,846,354,492
03W515,nan,03,Pankow,515,W,5,76,nan,1294,984,310,0,755,7,5,750,180,570
03W516,nan,03,Pankow,516,W,5,76,nan,1802,1215,587,0,939,0,11,928,218,710
03W517,nan,03,Pankow,517,W,5,76,nan,1229,932,297,0,729,2,4,725,138,587
03W518,nan,03,Pankow,518,W,5,76,nan,1427,1035,392,0,730,3,9,721,232,489
03W519,nan,03,Pankow,519,W,5,76,nan,1314,912,402,0,654,3,8,646,261,385
03W520,nan,03,Pankow,520,W,5,76,nan,1544,1075,469,0,835,14,12,823,334,489
03W600,nan,03,Pankow,600,W,6,76,nan,1501,1060,441,0,780,7,23,757,281,476
03W601,nan,03,Pankow,601,W,6,76,nan,1554,1202,352,0,829,8,16,813,346,467
03W602,nan,03,Pankow,602,W,6,76,nan,1544,1044,500,0,811,15,14,797,318,479
03W603,nan,03,Pankow,603,W,6,76,nan,1197,821,376,0,648,5,14,634,268,366
03W604,nan,03,Pankow,604,W,6,76,nan,1376,939,437,0,774,4,13,761,288,473
03W605,nan,03,Pankow,605,W,6,76,nan,1452,1054,398,0,841,13,22,819,316,503
03W606,nan,03,Pankow,606,W,6,76,nan,1646,1123,523,0,899,11,22,877,327,550
03W607,nan,03,Pankow,607,W,6,76,nan,1614,1091,523,0,902,9,10,892,359,533
03W608,nan,03,Pankow,608,W,6,76,nan,1585,1101,484,0,888,0,19,869,372,497
03W609,nan,03,Pankow,609,W,6,76,nan,1588,1068,520,0,872,18,15,857,378,479
03W610,nan,03,Pankow,610,W,6,76,nan,1613,1187,426,0,948,10,17,931,417,514
03W611,nan,03,Pankow,611,W,6,76,nan,1534,1002,532,0,752,20,13,739,336,403
03W612,nan,03,Pankow,612,W,6,76,nan,1517,964,553,0,786,12,11,775,314,461
03W613,nan,03,Pankow,613,W,6,76,nan,1444,969,475,0,769,12,15,754,326,428
03W614,nan,03,Pankow,614,W,6,76,nan,1732,1151,581,0,950,13,26,924,352,572
03W615,nan,03,Pankow,615,W,6,76,nan,923,617,306,0,518,8,11,507,242,265
03W616,nan,03,Pankow,616,W,6,76,nan,816,539,277,0,438,12,7,431,168,263
03W617,nan,03,Pankow,617,W,6,76,nan,1626,1131,495,0,926,20,28,898,415,483
03W618,nan,03,Pankow,618,W,6,76,nan,1699,1078,621,0,903,25,14,889,394,495
03W619,nan,03,Pankow,619,W,6,76,nan,1427,964,463,0,754,3,21,733,294,439
03W620,nan,03,Pankow,620,W,6,76,nan,1752,1155,597,0,950,9,14,936,439,497
03W701,nan,03,Pankow,701,W,7,76,nan,1521,1172,349,0,843,6,15,828,409,419
03W702,nan,03,Pankow,702,W,7,76,nan,1456,1089,367,0,798,0,0,798,364,434
03W703,nan,03,Pankow,703,W,7,76,nan,1652,1315,337,0,859,12,11,848,428,420
03W704,nan,03,Pankow,704,W,7,76,nan,1337,1052,285,0,670,6,10,660,363,297
03W705,nan,03,Pankow,705,W,7,76,nan,1639,1208,431,0,860,4,24,836,380,456
03W706,nan,03,Pankow,706,W,7,83,O,1634,1189,445,0,745,0,19,726,361,365
03W707,nan,03,Pankow,707,W,7,83,O,1917,1335,582,0,869,1,27,842,441,401
03W708,nan,03,Pankow,708,W,7,83,O,1608,1140,468,0,792,11,0,792,360,432
03W709,nan,03,Pankow,709,W,7,83,O,1645,1261,384,0,898,5,18,880,429,451
03W710,nan,03,Pankow,710,W,7,83,O,1802,1359,443,0,952,6,30,922,432,490
03W711,nan,03,Pankow,711,W,7,83,O,1548,1112,436,0,720,8,14,706,333,373
03W712,nan,03,Pankow,712,W,7,76,nan,1534,1070,464,0,808,7,13,795,389,406
03W713,nan,03,Pankow,713,W,7,76,nan,1486,980,506,0,785,11,5,780,349,431
03W714,nan,03,Pankow,714,W,7,76,nan,1297,846,451,0,653,2,19,634,257,377
03W715,nan,03,Pankow,715,W,7,76,nan,1672,1166,506,0,851,0,10,841,356,485
03W716,nan,03,Pankow,716,W,7,76,nan,1506,991,515,0,763,11,11,752,328,424
03W717,nan,03,Pankow,717,W,7,76,nan,1345,908,437,0,678,11,7,671,284,387
03W718,nan,03,Pankow,718,W,7,76,nan,1081,828,253,0,624,6,14,610,279,331
03W719,nan,03,Pankow,719,W,7,76,nan,1358,1033,325,0,733,5,7,726,364,362
03W720,nan,03,Pankow,720,W,7,76,nan,1440,1000,440,0,805,11,18,787,327,460
03W801,nan,03,Pankow,801,W,8,83,O,1945,1461,484,0,985,1,16,969,541,428
03W802,nan,03,Pankow,802,W,8,83,O,1499,1062,437,0,824,13,27,797,367,430
03W803,nan,03,Pankow,803,W,8,83,O,1491,1024,467,0,780,6,27,753,332,421
03W804,nan,03,Pankow,804,W,8,83,O,1472,1005,467,0,852,12,15,837,356,481
03W805,nan,03,Pankow,805,W,8,83,O,1786,1172,614,0,951,21,17,934,413,521
03W806,nan,03,Pankow,806,W,8,83,O,1655,1048,607,0,871,17,27,844,392,452
03W807,nan,03,Pankow,807,W,8,83,O,1520,966,554,0,788,10,14,774,317,457
03W808,nan,03,Pankow,808,W,8,83,O,1731,1236,495,0,811,5,22,789,472,317
03W809,nan,03,Pankow,809,W,8,76,nan,1588,979,609,0,812,10,20,792,339,453
03W810,nan,03,Pankow,810,W,8,76,nan,1453,991,462,0,806,16,17,789,374,415
03W811,nan,03,Pankow,811,W,8,76,nan,1471,957,514,0,795,20,22,773,348,425
03W812,nan,03,Pankow,812,W,8,76,nan,1675,1058,617,0,877,13,20,857,393,464
03W813,nan,03,Pankow,813,W,8,76,nan,1797,1177,620,0,997,17,18,979,477,502
03W814,nan,03,Pankow,814,W,8,76,nan,1402,922,480,0,753,7,13,740,330,410
03W815,nan,03,Pankow,815,W,8,76,nan,1522,1004,518,0,843,20,25,818,366,452
03W816,nan,03,Pankow,816,W,8,76,nan,1475,1023,452,0,822,7,19,803,385,418
03W817,nan,03,Pankow,817,W,8,76,nan,1295,868,427,0,652,9,16,636,295,341
03W818,nan,03,Pankow,818,W,8,76,nan,1274,791,483,0,631,16,15,616,304,312
03W819,nan,03,Pankow,819,W,8,76,nan,944,602,342,0,510,12,14,496,213,283
03W901,nan,03,Pankow,901,W,9,76,nan,1648,1191,457,0,876,0,15,861,369,492
03W902,nan,03,Pankow,902,W,9,76,nan,1567,1227,340,0,875,8,14,861,416,445
03W903,nan,03,Pankow,903,W,9,76,nan,1816,1328,488,0,1077,16,25,1052,404,648
03W904,nan,03,Pankow,904,W,9,76,nan,1698,1271,427,0,954,10,19,935,420,515
03W905,nan,03,Pankow,905,W,9,83,O,1374,1045,329,0,716,1,15,701,359,342
03W906,nan,03,Pankow,906,W,9,83,O,1141,843,298,0,600,0,19,581,270,311
03W907,nan,03,Pankow,907,W,9,83,O,1176,896,280,0,615,1,16,599,345,254
03W908,nan,03,Pankow,908,W,9,83,O,1572,1214,358,0,721,3,25,696,397,299
03W909,nan,03,Pankow,909,W,9,83,O,1049,714,335,0,580,3,23,557,264,293
03W910,nan,03,Pankow,910,W,9,83,O,1236,951,285,0,536,3,19,517,248,269
03W911,nan,03,Pankow,911,W,9,83,O,1369,1066,303,0,693,6,17,676,332,344
03W912,nan,03,Pankow,912,W,9,83,O,1351,1010,341,0,699,7,15,684,351,333
03W913,nan,03,Pankow,913,W,9,83,O,1511,1085,426,0,799,6,25,774,354,420
03W914,nan,03,Pankow,914,W,9,83,O,975,682,293,0,528,6,14,514,236,278
03W915,nan,03,Pankow,915,W,9,83,O,1904,1349,555,0,966,12,37,929,433,496
03W916,nan,03,Pankow,916,W,9,83,O,1611,1089,522,0,912,8,18,894,351,543
03W917,nan,03,Pankow,917,W,9,83,O,1505,979,526,0,829,22,15,814,325,489
03W918,nan,03,Pankow,918,W,9,83,O,1446,1001,445,0,823,10,18,805,364,441
03W919,nan,03,Pankow,919,W,9,83,O,1639,1092,547,0,889,14,18,871,403,468
03W920,nan,03,Pankow,920,W,9,83,O,1141,824,317,0,553,4,12,541,297,244
03W921,nan,03,Pankow,921,W,9,83,O,1181,905,276,0,613,7,18,595,301,294
03W922,nan,03,Pankow,922,W,9,83,O,1476,1034,442,0,911,11,17,894,361,533
03W923,nan,03,Pankow,923,W,9,83,O,646,496,150,0,219,1,13,206,104,102
03W924,nan,03,Pankow,924,W,9,83,O,1852,1259,593,0,974,17,29,945,396,549
04W101,nan,04,Charlottenburg-Wilmersdorf,101,W,1,78,nan,1060,835,225,0,457,1,3,454,333,121
04W102,nan,04,Charlottenburg-Wilmersdorf,102,W,1,78,nan,1090,840,250,0,502,0,17,485,335,150
04W103,nan,04,Charlottenburg-Wilmersdorf,103,W,1,78,nan,1107,808,299,0,520,1,12,508,333,175
04W104,nan,04,Charlottenburg-Wilmersdorf,104,W,1,78,nan,958,755,203,0,441,0,7,434,295,139
04W105,nan,04,Charlottenburg-Wilmersdorf,105,W,1,78,nan,995,794,201,0,405,1,10,395,276,119
04W106,nan,04,Charlottenburg-Wilmersdorf,106,W,1,78,nan,1406,1136,270,0,695,4,10,685,510,175
04W107,nan,04,Charlottenburg-Wilmersdorf,107,W,1,78,nan,1315,1054,261,0,618,1,11,607,409,198
04W108,nan,04,Charlottenburg-Wilmersdorf,108,W,1,78,nan,811,624,187,0,382,0,2,380,289,91
04W109,nan,04,Charlottenburg-Wilmersdorf,109,W,1,78,nan,891,730,161,0,386,2,6,380,277,103
04W110,nan,04,Charlottenburg-Wilmersdorf,110,W,1,78,nan,1181,914,267,0,582,2,12,570,415,155
04W111,nan,04,Charlottenburg-Wilmersdorf,111,W,1,78,nan,1032,829,203,0,488,2,1,487,378,109
04W112,nan,04,Charlottenburg-Wilmersdorf,112,W,1,78,nan,1256,992,264,0,640,0,15,625,444,181
04W113,nan,04,Charlottenburg-Wilmersdorf,113,W,1,78,nan,1359,1027,332,0,722,0,14,708,482,226
04W114,nan,04,Charlottenburg-Wilmersdorf,114,W,1,78,nan,1247,836,411,0,557,4,6,551,390,161
04W115,nan,04,Charlottenburg-Wilmersdorf,115,W,1,78,nan,1402,980,422,0,738,3,2,736,468,268
04W116,nan,04,Charlottenburg-Wilmersdorf,116,W,1,78,nan,1260,872,388,0,635,4,15,620,417,203
04W117,nan,04,Charlottenburg-Wilmersdorf,117,W,1,78,nan,1624,1136,488,0,823,8,17,806,565,241
04W118,nan,04,Charlottenburg-Wilmersdorf,118,W,1,78,nan,1493,1058,435,0,681,3,10,671,471,200
04W201,nan,04,Charlottenburg-Wilmersdorf,201,W,2,80,nan,949,559,390,0,447,2,5,442,282,160
04W202,nan,04,Charlottenburg-Wilmersdorf,202,W,2,80,nan,1137,718,419,0,530,0,8,522,347,175
04W203,nan,04,Charlottenburg-Wilmersdorf,203,W,2,80,nan,1588,1022,566,0,800,0,12,788,526,262
04W204,nan,04,Charlottenburg-Wilmersdorf,204,W,2,80,nan,1517,999,518,0,749,1,20,729,602,127
04W205,nan,04,Charlottenburg-Wilmersdorf,205,W,2,80,nan,1373,876,497,0,699,10,10,689,520,169
04W206,nan,04,Charlottenburg-Wilmersdorf,206,W,2,80,nan,1196,832,364,0,598,1,8,590,435,155
04W207,nan,04,Charlottenburg-Wilmersdorf,207,W,2,80,nan,1157,792,365,0,563,10,9,554,373,181
04W208,nan,04,Charlottenburg-Wilmersdorf,208,W,2,80,nan,1712,1350,362,0,774,5,21,753,524,229
04W209,nan,04,Charlottenburg-Wilmersdorf,209,W,2,80,nan,1056,707,349,0,524,0,8,516,347,169
04W210,nan,04,Charlottenburg-Wilmersdorf,210,W,2,80,nan,1215,776,439,0,603,1,11,592,406,186
04W211,nan,04,Charlottenburg-Wilmersdorf,211,W,2,80,nan,1445,953,492,0,737,0,2,735,507,228
04W212,nan,04,Charlottenburg-Wilmersdorf,212,W,2,80,nan,1134,652,482,0,513,5,3,510,353,157
04W213,nan,04,Charlottenburg-Wilmersdorf,213,W,2,80,nan,1628,1033,595,0,795,7,9,786,557,229
04W214,nan,04,Charlottenburg-Wilmersdorf,214,W,2,80,nan,1180,832,348,0,566,2,18,548,353,195
04W215,nan,04,Charlottenburg-Wilmersdorf,215,W,2,80,nan,1646,1254,392,0,836,2,19,817,562,255
04W216,nan,04,Charlottenburg-Wilmersdorf,216,W,2,80,nan,1064,684,380,0,526,2,4,522,373,149
04W217,nan,04,Charlottenburg-Wilmersdorf,217,W,2,80,nan,1441,884,557,0,723,9,15,708,494,214
04W218,nan,04,Charlottenburg-Wilmersdorf,218,W,2,80,nan,1432,994,438,0,733,0,5,728,536,192
04W219,nan,04,Charlottenburg-Wilmersdorf,219,W,2,80,nan,1195,780,415,0,552,5,10,542,398,144
04W220,nan,04,Charlottenburg-Wilmersdorf,220,W,2,80,nan,1222,760,462,0,616,13,14,602,396,206
04W221,nan,04,Charlottenburg-Wilmersdorf,221,W,2,80,nan,1227,753,474,0,539,0,6,533,393,140
04W222,nan,04,Charlottenburg-Wilmersdorf,222,W,2,80,nan,817,593,224,0,449,0,5,444,309,135
04W223,nan,04,Charlottenburg-Wilmersdorf,223,W,2,80,nan,1550,1069,481,0,764,3,5,759,540,219
04W224,nan,04,Charlottenburg-Wilmersdorf,224,W,2,80,nan,1097,696,401,0,603,6,17,586,357,229
04W301,nan,04,Charlottenburg-Wilmersdorf,301,W,3,80,nan,1270,917,353,0,596,0,22,574,366,208
04W302,nan,04,Charlottenburg-Wilmersdorf,302,W,3,80,nan,1108,777,331,0,573,6,6,567,389,178
04W303,nan,04,Charlottenburg-Wilmersdorf,303,W,3,80,nan,1328,964,364,0,712,3,14,698,469,229
04W304,nan,04,Charlottenburg-Wilmersdorf,304,W,3,80,nan,1318,945,373,0,687,5,3,684,461,223
04W305,nan,04,Charlottenburg-Wilmersdorf,305,W,3,80,nan,1519,1036,483,0,764,7,11,753,488,265
04W306,nan,04,Charlottenburg-Wilmersdorf,306,W,3,80,nan,1079,818,261,0,614,5,8,606,352,254
04W307,nan,04,Charlottenburg-Wilmersdorf,307,W,3,80,nan,1394,1011,383,0,765,0,26,739,426,313
04W308,nan,04,Charlottenburg-Wilmersdorf,308,W,3,80,nan,1530,1054,476,0,781,6,10,771,514,257
04W309,nan,04,Charlottenburg-Wilmersdorf,309,W,3,80,nan,1563,1056,507,0,777,2,6,771,544,227
04W310,nan,04,Charlottenburg-Wilmersdorf,310,W,3,80,nan,1054,735,319,0,551,4,14,537,353,184
04W311,nan,04,Charlottenburg-Wilmersdorf,311,W,3,80,nan,1414,1031,383,0,808,3,15,793,483,310
04W312,nan,04,Charlottenburg-Wilmersdorf,312,W,3,80,nan,1225,832,393,0,605,3,7,598,402,196
04W313,nan,04,Charlottenburg-Wilmersdorf,313,W,3,80,nan,1496,951,545,0,686,5,18,668,409,259
04W314,nan,04,Charlottenburg-Wilmersdorf,314,W,3,80,nan,1419,983,436,0,739,0,12,727,429,298
04W315,nan,04,Charlottenburg-Wilmersdorf,315,W,3,80,nan,1451,1010,441,0,800,0,8,792,479,313
04W316,nan,04,Charlottenburg-Wilmersdorf,316,W,3,80,nan,1230,817,413,0,623,10,4,619,412,207
04W317,nan,04,Charlottenburg-Wilmersdorf,317,W,3,80,nan,1010,657,353,0,501,5,4,497,329,168
04W318,nan,04,Charlottenburg-Wilmersdorf,318,W,3,80,nan,1132,750,382,0,612,5,10,602,348,254
04W319,nan,04,Charlottenburg-Wilmersdorf,319,W,3,80,nan,908,588,320,0,481,1,12,469,282,187
04W320,nan,04,Charlottenburg-Wilmersdorf,320,W,3,80,nan,1569,1072,497,0,745,10,11,734,496,238
04W321,nan,04,Charlottenburg-Wilmersdorf,321,W,3,80,nan,1292,912,380,0,586,2,9,577,400,177
04W322,nan,04,Charlottenburg-Wilmersdorf,322,W,3,80,nan,1187,744,443,0,599,9,8,591,360,231
04W323,nan,04,Charlottenburg-Wilmersdorf,323,W,3,80,nan,1541,1063,478,0,784,6,35,749,519,230
04W324,nan,04,Charlottenburg-Wilmersdorf,324,W,3,80,nan,1000,674,326,0,505,6,13,492,356,136
04W401,nan,04,Charlottenburg-Wilmersdorf,401,W,4,80,nan,1464,988,476,0,680,0,14,666,452,214
04W402,nan,04,Charlottenburg-Wilmersdorf,402,W,4,80,nan,1107,784,323,0,517,2,16,501,374,127
04W403,nan,04,Charlottenburg-Wilmersdorf,403,W,4,80,nan,1577,1039,538,0,597,4,8,589,429,160
04W404,nan,04,Charlottenburg-Wilmersdorf,404,W,4,80,nan,1052,819,233,0,601,0,2,599,413,186
04W405,nan,04,Charlottenburg-Wilmersdorf,405,W,4,80,nan,1101,757,344,0,564,3,15,549,371,178
04W406,nan,04,Charlottenburg-Wilmersdorf,406,W,4,80,nan,1081,777,304,0,509,1,3,506,387,119
04W407,nan,04,Charlottenburg-Wilmersdorf,407,W,4,80,nan,1481,1078,403,0,737,0,15,722,490,232
04W408,nan,04,Charlottenburg-Wilmersdorf,408,W,4,80,nan,1362,965,397,0,637,0,15,622,440,182
04W409,nan,04,Charlottenburg-Wilmersdorf,409,W,4,80,nan,1268,846,422,0,631,0,18,613,405,208
04W410,nan,04,Charlottenburg-Wilmersdorf,410,W,4,80,nan,1294,987,307,0,615,0,18,597,463,134
04W411,nan,04,Charlottenburg-Wilmersdorf,411,W,4,80,nan,1407,982,425,0,757,2,12,745,477,268
04W412,nan,04,Charlottenburg-Wilmersdorf,412,W,4,80,nan,1413,983,430,0,731,0,17,714,512,202
04W413,nan,04,Charlottenburg-Wilmersdorf,413,W,4,80,nan,1182,805,377,0,569,0,9,560,379,181
04W414,nan,04,Charlottenburg-Wilmersdorf,414,W,4,80,nan,1395,907,488,0,678,0,6,672,467,205
04W415,nan,04,Charlottenburg-Wilmersdorf,415,W,4,80,nan,1540,1013,527,0,705,0,10,695,494,201
04W416,nan,04,Charlottenburg-Wilmersdorf,416,W,4,80,nan,1446,1017,429,0,662,7,12,650,457,193
04W417,nan,04,Charlottenburg-Wilmersdorf,417,W,4,80,nan,1113,762,351,0,557,0,8,549,386,163
04W418,nan,04,Charlottenburg-Wilmersdorf,418,W,4,80,nan,1363,865,498,0,646,6,13,633,461,172
04W419,nan,04,Charlottenburg-Wilmersdorf,419,W,4,80,nan,1270,848,422,0,626,0,9,617,440,177
04W420,nan,04,Charlottenburg-Wilmersdorf,420,W,4,80,nan,1186,792,394,0,553,0,15,538,401,137
04W421,nan,04,Charlottenburg-Wilmersdorf,421,W,4,80,nan,1096,711,385,0,465,0,4,461,333,128
04W422,nan,04,Charlottenburg-Wilmersdorf,422,W,4,80,nan,918,545,373,0,418,9,3,415,307,108
04W423,nan,04,Charlottenburg-Wilmersdorf,423,W,4,80,nan,1182,770,412,0,509,3,18,491,396,95
04W424,nan,04,Charlottenburg-Wilmersdorf,424,W,4,80,nan,1213,850,363,0,634,0,10,624,489,135
04W425,nan,04,Charlottenburg-Wilmersdorf,425,W,4,80,nan,1511,963,548,0,734,0,14,720,523,197
04W501,nan,04,Charlottenburg-Wilmersdorf,501,W,5,80,nan,947,590,357,0,463,0,5,458,338,120
04W502,nan,04,Charlottenburg-Wilmersdorf,502,W,5,80,nan,1145,698,447,0,505,0,10,495,398,97
04W503,nan,04,Charlottenburg-Wilmersdorf,503,W,5,80,nan,919,617,302,0,426,0,11,415,321,94
04W504,nan,04,Charlottenburg-Wilmersdorf,504,W,5,80,nan,1310,910,400,0,512,0,5,507,394,113
04W505,nan,04,Charlottenburg-Wilmersdorf,505,W,5,80,nan,1134,834,300,0,600,0,12,588,435,153
04W506,nan,04,Charlottenburg-Wilmersdorf,506,W,5,80,nan,1453,1022,431,0,744,0,6,738,541,197
04W507,nan,04,Charlottenburg-Wilmersdorf,507,W,5,80,nan,993,669,324,0,480,0,6,474,344,130
04W508,nan,04,Charlottenburg-Wilmersdorf,508,W,5,80,nan,1184,843,341,0,632,0,10,622,440,182
04W509,nan,04,Charlottenburg-Wilmersdorf,509,W,5,80,nan,1378,918,460,0,727,0,19,708,474,234
04W510,nan,04,Charlottenburg-Wilmersdorf,510,W,5,80,nan,1475,1023,452,0,786,0,22,764,538,226
04W511,nan,04,Charlottenburg-Wilmersdorf,511,W,5,80,nan,1218,832,386,0,561,0,10,551,427,124
04W512,nan,04,Charlottenburg-Wilmersdorf,512,W,5,80,nan,1083,792,291,0,539,3,18,521,394,127
04W513,nan,04,Charlottenburg-Wilmersdorf,513,W,5,80,nan,1444,913,531,0,644,0,12,632,438,194
04W514,nan,04,Charlottenburg-Wilmersdorf,514,W,5,80,nan,1150,746,404,0,504,5,7,497,351,146
04W515,nan,04,Charlottenburg-Wilmersdorf,515,W,5,80,nan,1183,753,430,0,552,8,8,544,381,163
04W516,nan,04,Charlottenburg-Wilmersdorf,516,W,5,80,nan,956,636,320,0,485,1,8,477,328,149
04W517,nan,04,Charlottenburg-Wilmersdorf,517,W,5,80,nan,1579,1150,429,0,806,3,20,786,585,201
04W518,nan,04,Charlottenburg-Wilmersdorf,518,W,5,80,nan,1384,967,417,0,669,4,31,638,461,177
04W519,nan,04,Charlottenburg-Wilmersdorf,519,W,5,80,nan,1280,925,355,0,676,5,20,656,459,197
04W520,nan,04,Charlottenburg-Wilmersdorf,520,W,5,80,nan,1350,944,406,0,716,5,19,697,505,192
04W521,nan,04,Charlottenburg-Wilmersdorf,521,W,5,80,nan,1005,639,366,0,465,5,9,456,346,110
04W522,nan,04,Charlottenburg-Wilmersdorf,522,W,5,80,nan,1276,786,490,0,551,0,5,546,442,104
04W523,nan,04,Charlottenburg-Wilmersdorf,523,W,5,80,nan,1073,678,395,0,525,5,5,520,396,124
04W524,nan,04,Charlottenburg-Wilmersdorf,524,W,5,80,nan,1360,753,607,0,578,5,7,571,456,115
04W525,nan,04,Charlottenburg-Wilmersdorf,525,W,5,80,nan,1128,632,496,0,491,0,12,479,366,113
04W601,nan,04,Charlottenburg-Wilmersdorf,601,W,6,80,nan,1052,715,337,0,510,4,13,497,340,157
04W602,nan,04,Charlottenburg-Wilmersdorf,602,W,6,80,nan,1065,714,351,0,517,0,6,511,360,151
04W603,nan,04,Charlottenburg-Wilmersdorf,603,W,6,80,nan,1140,807,333,0,461,0,3,458,307,151
04W604,nan,04,Charlottenburg-Wilmersdorf,604,W,6,80,nan,1085,756,329,0,473,0,10,463,315,148
04W605,nan,04,Charlottenburg-Wilmersdorf,605,W,6,80,nan,1046,732,314,0,515,0,5,510,339,171
04W606,nan,04,Charlottenburg-Wilmersdorf,606,W,6,80,nan,1281,919,362,0,667,0,29,638,434,204
04W607,nan,04,Charlottenburg-Wilmersdorf,607,W,6,80,nan,1163,741,422,0,535,0,15,520,348,172
04W608,nan,04,Charlottenburg-Wilmersdorf,608,W,6,80,nan,1241,802,439,0,555,0,6,549,387,162
04W609,nan,04,Charlottenburg-Wilmersdorf,609,W,6,80,nan,1173,821,352,0,571,0,8,563,387,176
04W610,nan,04,Charlottenburg-Wilmersdorf,610,W,6,80,nan,1124,700,424,0,549,0,18,531,341,190
04W611,nan,04,Charlottenburg-Wilmersdorf,611,W,6,80,nan,1004,695,309,0,556,0,18,538,351,187
04W612,nan,04,Charlottenburg-Wilmersdorf,612,W,6,80,nan,1383,977,406,0,723,5,21,702,469,233
04W613,nan,04,Charlottenburg-Wilmersdorf,613,W,6,80,nan,1311,832,479,0,614,0,13,601,370,231
04W614,nan,04,Charlottenburg-Wilmersdorf,614,W,6,80,nan,1135,791,344,0,603,0,13,590,372,218
04W615,nan,04,Charlottenburg-Wilmersdorf,615,W,6,80,nan,1131,789,342,0,603,0,5,598,410,188
04W616,nan,04,Charlottenburg-Wilmersdorf,616,W,6,80,nan,1025,648,377,0,489,7,9,480,275,205
04W617,nan,04,Charlottenburg-Wilmersdorf,617,W,6,80,nan,1320,914,406,0,679,0,6,673,444,229
04W618,nan,04,Charlottenburg-Wilmersdorf,618,W,6,80,nan,1179,817,362,0,603,0,13,590,368,222
04W619,nan,04,Charlottenburg-Wilmersdorf,619,W,6,80,nan,1137,789,348,0,563,9,6,557,333,224
04W620,nan,04,Charlottenburg-Wilmersdorf,620,W,6,80,nan,1519,994,525,0,653,5,16,637,413,224
04W621,nan,04,Charlottenburg-Wilmersdorf,621,W,6,80,nan,1536,1110,426,0,827,5,12,815,497,318
04W622,nan,04,Charlottenburg-Wilmersdorf,622,W,6,80,nan,1545,1035,510,0,773,3,16,757,476,281
04W623,nan,04,Charlottenburg-Wilmersdorf,623,W,6,80,nan,1088,766,322,0,571,8,14,557,344,213
04W624,nan,04,Charlottenburg-Wilmersdorf,624,W,6,80,nan,1228,858,370,0,722,0,8,714,407,307
04W625,nan,04,Charlottenburg-Wilmersdorf,625,W,6,80,nan,1225,882,343,0,665,0,11,654,384,270
04W626,nan,04,Charlottenburg-Wilmersdorf,626,W,6,80,nan,1388,1017,371,0,749,0,15,734,480,254
04W701,nan,04,Charlottenburg-Wilmersdorf,701,W,7,80,nan,1258,862,396,0,595,2,4,591,387,204
04W702,nan,04,Charlottenburg-Wilmersdorf,702,W,7,80,nan,1139,789,350,0,540,5,7,533,387,146
04W703,nan,04,Charlottenburg-Wilmersdorf,703,W,7,80,nan,1174,830,344,0,566,3,16,550,350,200
04W704,nan,04,Charlottenburg-Wilmersdorf,704,W,7,80,nan,1420,984,436,0,703,6,9,694,489,205
04W705,nan,04,Charlottenburg-Wilmersdorf,705,W,7,80,nan,1401,926,475,0,700,3,16,684,432,252
04W706,nan,04,Charlottenburg-Wilmersdorf,706,W,7,80,nan,1596,1129,467,0,915,16,13,902,535,367
04W707,nan,04,Charlottenburg-Wilmersdorf,707,W,7,80,nan,1419,1036,383,0,768,9,25,743,448,295
04W708,nan,04,Charlottenburg-Wilmersdorf,708,W,7,80,nan,1348,1004,344,0,735,5,22,713,481,232
04W709,nan,04,Charlottenburg-Wilmersdorf,709,W,7,80,nan,1449,1003,446,0,691,0,18,673,470,203
04W710,nan,04,Charlottenburg-Wilmersdorf,710,W,7,80,nan,1555,1040,515,0,854,5,21,833,505,328
04W711,nan,04,Charlottenburg-Wilmersdorf,711,W,7,80,nan,1438,866,572,0,666,1,12,654,406,248
04W712,nan,04,Charlottenburg-Wilmersdorf,712,W,7,80,nan,1432,912,520,0,740,2,12,728,449,279
04W713,nan,04,Charlottenburg-Wilmersdorf,713,W,7,80,nan,1301,851,450,0,669,3,6,663,413,250
04W714,nan,04,Charlottenburg-Wilmersdorf,714,W,7,80,nan,1388,957,431,0,741,4,10,731,476,255
04W715,nan,04,Charlottenburg-Wilmersdorf,715,W,7,80,nan,1652,1133,519,0,802,8,6,796,532,264
04W716,nan,04,Charlottenburg-Wilmersdorf,716,W,7,80,nan,1459,972,487,0,737,0,16,721,454,267
04W717,nan,04,Charlottenburg-Wilmersdorf,717,W,7,80,nan,1505,1001,504,0,822,7,14,808,428,380
04W718,nan,04,Charlottenburg-Wilmersdorf,718,W,7,80,nan,1424,910,514,0,716,6,14,702,499,203
04W719,nan,04,Charlottenburg-Wilmersdorf,719,W,7,80,nan,1016,772,244,0,494,1,6,488,345,143
04W720,nan,04,Charlottenburg-Wilmersdorf,720,W,7,80,nan,1248,808,440,0,547,3,5,542,380,162
04W721,nan,04,Charlottenburg-Wilmersdorf,721,W,7,80,nan,1247,856,391,0,708,9,13,695,452,243
04W722,nan,04,Charlottenburg-Wilmersdorf,722,W,7,80,nan,919,567,352,0,452,0,13,439,307,132
04W723,nan,04,Charlottenburg-Wilmersdorf,723,W,7,80,nan,1205,809,396,0,633,0,10,623,435,188
04W724,nan,04,Charlottenburg-Wilmersdorf,724,W,7,80,nan,1527,998,529,0,754,8,14,740,477,263
04W801,nan,04,Charlottenburg-Wilmersdorf,801,W,1,80,nan,1352,902,450,0,617,0,10,607,386,221
04W802,nan,04,Charlottenburg-Wilmersdorf,802,W,1,80,nan,1182,759,423,0,549,3,5,544,385,159
04W803,nan,04,Charlottenburg-Wilmersdorf,803,W,1,80,nan,1169,869,300,0,601,3,21,580,415,165
04W804,nan,04,Charlottenburg-Wilmersdorf,804,W,1,80,nan,1607,1187,420,0,790,6,13,777,509,268
04W805,nan,04,Charlottenburg-Wilmersdorf,805,W,1,80,nan,1337,958,379,0,658,2,10,648,460,188
04W806,nan,04,Charlottenburg-Wilmersdorf,806,W,1,80,nan,1312,834,478,0,560,4,7,553,351,202
05W101,nan,05,Spandau,101,W,1,78,nan,855,547,308,0,311,4,4,307,159,148
05W102,nan,05,Spandau,102,W,1,78,nan,921,617,304,0,452,0,4,448,275,173
05W103,nan,05,Spandau,103,W,1,78,nan,1085,769,316,0,608,6,19,589,218,371
05W104,nan,05,Spandau,104,W,1,78,nan,934,788,146,0,474,0,6,468,271,197
05W105,nan,05,Spandau,105,W,1,78,nan,1067,736,331,0,611,2,4,607,191,416
05W106,nan,05,Spandau,106,W,1,78,nan,1133,734,399,0,528,3,7,521,159,362
05W107,nan,05,Spandau,107,W,1,78,nan,898,655,243,0,463,0,4,459,258,201
05W108,nan,05,Spandau,108,W,1,78,nan,1148,896,252,0,509,2,5,504,287,217
05W109,nan,05,Spandau,109,W,1,78,nan,746,630,116,0,294,0,13,281,90,191
05W110,nan,05,Spandau,110,W,1,78,nan,922,692,230,0,466,1,2,464,217,247
05W111,nan,05,Spandau,111,W,1,78,nan,1240,948,292,0,632,1,12,620,338,282
05W112,nan,05,Spandau,112,W,1,78,nan,1055,778,277,0,529,1,4,525,248,277
05W113,nan,05,Spandau,113,W,1,78,nan,1051,750,301,0,559,2,7,552,186,366
05W114,nan,05,Spandau,114,W,1,78,nan,913,685,228,0,468,3,7,461,207,254
05W115,nan,05,Spandau,115,W,1,78,nan,1064,929,135,0,584,1,11,573,289,284
05W116,nan,05,Spandau,116,W,1,78,nan,822,696,126,0,421,0,0,421,197,224
05W117,nan,05,Spandau,117,W,1,78,nan,979,832,147,0,496,1,2,494,286,208
05W118,nan,05,Spandau,118,W,1,78,nan,1233,965,268,0,575,2,12,563,322,241
05W119,nan,05,Spandau,119,W,1,78,nan,1285,885,400,0,586,3,9,577,360,217
05W120,nan,05,Spandau,120,W,1,78,nan,1199,1005,194,0,664,2,13,651,368,283
05W121,nan,05,Spandau,121,W,1,78,nan,1087,899,188,0,623,4,5,618,359,259
05W122,nan,05,Spandau,122,W,1,78,nan,993,768,225,0,428,0,1,427,250,177
05W123,nan,05,Spandau,123,W,1,78,nan,860,651,209,0,430,1,2,428,212,216
05W124,nan,05,Spandau,124,W,1,78,nan,1364,1074,290,0,702,0,7,695,349,346
05W125,nan,05,Spandau,125,W,1,78,nan,1001,844,157,0,487,0,4,483,278,205
05W126,nan,05,Spandau,126,W,1,78,nan,1180,978,202,0,515,4,5,510,302,208
05W127,nan,05,Spandau,127,W,1,78,nan,957,847,110,0,496,1,10,486,298,188
05W128,nan,05,Spandau,128,W,1,78,nan,905,774,131,0,318,5,12,306,166,140
05W129,nan,05,Spandau,129,W,1,78,nan,1017,846,171,0,537,0,12,525,293,232
05W130,nan,05,Spandau,130,W,1,78,nan,1064,908,156,0,533,0,7,526,284,242
05W131,nan,05,Spandau,131,W,1,78,nan,1239,1070,169,0,607,1,13,594,298,296
05W132,nan,05,Spandau,132,W,1,78,nan,1324,1058,266,0,550,3,10,540,268,272
05W201,nan,05,Spandau,201,W,2,78,nan,1327,1016,311,0,692,3,4,688,382,306
05W202,nan,05,Spandau,202,W,2,78,nan,1482,1220,262,0,779,1,11,768,404,364
05W203,nan,05,Spandau,203,W,2,78,nan,1245,1087,158,0,584,1,7,577,360,217
05W204,nan,05,Spandau,204,W,2,78,nan,958,795,163,0,445,0,5,440,298,142
05W205,nan,05,Spandau,205,W,2,78,nan,1021,798,223,0,474,0,6,468,284,184
05W206,nan,05,Spandau,206,W,2,78,nan,1371,1055,316,0,648,1,4,644,396,248
05W207,nan,05,Spandau,207,W,2,78,nan,1075,905,170,0,413,0,4,409,245,164
05W208,nan,05,Spandau,208,W,2,78,nan,1134,979,155,0,546,0,13,533,290,243
05W209,nan,05,Spandau,209,W,2,78,nan,1052,783,269,0,482,1,2,480,215,265
05W210,nan,05,Spandau,210,W,2,78,nan,1220,1046,174,0,544,3,7,537,308,229
05W211,nan,05,Spandau,211,W,2,78,nan,1543,1287,256,0,837,3,13,824,434,390
05W212,nan,05,Spandau,212,W,2,78,nan,909,739,169,1,478,0,9,469,298,171
05W213,nan,05,Spandau,213,W,2,78,nan,1033,786,247,0,603,0,0,603,218,385
05W214,nan,05,Spandau,214,W,2,78,nan,808,713,95,0,343,1,11,332,195,137
05W215,nan,05,Spandau,215,W,2,78,nan,1601,1291,310,0,673,2,12,661,389,272
05W216,nan,05,Spandau,216,W,2,78,nan,1588,1172,416,0,752,0,14,738,407,331
05W217,nan,05,Spandau,217,W,2,78,nan,881,697,184,0,458,1,10,448,291,157
05W218,nan,05,Spandau,218,W,2,78,nan,1011,811,200,0,555,0,9,546,285,261
05W219,nan,05,Spandau,219,W,2,78,nan,1250,990,260,0,659,0,3,656,355,301
05W220,nan,05,Spandau,220,W,2,78,nan,1061,780,281,0,473,1,10,463,311,152
05W221,nan,05,Spandau,221,W,2,78,nan,849,641,208,0,464,3,14,450,275,175
05W222,nan,05,Spandau,222,W,2,78,nan,865,675,190,0,436,0,3,433,248,185
05W223,nan,05,Spandau,223,W,2,78,nan,1125,898,227,0,566,1,6,560,342,218
05W224,nan,05,Spandau,224,W,2,78,nan,958,776,182,0,415,1,5,410,247,163
05W225,nan,05,Spandau,225,W,2,78,nan,999,849,150,0,491,1,8,483,233,250
05W226,nan,05,Spandau,226,W,2,78,nan,906,650,255,1,530,1,4,526,393,133
05W227,nan,05,Spandau,227,W,2,78,nan,1298,984,314,0,502,0,4,498,276,222
05W301,nan,05,Spandau,301,W,3,78,nan,1015,739,276,0,498,0,10,488,300,188
05W302,nan,05,Spandau,302,W,3,78,nan,929,774,155,0,451,1,11,440,332,108
05W303,nan,05,Spandau,303,W,3,78,nan,970,588,382,0,435,1,4,431,281,150
05W304,nan,05,Spandau,304,W,3,78,nan,1556,1124,432,0,822,4,11,811,175,636
05W305,nan,05,Spandau,305,W,3,78,nan,1044,941,103,0,614,6,4,610,367,243
05W306,nan,05,Spandau,306,W,3,78,nan,901,595,306,0,406,3,2,404,277,127
05W307,nan,05,Spandau,307,W,3,78,nan,1345,1113,232,0,631,2,12,619,352,267
05W308,nan,05,Spandau,308,W,3,78,nan,1228,954,274,0,614,0,11,603,321,282
05W309,nan,05,Spandau,309,W,3,78,nan,1364,1078,286,0,654,2,2,652,421,231
05W310,nan,05,Spandau,310,W,3,78,nan,1270,1013,257,0,638,2,12,626,438,188
05W311,nan,05,Spandau,311,W,3,78,nan,1201,939,261,1,621,5,5,616,417,199
05W312,nan,05,Spandau,312,W,3,78,nan,970,733,237,0,480,1,9,471,323,148
05W313,nan,05,Spandau,313,W,3,78,nan,1390,1096,294,0,662,2,6,656,434,222
05W314,nan,05,Spandau,314,W,3,78,nan,1225,948,277,0,633,4,5,628,412,216
05W315,nan,05,Spandau,315,W,3,78,nan,1128,754,374,0,636,2,6,630,302,328
05W316,nan,05,Spandau,316,W,3,78,nan,1365,1061,304,0,673,0,9,664,452,212
05W317,nan,05,Spandau,317,W,3,78,nan,1121,970,151,0,567,0,6,561,342,219
05W318,nan,05,Spandau,318,W,3,78,nan,1225,945,280,0,648,1,14,634,453,181
05W319,nan,05,Spandau,319,W,3,78,nan,670,603,67,0,351,0,14,337,252,85
05W320,nan,05,Spandau,320,W,3,78,nan,1016,825,191,0,505,5,3,502,329,173
05W321,nan,05,Spandau,321,W,3,78,nan,1169,910,259,0,561,4,11,550,371,179
05W322,nan,05,Spandau,322,W,3,78,nan,1161,934,227,0,588,3,15,573,392,181
05W323,nan,05,Spandau,323,W,3,78,nan,909,668,241,0,416,2,3,413,256,157
05W324,nan,05,Spandau,324,W,3,78,nan,887,738,149,0,479,1,3,476,326,150
05W325,nan,05,Spandau,325,W,3,78,nan,1290,1000,290,0,669,2,11,658,403,255
05W326,nan,05,Spandau,326,W,3,78,nan,1096,802,294,0,470,1,11,459,313,146
05W327,nan,05,Spandau,327,W,3,78,nan,1049,842,207,0,591,1,6,585,379,206
05W328,nan,05,Spandau,328,W,3,78,nan,1243,929,314,0,632,2,9,623,456,167
05W329,nan,05,Spandau,329,W,3,78,nan,1020,783,237,0,472,3,6,466,342,124
05W401,nan,05,Spandau,401,W,4,78,nan,1026,710,316,0,560,4,4,556,171,385
05W402,nan,05,Spandau,402,W,4,78,nan,725,496,229,0,383,2,0,383,125,258
05W403,nan,05,Spandau,403,W,4,78,nan,958,683,275,0,540,1,5,535,142,393
05W404,nan,05,Spandau,404,W,4,78,nan,1027,846,181,0,627,2,6,621,330,291
05W405,nan,05,Spandau,405,W,4,78,nan,1083,759,324,0,600,1,5,595,242,353
05W406,nan,05,Spandau,406,W,4,78,nan,1106,779,327,0,520,1,3,517,322,195
05W407,nan,05,Spandau,407,W,4,78,nan,968,645,323,0,508,1,3,505,265,240
05W408,nan,05,Spandau,408,W,4,78,nan,952,851,101,0,421,1,14,407,279,128
05W409,nan,05,Spandau,409,W,4,78,nan,1133,835,298,0,639,3,8,631,384,247
05W410,nan,05,Spandau,410,W,4,78,nan,1442,1134,308,0,682,2,7,675,342,333
05W411,nan,05,Spandau,411,W,4,78,nan,1055,883,172,0,590,4,8,582,403,179
05W412,nan,05,Spandau,412,W,4,78,nan,1399,1119,280,0,717,0,10,707,479,228
05W413,nan,05,Spandau,413,W,4,78,nan,1528,1182,346,0,765,3,20,745,422,323
05W414,nan,05,Spandau,414,W,4,78,nan,860,708,152,0,443,0,5,438,312,126
05W415,nan,05,Spandau,415,W,4,78,nan,1411,1140,271,0,628,2,9,619,441,178
05W416,nan,05,Spandau,416,W,4,78,nan,1247,799,448,0,596,2,4,592,137,455
05W417,nan,05,Spandau,417,W,4,78,nan,1372,979,393,0,766,8,7,759,410,349
05W418,nan,05,Spandau,418,W,4,78,nan,805,621,184,0,324,0,7,317,182,135
05W419,nan,05,Spandau,419,W,4,78,nan,1096,797,299,0,618,1,8,610,161,449
05W420,nan,05,Spandau,420,W,4,78,nan,1122,706,416,0,559,2,4,555,111,444
05W421,nan,05,Spandau,421,W,4,78,nan,1300,1113,187,0,601,0,10,591,427,164
05W422,nan,05,Spandau,422,W,4,78,nan,1035,915,120,0,471,1,8,463,343,120
05W423,nan,05,Spandau,423,W,4,78,nan,897,686,211,0,467,0,3,464,197,267
05W424,nan,05,Spandau,424,W,4,78,nan,1387,1081,306,0,685,2,16,669,311,358
05W425,nan,05,Spandau,425,W,4,78,nan,1420,1093,327,0,799,5,8,791,416,375
05W426,nan,05,Spandau,426,W,4,78,nan,1117,897,220,0,703,2,5,698,427,271
05W427,nan,05,Spandau,427,W,4,78,nan,888,768,120,0,421,3,7,414,283,131
05W428,nan,05,Spandau,428,W,4,78,nan,1117,820,297,0,641,0,10,631,245,386
05W429,nan,05,Spandau,429,W,4,78,nan,945,709,236,0,528,1,6,522,234,288
05W501,nan,05,Spandau,501,W,5,78,nan,1130,834,296,0,545,2,17,528,359,169
05W502,nan,05,Spandau,502,W,5,78,nan,1216,922,294,0,653,3,13,640,431,209
05W503,nan,05,Spandau,503,W,5,78,nan,837,521,316,0,454,5,11,443,266,177
05W504,nan,05,Spandau,504,W,5,78,nan,958,651,307,0,526,4,10,516,329,187
05W505,nan,05,Spandau,505,W,5,78,nan,1127,622,505,0,452,1,16,436,275,161
05W506,nan,05,Spandau,506,W,5,78,nan,1137,792,345,0,642,3,14,628,378,250
05W507,nan,05,Spandau,507,W,5,78,nan,1007,719,288,0,576,0,8,568,368,200
05W508,nan,05,Spandau,508,W,5,78,nan,941,611,330,0,508,3,10,498,328,170
05W509,nan,05,Spandau,509,W,5,78,nan,1142,780,362,0,596,2,10,586,402,184
05W510,nan,05,Spandau,510,W,5,78,nan,985,672,313,0,585,7,4,581,408,173
05W511,nan,05,Spandau,511,W,5,78,nan,948,591,357,0,505,3,10,495,332,163
05W512,nan,05,Spandau,512,W,5,78,nan,923,584,339,0,494,0,13,481,314,167
05W513,nan,05,Spandau,513,W,5,78,nan,1421,1074,347,0,924,1,9,915,620,295
05W514,nan,05,Spandau,514,W,5,78,nan,1140,945,195,0,479,0,13,466,346,120
05W515,nan,05,Spandau,515,W,5,78,nan,1116,711,405,0,549,5,15,534,352,182
05W516,nan,05,Spandau,516,W,5,78,nan,1204,820,384,0,643,8,7,636,454,182
05W517,nan,05,Spandau,517,W,5,78,nan,1071,830,241,0,554,5,14,540,393,147
05W518,nan,05,Spandau,518,W,5,78,nan,927,575,352,0,508,1,6,502,345,157
05W519,nan,05,Spandau,519,W,5,78,nan,1065,770,295,0,506,0,5,501,330,171
05W520,nan,05,Spandau,520,W,5,78,nan,1252,971,281,0,580,3,17,563,412,151
05W521,nan,05,Spandau,521,W,5,78,nan,1274,1088,186,0,558,1,9,549,394,155
05W522,nan,05,Spandau,522,W,5,78,nan,1023,638,385,0,537,1,7,530,333,197
05W523,nan,05,Spandau,523,W,5,78,nan,1508,1060,448,0,921,8,11,910,632,278
05W524,nan,05,Spandau,524,W,5,78,nan,1030,669,361,0,579,2,5,574,355,219
05W525,nan,05,Spandau,525,W,5,78,nan,825,512,313,0,429,3,14,415,250,165
05W526,nan,05,Spandau,526,W,5,78,nan,1212,847,365,0,645,6,11,634,429,205
05W527,nan,05,Spandau,527,W,5,78,nan,1513,1306,207,0,555,0,27,528,375,153
05W528,nan,05,Spandau,528,W,5,78,nan,908,658,250,0,491,1,6,485,336,149
05W529,nan,05,Spandau,529,W,5,78,nan,900,580,320,0,469,7,4,465,323,142
05W530,nan,05,Spandau,530,W,5,78,nan,1057,827,230,0,561,1,12,549,372,177
06W101,nan,06,Steglitz-Zehlendorf,101,W,1,79,nan,1857,1104,753,0,867,0,13,854,536,318
06W102,nan,06,Steglitz-Zehlendorf,102,W,1,79,nan,1752,1060,692,0,851,0,18,833,502,331
06W103,nan,06,Steglitz-Zehlendorf,103,W,1,79,nan,1800,1269,531,0,934,0,18,916,582,334
06W104,nan,06,Steglitz-Zehlendorf,104,W,1,79,nan,1991,1323,668,0,1045,0,26,1019,573,446
06W105,nan,06,Steglitz-Zehlendorf,105,W,1,79,nan,1589,1101,488,0,813,0,15,798,550,248
06W106,nan,06,Steglitz-Zehlendorf,106,W,1,79,nan,1675,1131,544,0,771,0,10,761,449,312
06W107,nan,06,Steglitz-Zehlendorf,107,W,1,79,nan,1848,1291,557,0,992,0,21,971,616,355
06W108,nan,06,Steglitz-Zehlendorf,108,W,1,79,nan,1960,1199,761,0,906,0,7,899,542,357
06W109,nan,06,Steglitz-Zehlendorf,109,W,1,79,nan,1943,1230,713,0,940,0,19,921,531,390
06W110,nan,06,Steglitz-Zehlendorf,110,W,1,79,nan,1808,1134,674,0,873,10,26,847,545,302
06W111,nan,06,Steglitz-Zehlendorf,111,W,1,79,nan,1888,1368,520,0,939,0,23,916,598,318
06W112,nan,06,Steglitz-Zehlendorf,112,W,1,79,nan,1619,1092,527,0,858,7,21,837,508,329
06W113,nan,06,Steglitz-Zehlendorf,113,W,1,79,nan,1825,1292,533,0,798,0,11,787,516,271
06W114,nan,06,Steglitz-Zehlendorf,114,W,1,79,nan,1835,1179,656,0,867,0,19,848,545,303
06W115,nan,06,Steglitz-Zehlendorf,115,W,1,79,nan,1536,1033,503,0,766,0,18,748,458,290
06W116,nan,06,Steglitz-Zehlendorf,116,W,1,79,nan,1969,1244,725,0,964,0,13,951,551,400
06W117,nan,06,Steglitz-Zehlendorf,117,W,1,79,nan,1723,1021,702,0,803,0,13,790,526,264
06W118,nan,06,Steglitz-Zehlendorf,118,W,1,79,nan,1765,1111,654,0,840,0,21,819,512,307
06W201,nan,06,Steglitz-Zehlendorf,201,W,2,79,nan,1906,1325,581,0,1027,0,32,995,581,414
06W202,nan,06,Steglitz-Zehlendorf,202,W,2,79,nan,1712,1194,518,0,876,0,19,857,541,316
06W203,nan,06,Steglitz-Zehlendorf,203,W,2,79,nan,1919,1337,582,0,928,0,25,903,577,326
06W204,nan,06,Steglitz-Zehlendorf,204,W,2,79,nan,1663,1160,503,0,890,0,18,872,524,348
06W205,nan,06,Steglitz-Zehlendorf,205,W,2,79,nan,1704,1136,568,0,755,0,18,737,459,278
06W206,nan,06,Steglitz-Zehlendorf,206,W,2,79,nan,1612,1014,598,0,698,0,13,685,451,234
06W207,nan,06,Steglitz-Zehlendorf,207,W,2,79,nan,1535,1082,453,0,738,0,12,726,424,302
06W208,nan,06,Steglitz-Zehlendorf,208,W,2,79,nan,1557,1129,428,0,808,0,11,797,562,235
06W209,nan,06,Steglitz-Zehlendorf,209,W,2,79,nan,1867,1174,693,0,821,0,14,807,528,279
06W210,nan,06,Steglitz-Zehlendorf,210,W,2,79,nan,1716,1047,669,0,764,0,18,746,459,287
06W211,nan,06,Steglitz-Zehlendorf,211,W,2,79,nan,1687,1011,676,0,731,0,13,718,464,254
06W212,nan,06,Steglitz-Zehlendorf,212,W,2,79,nan,1881,1256,625,0,837,0,18,819,546,273
06W213,nan,06,Steglitz-Zehlendorf,213,W,2,79,nan,2074,1475,599,0,1031,0,27,1004,633,371
06W214,nan,06,Steglitz-Zehlendorf,214,W,2,79,nan,1940,1379,561,0,1008,0,20,988,606,382
06W215,nan,06,Steglitz-Zehlendorf,215,W,2,79,nan,1718,1248,470,0,904,0,17,887,586,301
06W216,nan,06,Steglitz-Zehlendorf,216,W,2,79,nan,1639,1113,526,0,819,0,17,802,508,294
06W217,nan,06,Steglitz-Zehlendorf,217,W,2,79,nan,1944,1362,582,0,1077,0,16,1061,674,387
06W218,nan,06,Steglitz-Zehlendorf,218,W,2,79,nan,1634,1074,560,0,658,0,10,648,447,201
06W301,nan,06,Steglitz-Zehlendorf,301,W,3,79,nan,1886,1188,698,0,939,0,17,922,548,374
06W302,nan,06,Steglitz-Zehlendorf,302,W,3,79,nan,1748,1035,713,0,828,0,18,810,481,329
06W303,nan,06,Steglitz-Zehlendorf,303,W,3,79,nan,1829,1270,559,0,968,0,15,953,609,344
06W304,nan,06,Steglitz-Zehlendorf,304,W,3,79,nan,1841,1151,690,0,957,0,17,940,552,388
06W305,nan,06,Steglitz-Zehlendorf,305,W,3,79,nan,1616,986,630,0,810,0,16,794,462,332
06W306,nan,06,Steglitz-Zehlendorf,306,W,3,79,nan,1973,1206,767,0,889,0,15,874,555,319
06W307,nan,06,Steglitz-Zehlendorf,307,W,3,79,nan,1729,1043,686,0,762,0,19,743,482,261
06W308,nan,06,Steglitz-Zehlendorf,308,W,3,79,nan,1743,1006,737,0,864,0,16,848,557,291
06W309,nan,06,Steglitz-Zehlendorf,309,W,3,79,nan,1828,1126,702,0,865,0,22,843,532,311
06W310,nan,06,Steglitz-Zehlendorf,310,W,3,79,nan,1768,1141,627,0,914,0,9,905,543,362
06W311,nan,06,Steglitz-Zehlendorf,311,W,3,79,nan,1749,1135,614,0,887,0,10,877,582,295
06W312,nan,06,Steglitz-Zehlendorf,312,W,3,79,nan,1810,1057,753,0,917,0,19,898,578,320
06W313,nan,06,Steglitz-Zehlendorf,313,W,3,79,nan,1788,1114,674,0,879,0,17,862,581,281
06W314,nan,06,Steglitz-Zehlendorf,314,W,3,79,nan,2729,1801,928,0,1424,0,18,1406,966,440
06W315,nan,06,Steglitz-Zehlendorf,315,W,3,79,nan,1658,963,695,0,795,0,16,779,539,240
06W316,nan,06,Steglitz-Zehlendorf,316,W,3,79,nan,1935,1309,626,0,972,0,23,949,647,302
06W317,nan,06,Steglitz-Zehlendorf,317,W,3,79,nan,1936,1376,560,0,858,0,17,841,600,241
06W318,nan,06,Steglitz-Zehlendorf,318,W,3,79,nan,2032,1258,774,0,898,0,34,864,609,255
06W401,nan,06,Steglitz-Zehlendorf,401,W,4,79,nan,1895,1299,596,0,994,0,23,971,649,322
06W402,nan,06,Steglitz-Zehlendorf,402,W,4,79,nan,1661,1096,565,0,801,0,20,781,538,243
06W403,nan,06,Steglitz-Zehlendorf,403,W,4,79,nan,1628,1046,582,0,729,0,16,713,468,245
06W404,nan,06,Steglitz-Zehlendorf,404,W,4,79,nan,1982,1284,698,0,1029,0,16,1013,664,349
06W405,nan,06,Steglitz-Zehlendorf,405,W,4,79,nan,1780,1157,623,0,940,0,17,923,599,324
06W406,nan,06,Steglitz-Zehlendorf,406,W,4,79,nan,1938,1247,691,0,941,0,34,907,598,309
06W407,nan,06,Steglitz-Zehlendorf,407,W,4,79,nan,1946,1332,614,0,926,0,20,906,614,292
06W408,nan,06,Steglitz-Zehlendorf,408,W,4,79,nan,1814,1096,718,0,864,0,19,845,546,299
06W409,nan,06,Steglitz-Zehlendorf,409,W,4,79,nan,1776,1152,624,0,834,0,16,818,593,225
06W410,nan,06,Steglitz-Zehlendorf,410,W,4,79,nan,1638,1213,425,0,864,0,23,841,583,258
06W411,nan,06,Steglitz-Zehlendorf,411,W,4,79,nan,1695,1149,546,0,877,0,11,866,612,254
06W412,nan,06,Steglitz-Zehlendorf,412,W,4,79,nan,1473,1080,393,0,805,0,16,789,562,227
06W413,nan,06,Steglitz-Zehlendorf,413,W,4,79,nan,1749,1176,573,0,787,0,21,766,528,238
06W414,nan,06,Steglitz-Zehlendorf,414,W,4,79,nan,1596,1338,258,0,720,0,26,694,507,187
06W415,nan,06,Steglitz-Zehlendorf,415,W,4,79,nan,1578,1143,435,0,727,0,14,713,493,220
06W416,nan,06,Steglitz-Zehlendorf,416,W,4,79,nan,1773,1074,699,0,777,0,9,768,517,251
06W417,nan,06,Steglitz-Zehlendorf,417,W,4,79,nan,1676,1050,626,0,859,0,18,841,584,257
06W501,nan,06,Steglitz-Zehlendorf,501,W,5,79,nan,1779,1178,601,0,788,0,18,770,501,269
06W502,nan,06,Steglitz-Zehlendorf,502,W,5,79,nan,1639,1241,398,0,860,0,25,835,581,254
06W503,nan,06,Steglitz-Zehlendorf,503,W,5,79,nan,1385,906,479,0,663,0,9,654,418,236
06W504,nan,06,Steglitz-Zehlendorf,504,W,5,79,nan,1489,963,526,0,755,0,23,732,499,233
06W505,nan,06,Steglitz-Zehlendorf,505,W,5,79,nan,1838,1151,687,0,953,0,25,928,580,348
06W506,nan,06,Steglitz-Zehlendorf,506,W,5,79,nan,1676,1114,562,0,725,0,12,713,501,212
06W507,nan,06,Steglitz-Zehlendorf,507,W,5,79,nan,1686,1299,387,0,863,0,17,846,602,244
06W508,nan,06,Steglitz-Zehlendorf,508,W,5,79,nan,1839,1304,535,0,867,0,23,844,617,227
06W509,nan,06,Steglitz-Zehlendorf,509,W,5,79,nan,1733,1139,594,0,849,0,20,829,632,197
06W510,nan,06,Steglitz-Zehlendorf,510,W,5,79,nan,1946,1430,516,0,1071,0,24,1047,733,314
06W511,nan,06,Steglitz-Zehlendorf,511,W,5,79,nan,1561,991,570,0,726,0,11,715,468,247
06W512,nan,06,Steglitz-Zehlendorf,512,W,5,79,nan,1518,1194,324,0,715,0,17,698,463,235
06W513,nan,06,Steglitz-Zehlendorf,513,W,5,79,nan,1998,1488,510,0,1018,0,8,1010,746,264
06W514,nan,06,Steglitz-Zehlendorf,514,W,5,79,nan,1834,1165,669,0,966,0,17,949,625,324
06W515,nan,06,Steglitz-Zehlendorf,515,W,5,79,nan,1580,1033,547,0,816,0,12,804,512,292
06W516,nan,06,Steglitz-Zehlendorf,516,W,5,79,nan,1778,1382,396,0,769,0,19,750,535,215
06W517,nan,06,Steglitz-Zehlendorf,517,W,5,79,nan,1694,1196,498,0,661,0,10,651,472,179
06W518,nan,06,Steglitz-Zehlendorf,518,W,5,79,nan,1686,1289,397,0,768,0,20,748,543,205
06W601,nan,06,Steglitz-Zehlendorf,601,W,6,79,nan,1335,777,558,0,635,0,8,627,373,254
06W602,nan,06,Steglitz-Zehlendorf,602,W,6,79,nan,1530,978,552,0,800,0,9,791,521,270
06W603,nan,06,Steglitz-Zehlendorf,603,W,6,79,nan,1506,943,563,0,741,0,16,725,457,268
06W604,nan,06,Steglitz-Zehlendorf,604,W,6,79,nan,1822,1074,748,0,901,0,13,888,465,423
06W605,nan,06,Steglitz-Zehlendorf,605,W,6,79,nan,1664,1116,548,0,922,0,8,914,608,306
06W606,nan,06,Steglitz-Zehlendorf,606,W,6,79,nan,1231,720,511,0,538,0,3,535,411,124
06W607,nan,06,Steglitz-Zehlendorf,607,W,6,79,nan,1475,814,661,0,669,0,4,665,451,214
06W608,nan,06,Steglitz-Zehlendorf,608,W,6,79,nan,2022,1275,747,0,1037,0,19,1018,714,304
06W609,nan,06,Steglitz-Zehlendorf,609,W,6,79,nan,1755,1052,703,0,889,0,18,871,522,349
06W610,nan,06,Steglitz-Zehlendorf,610,W,6,79,nan,1155,622,533,0,539,0,7,532,392,140
06W611,nan,06,Steglitz-Zehlendorf,611,W,6,79,nan,1530,963,567,0,761,0,15,746,478,268
06W612,nan,06,Steglitz-Zehlendorf,612,W,6,79,nan,1840,1197,643,0,906,8,16,890,577,313
06W613,nan,06,Steglitz-Zehlendorf,613,W,6,79,nan,1751,939,812,0,832,0,14,818,453,365
06W614,nan,06,Steglitz-Zehlendorf,614,W,6,79,nan,1916,1154,762,0,902,0,22,880,553,327
06W615,nan,06,Steglitz-Zehlendorf,615,W,6,79,nan,1746,1119,627,0,783,0,16,767,523,244
06W616,nan,06,Steglitz-Zehlendorf,616,W,6,79,nan,1962,1350,612,0,1052,0,23,1029,687,342
06W617,nan,06,Steglitz-Zehlendorf,617,W,6,79,nan,1775,1278,497,0,978,0,22,956,677,279
06W618,nan,06,Steglitz-Zehlendorf,618,W,6,79,nan,1749,1071,678,0,818,0,16,802,509,293
06W619,nan,06,Steglitz-Zehlendorf,619,W,6,79,nan,1459,955,504,0,754,0,39,715,449,266
06W701,nan,06,Steglitz-Zehlendorf,701,W,7,79,nan,1638,1040,598,0,863,0,14,849,577,272
06W702,nan,06,Steglitz-Zehlendorf,702,W,7,79,nan,1992,1201,791,0,993,0,12,981,671,310
06W703,nan,06,Steglitz-Zehlendorf,703,W,7,79,nan,1422,883,539,0,666,0,4,662,449,213
06W704,nan,06,Steglitz-Zehlendorf,704,W,7,79,nan,1447,910,537,0,684,0,16,668,473,195
06W705,nan,06,Steglitz-Zehlendorf,705,W,7,79,nan,1442,805,637,0,592,0,4,588,393,195
06W706,nan,06,Steglitz-Zehlendorf,706,W,7,79,nan,1819,1085,734,0,931,0,15,916,617,299
06W707,nan,06,Steglitz-Zehlendorf,707,W,7,79,nan,1753,939,814,0,793,0,6,787,540,247
06W708,nan,06,Steglitz-Zehlendorf,708,W,7,79,nan,1331,874,457,0,661,0,18,643,415,228
06W709,nan,06,Steglitz-Zehlendorf,709,W,7,79,nan,1752,972,780,0,843,0,17,826,578,248
06W710,nan,06,Steglitz-Zehlendorf,710,W,7,79,nan,1728,1004,724,0,820,0,23,797,568,229
06W711,nan,06,Steglitz-Zehlendorf,711,W,7,79,nan,1714,1069,645,0,861,0,16,845,538,307
06W712,nan,06,Steglitz-Zehlendorf,712,W,7,79,nan,1611,1071,540,0,911,0,13,898,547,351
06W713,nan,06,Steglitz-Zehlendorf,713,W,7,79,nan,1586,903,683,0,773,0,12,761,520,241
06W714,nan,06,Steglitz-Zehlendorf,714,W,7,79,nan,1306,815,491,0,602,0,8,594,382,212
06W715,nan,06,Steglitz-Zehlendorf,715,W,7,79,nan,1480,850,630,0,708,0,10,698,464,234
06W716,nan,06,Steglitz-Zehlendorf,716,W,7,79,nan,1360,739,621,0,620,0,5,615,416,199
06W717,nan,06,Steglitz-Zehlendorf,717,W,7,79,nan,1166,770,396,0,613,0,15,598,397,201
06W718,nan,06,Steglitz-Zehlendorf,718,W,7,79,nan,1842,1192,650,0,948,0,23,925,645,280
06W719,nan,06,Steglitz-Zehlendorf,719,W,7,79,nan,1686,1031,655,0,832,0,23,809,502,307
07W101,nan,07,Tempelhof-Schöneberg,101,W,1,81,nan,1816,1273,543,0,728,6,19,709,546,163
07W102,nan,07,Tempelhof-Schöneberg,102,W,1,81,nan,1988,1400,588,0,868,3,13,855,583,272
07W103,nan,07,Tempelhof-Schöneberg,103,W,1,81,nan,1891,1457,434,0,912,9,23,889,568,321
07W104,nan,07,Tempelhof-Schöneberg,104,W,1,81,nan,1849,1436,413,0,887,4,31,856,489,367
07W105,nan,07,Tempelhof-Schöneberg,105,W,1,81,nan,1914,1311,603,0,852,8,14,838,554,284
07W106,nan,07,Tempelhof-Schöneberg,106,W,1,81,nan,1713,1145,568,0,820,16,16,804,485,319
07W107,nan,07,Tempelhof-Schöneberg,107,W,1,81,nan,1697,1060,637,0,818,9,19,799,418,381
07W108,nan,07,Tempelhof-Schöneberg,108,W,1,81,nan,1816,1380,436,0,859,5,12,847,507,340
07W109,nan,07,Tempelhof-Schöneberg,109,W,1,81,nan,1893,1183,710,0,876,13,18,858,500,358
07W110,nan,07,Tempelhof-Schöneberg,110,W,1,81,nan,2051,1429,622,0,1048,9,19,1029,657,372
07W111,nan,07,Tempelhof-Schöneberg,111,W,1,81,nan,1771,1210,561,0,931,6,31,900,525,375
07W112,nan,07,Tempelhof-Schöneberg,112,W,1,81,nan,2061,1301,760,0,1057,16,30,1027,513,514
07W113,nan,07,Tempelhof-Schöneberg,113,W,1,81,nan,1955,1334,621,0,1009,14,17,992,532,460
07W114,nan,07,Tempelhof-Schöneberg,114,W,1,81,nan,1792,1340,452,0,896,13,23,873,460,413
07W115,nan,07,Tempelhof-Schöneberg,115,W,1,81,nan,1738,1186,552,0,826,9,24,802,370,432
07W116,nan,07,Tempelhof-Schöneberg,116,W,1,81,nan,1976,1218,758,0,881,0,13,868,546,322
07W117,nan,07,Tempelhof-Schöneberg,117,W,1,81,nan,1935,1351,584,0,931,3,28,903,539,364
07W118,nan,07,Tempelhof-Schöneberg,118,W,1,81,nan,1942,1273,669,0,951,8,27,924,450,474
07W201,nan,07,Tempelhof-Schöneberg,201,W,2,81,nan,1899,1185,714,0,983,3,18,965,539,426
07W202,nan,07,Tempelhof-Schöneberg,202,W,2,81,nan,1950,1281,669,0,953,14,26,927,544,383
07W203,nan,07,Tempelhof-Schöneberg,203,W,2,81,nan,2016,1311,705,0,1087,15,23,1064,537,527
07W204,nan,07,Tempelhof-Schöneberg,204,W,2,81,nan,2004,1325,679,0,879,8,19,860,437,423
07W205,nan,07,Tempelhof-Schöneberg,205,W,2,81,nan,1782,1297,485,0,919,15,17,902,448,454
07W206,nan,07,Tempelhof-Schöneberg,206,W,2,81,nan,2217,1488,729,0,1041,9,18,1023,524,499
07W207,nan,07,Tempelhof-Schöneberg,207,W,2,81,nan,2263,1466,797,0,1114,19,25,1089,506,583
07W208,nan,07,Tempelhof-Schöneberg,208,W,2,81,nan,1934,1232,702,0,892,5,10,882,513,369
07W209,nan,07,Tempelhof-Schöneberg,209,W,2,81,nan,1751,1234,517,0,819,2,12,807,499,308
07W210,nan,07,Tempelhof-Schöneberg,210,W,2,81,nan,2052,1462,590,0,1089,14,30,1059,531,528
07W211,nan,07,Tempelhof-Schöneberg,211,W,2,81,nan,1999,1509,490,0,948,0,37,911,475,436
07W212,nan,07,Tempelhof-Schöneberg,212,W,2,81,nan,1423,979,444,0,779,12,18,761,296,465
07W213,nan,07,Tempelhof-Schöneberg,213,W,2,81,nan,1675,1077,598,0,818,12,20,798,338,460
07W214,nan,07,Tempelhof-Schöneberg,214,W,2,81,nan,1775,1159,616,0,834,11,19,815,371,444
07W215,nan,07,Tempelhof-Schöneberg,215,W,2,81,nan,2040,1480,560,0,932,9,30,902,510,392
07W216,nan,07,Tempelhof-Schöneberg,216,W,2,81,nan,2048,1506,542,0,953,4,16,937,608,329
07W217,nan,07,Tempelhof-Schöneberg,217,W,2,81,nan,1577,1197,380,0,717,12,21,696,452,244
07W301,nan,07,Tempelhof-Schöneberg,301,W,3,81,nan,1998,1218,780,0,943,11,13,930,493,437
07W302,nan,07,Tempelhof-Schöneberg,302,W,3,81,nan,1824,1244,580,0,1041,9,16,1025,532,493
07W303,nan,07,Tempelhof-Schöneberg,303,W,3,81,nan,1688,1057,631,0,851,12,16,835,425,410
07W304,nan,07,Tempelhof-Schöneberg,304,W,3,81,nan,1464,940,524,0,720,4,10,710,385,325
07W305,nan,07,Tempelhof-Schöneberg,305,W,3,81,nan,1857,1091,766,0,900,10,13,887,431,456
07W306,nan,07,Tempelhof-Schöneberg,306,W,3,81,nan,1761,1130,631,0,941,9,13,928,487,441
07W307,nan,07,Tempelhof-Schöneberg,307,W,3,81,nan,1945,1192,753,0,907,10,12,895,448,447
07W308,nan,07,Tempelhof-Schöneberg,308,W,3,81,nan,1726,1103,623,0,865,7,18,847,405,442
07W309,nan,07,Tempelhof-Schöneberg,309,W,3,81,nan,1680,1137,543,0,957,10,25,932,484,448
07W310,nan,07,Tempelhof-Schöneberg,310,W,3,81,nan,1868,1104,764,0,890,6,16,874,448,426
07W311,nan,07,Tempelhof-Schöneberg,311,W,3,81,nan,1686,1134,552,0,910,10,26,884,450,434
07W312,nan,07,Tempelhof-Schöneberg,312,W,3,81,nan,1441,1026,415,0,788,0,20,768,389,379
07W313,nan,07,Tempelhof-Schöneberg,313,W,3,81,nan,1833,1182,651,0,935,7,12,923,503,420
07W314,nan,07,Tempelhof-Schöneberg,314,W,3,81,nan,1698,1179,519,0,922,6,21,901,500,401
07W315,nan,07,Tempelhof-Schöneberg,315,W,3,81,nan,1936,1251,685,0,991,12,18,973,489,484
07W316,nan,07,Tempelhof-Schöneberg,316,W,3,81,nan,1956,1555,401,0,940,3,19,921,571,350
07W317,nan,07,Tempelhof-Schöneberg,317,W,3,81,nan,1846,1320,526,0,882,7,23,859,517,342
07W318,nan,07,Tempelhof-Schöneberg,318,W,3,81,nan,1798,1358,440,0,890,5,17,873,546,327
07W319,nan,07,Tempelhof-Schöneberg,319,W,3,81,nan,2087,1302,785,0,864,2,14,850,571,279
07W401,nan,07,Tempelhof-Schöneberg,401,W,4,81,nan,1764,1189,575,0,911,14,20,891,480,411
07W402,nan,07,Tempelhof-Schöneberg,402,W,4,81,nan,1874,1214,660,0,912,13,23,889,389,500
07W403,nan,07,Tempelhof-Schöneberg,403,W,4,81,nan,1995,1517,478,0,1071,8,33,1038,665,373
07W404,nan,07,Tempelhof-Schöneberg,404,W,4,81,nan,1764,1135,629,0,922,10,16,906,400,506
07W405,nan,07,Tempelhof-Schöneberg,405,W,4,81,nan,1924,1399,525,0,827,5,14,813,513,300
07W406,nan,07,Tempelhof-Schöneberg,406,W,4,81,nan,1979,1549,430,0,994,3,10,984,631,353
07W407,nan,07,Tempelhof-Schöneberg,407,W,4,81,nan,1804,1332,472,0,837,1,20,817,560,257
07W408,nan,07,Tempelhof-Schöneberg,408,W,4,81,nan,1918,1275,643,0,962,4,24,938,508,430
07W409,nan,07,Tempelhof-Schöneberg,409,W,4,81,nan,1922,1288,634,0,837,4,18,819,490,329
07W410,nan,07,Tempelhof-Schöneberg,410,W,4,81,nan,2189,1505,684,0,969,5,15,954,613,341
07W411,nan,07,Tempelhof-Schöneberg,411,W,4,81,nan,2056,1428,628,0,913,4,25,888,551,337
07W412,nan,07,Tempelhof-Schöneberg,412,W,4,81,nan,1864,1311,553,0,958,6,20,938,544,394
07W413,nan,07,Tempelhof-Schöneberg,413,W,4,81,nan,2000,1413,587,0,990,3,14,976,563,413
07W414,nan,07,Tempelhof-Schöneberg,414,W,4,81,nan,2123,1351,772,0,840,9,13,827,554,273
07W415,nan,07,Tempelhof-Schöneberg,415,W,4,81,nan,1887,1420,467,0,932,7,23,909,538,371
07W416,nan,07,Tempelhof-Schöneberg,416,W,4,81,nan,2310,1554,756,0,1051,3,27,1024,640,384
07W417,nan,07,Tempelhof-Schöneberg,417,W,4,81,nan,1691,1232,459,0,894,4,24,870,510,360
07W501,nan,07,Tempelhof-Schöneberg,501,W,5,81,nan,2320,1658,662,0,1084,12,22,1062,738,324
07W502,nan,07,Tempelhof-Schöneberg,502,W,5,81,nan,1937,1496,441,0,895,1,23,872,626,246
07W503,nan,07,Tempelhof-Schöneberg,503,W,5,81,nan,1857,1307,550,0,936,7,15,921,627,294
07W504,nan,07,Tempelhof-Schöneberg,504,W,5,81,nan,2195,1773,422,0,973,5,37,936,601,335
07W505,nan,07,Tempelhof-Schöneberg,505,W,5,81,nan,1971,1491,480,0,998,4,15,983,668,315
07W506,nan,07,Tempelhof-Schöneberg,506,W,5,81,nan,2096,1556,540,0,1061,5,23,1038,702,336
07W507,nan,07,Tempelhof-Schöneberg,507,W,5,81,nan,2131,1462,669,0,860,7,23,837,591,246
07W508,nan,07,Tempelhof-Schöneberg,508,W,5,81,nan,1908,1439,469,0,943,4,13,930,632,298
07W509,nan,07,Tempelhof-Schöneberg,509,W,5,81,nan,1987,1413,574,0,952,2,12,940,675,265
07W510,nan,07,Tempelhof-Schöneberg,510,W,5,81,nan,1746,1180,566,0,754,9,13,741,537,204
07W511,nan,07,Tempelhof-Schöneberg,511,W,5,81,nan,1830,1386,444,0,867,7,20,847,594,253
07W512,nan,07,Tempelhof-Schöneberg,512,W,5,81,nan,1657,1288,369,0,820,2,21,799,587,212
07W513,nan,07,Tempelhof-Schöneberg,513,W,5,81,nan,1928,1397,531,0,798,2,21,777,553,224
07W514,nan,07,Tempelhof-Schöneberg,514,W,5,81,nan,2155,1530,625,0,1012,7,32,980,660,320
07W515,nan,07,Tempelhof-Schöneberg,515,W,5,81,nan,1952,1540,412,0,893,0,9,884,646,238
07W516,nan,07,Tempelhof-Schöneberg,516,W,5,81,nan,2116,1525,591,0,1106,1,26,1080,755,325
07W517,nan,07,Tempelhof-Schöneberg,517,W,5,81,nan,2013,1325,688,0,1010,2,14,996,676,320
07W601,nan,07,Tempelhof-Schöneberg,601,W,6,81,nan,1928,1377,551,0,922,7,31,891,588,303
07W602,nan,07,Tempelhof-Schöneberg,602,W,6,81,nan,2228,1609,619,0,1199,3,39,1160,799,361
07W603,nan,07,Tempelhof-Schöneberg,603,W,6,81,nan,2110,1422,688,0,1078,3,17,1061,711,350
07W604,nan,07,Tempelhof-Schöneberg,604,W,6,81,nan,2127,1291,836,0,951,1,13,938,655,283
07W605,nan,07,Tempelhof-Schöneberg,605,W,6,81,nan,2020,1486,534,0,951,4,19,932,680,252
07W606,nan,07,Tempelhof-Schöneberg,606,W,6,81,nan,1738,1227,511,0,997,1,17,980,624,356
07W607,nan,07,Tempelhof-Schöneberg,607,W,6,81,nan,2031,1474,557,0,1075,1,27,1048,740,308
07W608,nan,07,Tempelhof-Schöneberg,608,W,6,81,nan,1140,812,328,0,577,4,13,564,438,126
07W609,nan,07,Tempelhof-Schöneberg,609,W,6,81,nan,2582,1926,656,0,1140,4,26,1114,808,306
07W610,nan,07,Tempelhof-Schöneberg,610,W,6,81,nan,1329,848,481,0,449,1,13,436,336,100
07W611,nan,07,Tempelhof-Schöneberg,611,W,6,81,nan,2033,1595,438,0,1025,2,16,1009,734,275
07W612,nan,07,Tempelhof-Schöneberg,612,W,6,81,nan,1555,1238,317,0,711,2,17,694,523,171
07W613,nan,07,Tempelhof-Schöneberg,613,W,6,81,nan,2129,1723,406,0,941,0,26,915,678,237
07W614,nan,07,Tempelhof-Schöneberg,614,W,6,81,nan,2176,1619,557,0,1034,5,8,1026,752,274
07W615,nan,07,Tempelhof-Schöneberg,615,W,6,81,nan,1778,1229,549,0,865,3,18,847,597,250
07W616,nan,07,Tempelhof-Schöneberg,616,W,6,81,nan,2280,1426,854,0,1055,6,19,1036,727,309
07W617,nan,07,Tempelhof-Schöneberg,617,W,6,81,nan,1931,1238,693,0,1033,4,10,1023,711,312
07W701,nan,07,Tempelhof-Schöneberg,701,W,7,81,nan,1973,1354,619,0,1052,11,16,1036,747,289
07W702,nan,07,Tempelhof-Schöneberg,702,W,7,81,nan,2010,1346,664,0,1049,1,24,1025,746,279
07W703,nan,07,Tempelhof-Schöneberg,703,W,7,81,nan,2120,1462,658,0,1161,4,34,1127,858,269
07W704,nan,07,Tempelhof-Schöneberg,704,W,7,81,nan,2318,1615,703,0,1105,4,27,1078,777,301
07W705,nan,07,Tempelhof-Schöneberg,705,W,7,81,nan,1883,1335,548,0,951,2,13,938,697,241
07W706,nan,07,Tempelhof-Schöneberg,706,W,7,81,nan,1790,1190,600,0,826,2,12,814,566,248
07W707,nan,07,Tempelhof-Schöneberg,707,W,7,81,nan,1962,1289,673,0,977,1,18,959,693,266
07W708,nan,07,Tempelhof-Schöneberg,708,W,7,81,nan,2037,1553,484,0,1005,0,34,971,735,236
07W709,nan,07,Tempelhof-Schöneberg,709,W,7,81,nan,1823,1213,610,0,934,5,17,917,647,270
07W710,nan,07,Tempelhof-Schöneberg,710,W,7,81,nan,1784,1260,524,0,787,2,20,767,604,163
07W711,nan,07,Tempelhof-Schöneberg,711,W,7,81,nan,1527,1100,427,0,698,6,11,687,519,168
07W712,nan,07,Tempelhof-Schöneberg,712,W,7,81,nan,1899,1296,603,0,854,4,17,837,650,187
07W713,nan,07,Tempelhof-Schöneberg,713,W,7,81,nan,1753,1243,510,0,797,4,24,773,567,206
07W714,nan,07,Tempelhof-Schöneberg,714,W,7,81,nan,1686,1273,413,0,793,3,20,773,598,175
07W715,nan,07,Tempelhof-Schöneberg,715,W,7,81,nan,1734,1232,502,0,913,7,12,901,664,237
07W716,nan,07,Tempelhof-Schöneberg,716,W,7,81,nan,1470,1000,470,0,723,2,10,713,513,200
07W717,nan,07,Tempelhof-Schöneberg,717,W,7,81,nan,1641,1046,595,0,801,7,13,788,563,225
07W718,nan,07,Tempelhof-Schöneberg,718,W,7,81,nan,1704,1149,555,0,854,3,10,844,642,202
08W101,nan,08,Neukölln,101,W,1,82,nan,1040,693,347,0,503,8,22,481,186,295
08W102,nan,08,Neukölln,102,W,1,82,nan,1128,744,384,0,549,12,21,528,219,309
08W103,nan,08,Neukölln,103,W,1,82,nan,1347,882,465,0,656,17,27,629,269,360
08W104,nan,08,Neukölln,104,W,1,82,nan,1260,896,364,0,592,10,2,590,257,333
08W105,nan,08,Neukölln,105,W,1,82,nan,1188,795,393,0,571,4,17,554,241,313
08W106,nan,08,Neukölln,106,W,1,82,nan,1221,810,411,0,609,8,36,573,213,360
08W107,nan,08,Neukölln,107,W,1,82,nan,1427,1035,392,0,646,5,26,620,251,369
08W108,nan,08,Neukölln,108,W,1,82,nan,1054,792,262,0,568,8,6,562,196,366
08W109,nan,08,Neukölln,109,W,1,82,nan,1160,869,291,0,616,1,15,601,242,359
08W110,nan,08,Neukölln,110,W,1,82,nan,1131,798,333,0,526,6,17,509,219,290
08W111,nan,08,Neukölln,111,W,1,82,nan,1008,727,281,0,464,4,28,436,196,240
08W112,nan,08,Neukölln,112,W,1,82,nan,1401,988,413,0,577,5,20,557,256,301
08W113,nan,08,Neukölln,113,W,1,82,nan,1446,1056,390,0,715,5,18,697,294,403
08W114,nan,08,Neukölln,114,W,1,82,nan,1159,830,329,0,573,4,16,557,227,330
08W115,nan,08,Neukölln,115,W,1,82,nan,1134,808,326,0,583,7,13,570,232,338
08W116,nan,08,Neukölln,116,W,1,82,nan,842,571,271,0,349,10,9,340,224,116
08W117,nan,08,Neukölln,117,W,1,82,nan,1228,908,320,0,518,5,27,491,251,240
08W118,nan,08,Neukölln,118,W,1,82,nan,1481,1032,449,0,713,7,19,694,274,420
08W119,nan,08,Neukölln,119,W,1,82,nan,1241,928,313,0,652,7,21,631,263,368
08W120,nan,08,Neukölln,120,W,1,82,nan,1198,886,312,0,601,5,21,580,299,281
08W121,nan,08,Neukölln,121,W,1,82,nan,1184,931,253,0,529,8,11,518,289,229
08W122,nan,08,Neukölln,122,W,1,82,nan,1432,1164,268,0,592,6,19,573,264,309
08W123,nan,08,Neukölln,123,W,1,82,nan,1478,1087,391,0,729,13,22,707,302,405
08W201,nan,08,Neukölln,201,W,2,82,nan,1486,1055,431,0,724,8,17,707,287,420
08W202,nan,08,Neukölln,202,W,2,82,nan,1336,1026,310,0,639,14,25,614,309,305
08W203,nan,08,Neukölln,203,W,2,82,nan,1405,1038,367,0,720,0,31,689,275,414
08W204,nan,08,Neukölln,204,W,2,82,nan,1245,903,342,0,574,2,23,551,241,310
08W205,nan,08,Neukölln,205,W,2,82,nan,1355,948,407,0,586,10,11,575,249,326
08W206,nan,08,Neukölln,206,W,2,82,nan,1340,966,374,0,588,16,23,565,257,308
08W207,nan,08,Neukölln,207,W,2,82,nan,1435,1061,374,0,678,8,24,654,264,390
08W208,nan,08,Neukölln,208,W,2,82,nan,1227,895,332,0,567,10,28,539,228,311
08W209,nan,08,Neukölln,209,W,2,82,nan,1447,1104,343,0,778,12,10,768,335,433
08W210,nan,08,Neukölln,210,W,2,82,nan,1325,966,359,0,653,5,18,635,283,352
08W211,nan,08,Neukölln,211,W,2,82,nan,1201,914,287,0,605,6,21,584,252,332
08W212,nan,08,Neukölln,212,W,2,82,nan,1329,1001,328,0,670,10,31,639,260,379
08W213,nan,08,Neukölln,213,W,2,82,nan,1127,1012,115,0,490,0,26,464,273,191
08W214,nan,08,Neukölln,214,W,2,82,nan,1111,893,218,0,469,5,13,456,286,170
08W215,nan,08,Neukölln,215,W,2,82,nan,1194,821,373,0,558,2,20,538,243,295
08W216,nan,08,Neukölln,216,W,2,82,nan,1305,882,423,0,521,7,25,496,222,274
08W217,nan,08,Neukölln,217,W,2,82,nan,1178,774,404,0,466,1,7,459,195,264
08W218,nan,08,Neukölln,218,W,2,82,nan,1317,961,356,0,586,4,25,561,247,314
08W219,nan,08,Neukölln,219,W,2,82,nan,1213,950,263,0,593,4,22,571,320,251
08W220,nan,08,Neukölln,220,W,2,82,nan,1217,900,317,0,609,4,23,586,242,344
08W221,nan,08,Neukölln,221,W,2,82,nan,1172,876,296,0,599,3,13,586,243,343
08W222,nan,08,Neukölln,222,W,2,82,nan,1549,1170,379,0,754,6,25,729,322,407
08W301,nan,08,Neukölln,301,W,3,82,nan,1316,961,355,0,617,5,15,602,244,358
08W302,nan,08,Neukölln,302,W,3,82,nan,1099,804,295,0,480,3,24,456,192,264
08W303,nan,08,Neukölln,303,W,3,82,nan,1384,1052,331,1,686,10,22,664,306,358
08W304,nan,08,Neukölln,304,W,3,82,nan,1463,1078,385,0,688,1,25,663,275,388
08W305,nan,08,Neukölln,305,W,3,82,nan,1187,875,312,0,632,3,23,609,250,359
08W306,nan,08,Neukölln,306,W,3,82,nan,1487,1088,399,0,693,12,21,672,273,399
08W307,nan,08,Neukölln,307,W,3,82,nan,1034,788,246,0,485,3,19,466,239,227
08W308,nan,08,Neukölln,308,W,3,82,nan,1463,1122,341,0,687,12,24,663,302,361
08W309,nan,08,Neukölln,309,W,3,82,nan,1101,826,275,0,522,3,17,505,206,299
08W310,nan,08,Neukölln,310,W,3,82,nan,1487,1084,403,0,739,9,28,711,295,416
08W311,nan,08,Neukölln,311,W,3,82,nan,1293,947,346,0,601,7,14,587,247,340
08W312,nan,08,Neukölln,312,W,3,82,nan,1586,1134,452,0,664,3,27,637,252,385
08W313,nan,08,Neukölln,313,W,3,82,nan,1028,803,225,0,421,2,18,403,184,219
08W314,nan,08,Neukölln,314,W,3,82,nan,1046,864,182,0,511,7,20,491,259,232
08W315,nan,08,Neukölln,315,W,3,82,nan,1268,925,343,0,445,1,12,433,230,203
08W316,nan,08,Neukölln,316,W,3,82,nan,1078,852,226,0,406,0,16,390,198,192
08W317,nan,08,Neukölln,317,W,3,82,nan,1098,827,271,0,493,3,22,471,265,206
08W318,nan,08,Neukölln,318,W,3,82,nan,1101,822,279,0,315,5,11,304,151,153
08W319,nan,08,Neukölln,319,W,3,82,nan,1009,887,122,0,402,1,5,397,271,126
08W320,nan,08,Neukölln,320,W,3,82,nan,1105,1018,87,0,429,2,11,418,290,128
08W321,nan,08,Neukölln,321,W,3,82,nan,1133,998,135,0,458,0,20,438,312,126
08W322,nan,08,Neukölln,322,W,3,82,nan,1190,994,196,0,531,7,20,511,350,161
08W323,nan,08,Neukölln,323,W,3,82,nan,1369,1100,269,0,678,9,8,670,417,253
08W324,nan,08,Neukölln,324,W,3,82,nan,1379,1265,114,0,539,2,9,530,373,157
08W401,nan,08,Neukölln,401,W,4,82,nan,1485,1230,255,0,649,0,13,636,324,312
08W402,nan,08,Neukölln,402,W,4,82,nan,1393,1105,288,0,580,3,10,570,338,232
08W403,nan,08,Neukölln,403,W,4,82,nan,1343,954,389,0,573,3,10,563,361,202
08W404,nan,08,Neukölln,404,W,4,82,nan,1362,1074,288,0,542,0,13,529,396,133
08W405,nan,08,Neukölln,405,W,4,82,nan,1396,1056,340,0,556,4,13,543,389,154
08W406,nan,08,Neukölln,406,W,4,82,nan,1466,1117,349,0,784,1,7,777,497,280
08W407,nan,08,Neukölln,407,W,4,82,nan,1435,1205,230,0,631,2,17,614,413,201
08W408,nan,08,Neukölln,408,W,4,82,nan,1158,915,243,0,480,5,20,460,290,170
08W409,nan,08,Neukölln,409,W,4,82,nan,1436,1054,381,1,706,0,22,684,469,215
08W410,nan,08,Neukölln,410,W,4,82,nan,1071,728,343,0,439,7,16,423,294,129
08W411,nan,08,Neukölln,411,W,4,82,nan,1379,1007,372,0,634,2,17,617,380,237
08W412,nan,08,Neukölln,412,W,4,82,nan,1426,968,458,0,743,6,14,729,387,342
08W413,nan,08,Neukölln,413,W,4,82,nan,1603,1084,519,0,685,6,8,677,430,247
08W414,nan,08,Neukölln,414,W,4,82,nan,1325,993,332,0,514,3,15,499,382,117
08W415,nan,08,Neukölln,415,W,4,82,nan,1043,777,266,0,456,5,14,442,320,122
08W416,nan,08,Neukölln,416,W,4,82,nan,999,714,285,0,518,2,16,502,305,197
08W417,nan,08,Neukölln,417,W,4,82,nan,1113,791,322,0,488,2,11,477,343,134
08W418,nan,08,Neukölln,418,W,4,82,nan,1437,991,446,0,645,0,4,641,423,218
08W419,nan,08,Neukölln,419,W,4,82,nan,1056,783,273,0,481,3,11,470,349,121
08W420,nan,08,Neukölln,420,W,4,82,nan,1463,1055,408,0,739,3,7,732,480,252
08W421,nan,08,Neukölln,421,W,4,82,nan,1028,736,292,0,555,1,10,545,375,170
08W422,nan,08,Neukölln,422,W,4,82,nan,1226,785,441,0,603,8,10,593,414,179
08W423,nan,08,Neukölln,423,W,4,82,nan,1188,799,389,0,567,3,17,550,391,159
08W501,nan,08,Neukölln,501,W,5,82,nan,1152,851,301,0,461,2,12,449,295,154
08W502,nan,08,Neukölln,502,W,5,82,nan,1409,998,411,0,765,3,8,757,495,262
08W503,nan,08,Neukölln,503,W,5,82,nan,1214,863,351,0,553,1,7,546,362,184
08W504,nan,08,Neukölln,504,W,5,82,nan,1442,1104,338,0,743,2,19,724,544,180
08W505,nan,08,Neukölln,505,W,5,82,nan,1373,983,390,0,701,5,21,680,492,188
08W506,nan,08,Neukölln,506,W,5,82,nan,1368,1029,339,0,707,0,18,689,532,157
08W507,nan,08,Neukölln,507,W,5,82,nan,1073,720,353,0,562,6,8,554,392,162
08W508,nan,08,Neukölln,508,W,5,82,nan,1271,755,516,0,523,3,11,512,348,164
08W509,nan,08,Neukölln,509,W,5,82,nan,1112,705,407,0,517,2,2,515,387,128
08W510,nan,08,Neukölln,510,W,5,82,nan,1586,1204,382,0,890,5,22,868,596,272
08W511,nan,08,Neukölln,511,W,5,82,nan,1468,1145,323,0,695,6,19,676,503,173
08W512,nan,08,Neukölln,512,W,5,82,nan,1079,732,347,0,564,3,8,556,388,168
08W513,nan,08,Neukölln,513,W,5,82,nan,960,604,356,0,507,6,7,500,330,170
08W514,nan,08,Neukölln,514,W,5,82,nan,1028,736,292,0,515,3,12,503,354,149
08W515,nan,08,Neukölln,515,W,5,82,nan,1160,847,313,0,596,2,4,592,444,148
08W516,nan,08,Neukölln,516,W,5,82,nan,1136,859,277,0,594,1,18,576,412,164
08W517,nan,08,Neukölln,517,W,5,82,nan,1350,1080,270,0,697,1,17,680,474,206
08W518,nan,08,Neukölln,518,W,5,82,nan,1232,862,370,0,576,2,17,559,422,137
08W519,nan,08,Neukölln,519,W,5,82,nan,1033,714,319,0,504,2,14,490,357,133
08W520,nan,08,Neukölln,520,W,5,82,nan,1386,1108,278,0,554,5,14,540,379,161
08W521,nan,08,Neukölln,521,W,5,82,nan,1219,887,332,0,611,2,15,596,416,180
08W522,nan,08,Neukölln,522,W,5,82,nan,1433,952,481,0,679,1,19,660,469,191
08W601,nan,08,Neukölln,601,W,6,82,nan,1598,1301,297,0,732,3,16,716,528,188
08W602,nan,08,Neukölln,602,W,6,82,nan,1709,1118,591,0,637,3,8,629,442,187
08W603,nan,08,Neukölln,603,W,6,82,nan,1113,787,326,0,464,0,5,459,322,137
08W604,nan,08,Neukölln,604,W,6,82,nan,1280,978,302,0,584,2,15,569,412,157
08W605,nan,08,Neukölln,605,W,6,82,nan,1301,935,366,0,562,9,5,557,398,159
08W606,nan,08,Neukölln,606,W,6,82,nan,1178,857,321,0,545,2,14,531,385,146
08W607,nan,08,Neukölln,607,W,6,82,nan,1257,844,413,0,481,0,12,469,328,141
08W608,nan,08,Neukölln,608,W,6,82,nan,1763,1308,455,0,749,2,32,717,507,210
08W609,nan,08,Neukölln,609,W,6,82,nan,1558,1186,372,0,641,1,11,630,460,170
08W610,nan,08,Neukölln,610,W,6,82,nan,1027,736,291,0,475,1,10,465,334,131
08W611,nan,08,Neukölln,611,W,6,82,nan,1565,1222,343,0,594,1,15,579,446,133
08W612,nan,08,Neukölln,612,W,6,82,nan,1243,1058,185,0,516,0,31,485,341,144
08W613,nan,08,Neukölln,613,W,6,82,nan,1441,1156,285,0,706,0,20,686,493,193
08W614,nan,08,Neukölln,614,W,6,82,nan,1016,773,243,0,395,3,5,390,297,93
08W615,nan,08,Neukölln,615,W,6,82,nan,1652,1288,364,0,677,3,17,660,458,202
08W616,nan,08,Neukölln,616,W,6,82,nan,1191,890,301,0,461,5,8,453,305,148
08W617,nan,08,Neukölln,617,W,6,82,nan,1318,923,395,0,654,3,8,646,466,180
08W618,nan,08,Neukölln,618,W,6,82,nan,1215,987,228,0,536,4,19,517,389,128
08W619,nan,08,Neukölln,619,W,6,82,nan,1401,1152,249,0,625,4,21,604,458,146
08W620,nan,08,Neukölln,620,W,6,82,nan,1566,1328,238,0,635,5,9,626,447,179
08W621,nan,08,Neukölln,621,W,6,82,nan,864,722,142,0,405,2,6,399,296,103
08W622,nan,08,Neukölln,622,W,6,82,nan,1325,1041,284,0,576,0,10,566,423,143
08W701,nan,08,Neukölln,701,W,7,82,nan,1486,975,511,0,734,1,8,726,514,212
08W702,nan,08,Neukölln,702,W,7,82,nan,1412,941,471,0,744,7,4,740,514,226
08W703,nan,08,Neukölln,703,W,7,82,nan,1177,801,376,0,558,1,13,545,397,148
08W704,nan,08,Neukölln,704,W,7,82,nan,1535,1102,433,0,801,4,11,790,563,227
08W705,nan,08,Neukölln,705,W,7,82,nan,1268,871,397,0,710,3,16,694,484,210
08W706,nan,08,Neukölln,706,W,7,82,nan,1549,1097,452,0,912,6,33,879,597,282
08W707,nan,08,Neukölln,707,W,7,82,nan,1419,997,422,0,688,5,19,669,474,195
08W708,nan,08,Neukölln,708,W,7,82,nan,1397,1025,372,0,713,4,12,701,504,197
08W709,nan,08,Neukölln,709,W,7,82,nan,1474,1100,374,0,737,7,14,723,513,210
08W710,nan,08,Neukölln,710,W,7,82,nan,1460,1037,423,0,805,1,23,782,576,206
08W711,nan,08,Neukölln,711,W,7,82,nan,1505,1199,306,0,824,3,16,808,574,234
08W712,nan,08,Neukölln,712,W,7,82,nan,1518,1161,357,0,796,0,15,781,561,220
08W713,nan,08,Neukölln,713,W,7,82,nan,1470,1035,435,0,805,6,14,791,562,229
08W714,nan,08,Neukölln,714,W,7,82,nan,1408,907,501,0,659,4,14,645,459,186
08W715,nan,08,Neukölln,715,W,7,82,nan,1492,1020,472,0,817,4,23,794,522,272
08W716,nan,08,Neukölln,716,W,7,82,nan,1640,1145,495,0,844,0,17,827,602,225
08W717,nan,08,Neukölln,717,W,7,82,nan,1542,1216,326,0,881,6,18,863,618,245
08W718,nan,08,Neukölln,718,W,7,82,nan,1673,1332,341,0,869,4,17,852,612,240
08W719,nan,08,Neukölln,719,W,7,82,nan,1527,1106,421,0,733,5,15,718,500,218
09W101,nan,09,Treptow-Köpenick,101,W,1,84,nan,1469,1077,392,0,818,12,30,788,315,473
09W102,nan,09,Treptow-Köpenick,102,W,1,84,nan,1849,1249,600,0,884,13,29,855,397,458
09W103,nan,09,Treptow-Köpenick,103,W,1,84,nan,1988,1465,523,0,1092,0,31,1061,416,645
09W104,nan,09,Treptow-Köpenick,104,W,1,84,nan,1353,997,356,0,791,13,37,754,340,414
09W105,nan,09,Treptow-Köpenick,105,W,1,84,nan,1296,917,379,0,632,14,15,617,272,345
09W106,nan,09,Treptow-Köpenick,106,W,1,84,nan,1993,1216,777,0,939,18,27,912,348,564
09W107,nan,09,Treptow-Köpenick,107,W,1,84,nan,2084,1557,527,0,1048,18,24,1024,518,506
09W108,nan,09,Treptow-Köpenick,108,W,1,84,nan,2059,1524,535,0,980,5,22,958,450,508
09W109,nan,09,Treptow-Köpenick,109,W,1,84,nan,1914,1461,453,0,952,3,27,925,429,496
09W110,nan,09,Treptow-Köpenick,110,W,1,84,nan,2093,1559,534,0,903,5,16,887,470,417
09W111,nan,09,Treptow-Köpenick,111,W,1,84,nan,1925,1441,484,0,952,12,19,933,499,434
09W112,nan,09,Treptow-Köpenick,112,W,1,84,nan,1640,1263,377,0,945,2,28,917,448,469
09W113,nan,09,Treptow-Köpenick,113,W,1,84,nan,1593,1164,429,0,846,11,28,818,413,405
09W114,nan,09,Treptow-Köpenick,114,W,1,84,nan,2221,1633,588,0,992,8,23,969,434,535
09W115,nan,09,Treptow-Köpenick,115,W,1,84,nan,1672,1267,405,0,852,3,17,835,472,363
09W116,nan,09,Treptow-Köpenick,116,W,1,84,nan,2208,1591,617,0,1059,10,30,1029,533,496
09W117,nan,09,Treptow-Köpenick,117,W,1,84,nan,1952,1313,639,0,942,1,16,926,514,412
09W118,nan,09,Treptow-Köpenick,118,W,1,84,nan,1272,1004,268,0,650,6,15,635,372,263
09W119,nan,09,Treptow-Köpenick,119,W,1,84,nan,1223,905,318,0,675,2,9,666,369,297
09W201,nan,09,Treptow-Köpenick,201,W,2,84,nan,2118,1530,588,0,1119,11,21,1098,579,519
09W202,nan,09,Treptow-Köpenick,202,W,2,84,nan,2038,1514,524,0,1120,4,25,1095,589,506
09W203,nan,09,Treptow-Köpenick,203,W,2,84,nan,1945,1463,482,0,1071,12,23,1048,598,450
09W204,nan,09,Treptow-Köpenick,204,W,2,84,nan,2177,1630,547,0,1161,5,27,1134,667,467
09W205,nan,09,Treptow-Köpenick,205,W,2,84,nan,1512,1172,340,0,793,7,18,775,469,306
09W206,nan,09,Treptow-Köpenick,206,W,2,84,nan,1712,1286,426,0,872,6,18,854,507,347
09W207,nan,09,Treptow-Köpenick,207,W,2,84,nan,1489,1071,418,0,739,6,32,707,423,284
09W208,nan,09,Treptow-Köpenick,208,W,2,84,nan,1395,929,466,0,749,6,12,737,418,319
09W209,nan,09,Treptow-Köpenick,209,W,2,84,nan,1350,995,355,0,711,2,15,696,391,305
09W210,nan,09,Treptow-Köpenick,210,W,2,84,nan,1771,1397,374,0,893,4,9,884,515,369
09W211,nan,09,Treptow-Köpenick,211,W,2,84,nan,2277,1627,650,0,1089,8,16,1073,585,488
09W212,nan,09,Treptow-Köpenick,212,W,2,84,nan,2130,1565,565,0,1051,4,26,1025,525,500
09W213,nan,09,Treptow-Köpenick,213,W,2,84,nan,2286,1857,429,0,1169,6,42,1127,662,465
09W214,nan,09,Treptow-Köpenick,214,W,2,84,nan,2268,1833,435,0,1025,1,30,995,572,423
09W215,nan,09,Treptow-Köpenick,215,W,2,84,nan,1325,1061,264,0,687,0,16,671,388,283
09W216,nan,09,Treptow-Köpenick,216,W,2,84,nan,1494,1200,293,1,852,8,25,827,432,395
09W217,nan,09,Treptow-Köpenick,217,W,2,84,nan,2046,1575,471,0,1039,12,19,1020,540,480
09W218,nan,09,Treptow-Köpenick,218,W,2,84,nan,1198,964,234,0,640,2,4,636,354,282
09W219,nan,09,Treptow-Köpenick,219,W,2,84,nan,1271,1032,239,0,706,0,29,677,412,265
09W220,nan,09,Treptow-Köpenick,220,W,2,84,nan,1758,1354,404,0,915,7,14,901,484,417
09W221,nan,09,Treptow-Köpenick,221,W,2,84,nan,2067,1548,519,0,946,2,22,924,549,375
09W301,nan,09,Treptow-Köpenick,301,W,3,84,nan,1747,1329,418,0,977,3,30,947,545,402
09W302,nan,09,Treptow-Köpenick,302,W,3,84,nan,1894,1321,573,0,1007,4,34,973,529,444
09W303,nan,09,Treptow-Köpenick,303,W,3,84,nan,2807,2043,764,0,1399,6,28,1371,777,594
09W304,nan,09,Treptow-Köpenick,304,W,3,84,nan,1754,1403,351,0,1001,0,20,981,567,414
09W305,nan,09,Treptow-Köpenick,305,W,3,84,nan,1941,1451,490,0,879,5,19,860,444,416
09W306,nan,09,Treptow-Köpenick,306,W,3,84,nan,1907,1448,459,0,1030,9,22,1008,589,419
09W307,nan,09,Treptow-Köpenick,307,W,3,84,nan,1621,1320,301,0,832,0,9,823,483,340
09W308,nan,09,Treptow-Köpenick,308,W,3,84,nan,2047,1542,505,0,1138,14,27,1111,660,451
09W309,nan,09,Treptow-Köpenick,309,W,3,84,nan,1351,984,367,0,726,8,8,718,431,287
09W310,nan,09,Treptow-Köpenick,310,W,3,84,nan,1586,1123,463,0,938,6,23,915,570,345
09W311,nan,09,Treptow-Köpenick,311,W,3,84,nan,1888,1364,524,0,1103,11,25,1078,624,454
09W312,nan,09,Treptow-Köpenick,312,W,3,84,nan,1477,1154,323,0,905,3,12,893,539,354
09W313,nan,09,Treptow-Köpenick,313,W,3,84,nan,1988,1628,360,0,1130,3,12,1118,706,412
09W314,nan,09,Treptow-Köpenick,314,W,3,84,nan,1881,1526,355,0,932,3,32,900,593,307
09W315,nan,09,Treptow-Köpenick,315,W,3,84,nan,1402,1011,391,0,784,6,16,768,463,305
09W316,nan,09,Treptow-Köpenick,316,W,3,84,nan,1681,1272,409,0,945,7,11,934,563,371
09W317,nan,09,Treptow-Köpenick,317,W,3,84,nan,1112,819,293,0,620,0,6,614,349,265
09W318,nan,09,Treptow-Köpenick,318,W,3,84,nan,1839,1629,210,0,814,8,21,793,509,284
09W319,nan,09,Treptow-Köpenick,319,W,3,84,nan,847,595,252,0,442,3,11,431,258,173
09W320,nan,09,Treptow-Köpenick,320,W,3,84,nan,1950,1668,282,0,989,6,15,974,589,385
09W401,nan,09,Treptow-Köpenick,401,W,4,84,nan,1995,1502,493,0,1105,4,5,1100,812,288
09W402,nan,09,Treptow-Köpenick,402,W,4,84,nan,1704,1210,494,0,939,3,5,934,766,168
09W403,nan,09,Treptow-Köpenick,403,W,4,84,nan,2173,1492,681,0,1108,9,12,1096,730,366
09W404,nan,09,Treptow-Köpenick,404,W,4,84,nan,1574,1177,397,0,935,1,18,917,735,182
09W405,nan,09,Treptow-Köpenick,405,W,4,84,nan,1865,1286,579,0,1013,1,15,998,865,133
09W406,nan,09,Treptow-Köpenick,406,W,4,84,nan,1896,1462,434,0,984,0,24,960,567,393
09W407,nan,09,Treptow-Köpenick,407,W,4,84,nan,1487,1162,325,0,806,7,22,784,432,352
09W408,nan,09,Treptow-Köpenick,408,W,4,84,nan,1322,973,349,0,688,3,13,675,382,293
09W409,nan,09,Treptow-Köpenick,409,W,4,84,nan,1694,1217,477,0,739,1,11,728,423,305
09W410,nan,09,Treptow-Köpenick,410,W,4,84,nan,1536,1379,157,0,728,3,18,710,481,229
09W411,nan,09,Treptow-Köpenick,411,W,4,84,nan,1326,983,343,0,741,5,17,724,428,296
09W412,nan,09,Treptow-Köpenick,412,W,4,84,nan,2251,1702,549,0,1266,15,4,1262,789,473
09W413,nan,09,Treptow-Köpenick,413,W,4,84,nan,1308,920,388,0,739,7,5,734,502,232
09W414,nan,09,Treptow-Köpenick,414,W,4,84,nan,1483,1035,448,0,860,3,15,845,720,125
09W415,nan,09,Treptow-Köpenick,415,W,4,84,nan,793,545,248,0,466,6,3,463,429,34
09W416,nan,09,Treptow-Köpenick,416,W,4,84,nan,827,624,203,0,517,11,2,515,414,101
09W417,nan,09,Treptow-Köpenick,417,W,4,84,nan,389,259,130,0,213,1,3,210,161,49
09W418,nan,09,Treptow-Köpenick,418,W,4,84,nan,2455,1740,715,0,1308,8,23,1285,685,600
09W419,nan,09,Treptow-Köpenick,419,W,4,84,nan,1537,1232,305,0,850,7,21,829,486,343
09W420,nan,09,Treptow-Köpenick,420,W,4,84,nan,1153,863,290,0,570,3,10,560,352,208
09W421,nan,09,Treptow-Köpenick,421,W,4,84,nan,1856,1456,400,0,1006,2,17,989,551,438
09W422,nan,09,Treptow-Köpenick,422,W,4,84,nan,1774,1183,591,0,892,2,20,872,514,358
09W501,nan,09,Treptow-Köpenick,501,W,5,84,nan,1521,1171,350,0,797,4,16,781,456,325
09W502,nan,09,Treptow-Köpenick,502,W,5,84,nan,2113,1670,443,0,1084,5,17,1067,652,415
09W503,nan,09,Treptow-Köpenick,503,W,5,84,nan,1228,921,307,0,666,1,7,659,384,275
09W504,nan,09,Treptow-Köpenick,504,W,5,84,nan,1837,1390,447,0,1007,4,20,987,539,448
09W505,nan,09,Treptow-Köpenick,505,W,5,84,nan,1201,908,293,0,716,2,16,700,406,294
09W506,nan,09,Treptow-Köpenick,506,W,5,84,nan,1291,1018,273,0,665,0,17,648,422,226
09W507,nan,09,Treptow-Köpenick,507,W,5,84,nan,885,720,165,0,470,0,16,454,287,167
09W508,nan,09,Treptow-Köpenick,508,W,5,84,nan,1408,1126,282,0,677,0,16,661,443,218
09W509,nan,09,Treptow-Köpenick,509,W,5,84,nan,1572,1252,320,0,822,2,26,796,518,278
09W510,nan,09,Treptow-Köpenick,510,W,5,84,nan,1334,1108,226,0,639,3,10,629,403,226
09W511,nan,09,Treptow-Köpenick,511,W,5,84,nan,1601,1164,437,0,918,3,11,907,581,326
09W512,nan,09,Treptow-Köpenick,512,W,5,84,nan,2165,1588,577,0,1095,3,20,1075,694,381
09W513,nan,09,Treptow-Köpenick,513,W,5,84,nan,2096,1489,607,0,1045,2,27,1018,642,376
09W514,nan,09,Treptow-Köpenick,514,W,5,84,nan,2122,1627,495,0,1125,2,20,1105,667,438
09W515,nan,09,Treptow-Köpenick,515,W,5,84,nan,1998,1374,624,0,1123,6,17,1106,703,403
09W516,nan,09,Treptow-Köpenick,516,W,5,84,nan,1979,1437,542,0,1112,2,18,1094,921,173
09W517,nan,09,Treptow-Köpenick,517,W,5,84,nan,1996,1496,500,0,1240,0,13,1227,1031,196
09W518,nan,09,Treptow-Köpenick,518,W,5,84,nan,1567,1127,440,0,877,2,2,875,750,125
09W601,nan,09,Treptow-Köpenick,601,W,6,84,nan,1992,1457,535,0,1044,7,38,1006,615,391
09W602,nan,09,Treptow-Köpenick,602,W,6,84,nan,1495,1100,395,0,852,0,25,827,514,313
09W603,nan,09,Treptow-Köpenick,603,W,6,84,nan,1497,1105,392,0,871,6,23,848,519,329
09W604,nan,09,Treptow-Köpenick,604,W,6,84,nan,2026,1449,577,0,1201,0,30,1171,762,409
09W605,nan,09,Treptow-Köpenick,605,W,6,84,nan,2160,1535,625,0,1175,12,22,1153,727,426
09W606,nan,09,Treptow-Köpenick,606,W,6,84,nan,1952,1451,501,0,1119,10,19,1100,683,417
09W607,nan,09,Treptow-Köpenick,607,W,6,84,nan,1615,1185,430,0,876,6,18,858,552,306
09W608,nan,09,Treptow-Köpenick,608,W,6,84,nan,2289,1526,763,0,1122,10,35,1087,680,407
09W609,nan,09,Treptow-Köpenick,609,W,6,84,nan,1618,1189,429,0,894,0,7,887,501,386
09W610,nan,09,Treptow-Köpenick,610,W,6,84,nan,1365,1044,321,0,839,5,20,819,450,369
09W611,nan,09,Treptow-Köpenick,611,W,6,84,nan,1711,1266,445,0,970,7,26,944,529,415
09W612,nan,09,Treptow-Köpenick,612,W,6,84,nan,2144,1602,542,0,1267,3,53,1214,644,570
09W613,nan,09,Treptow-Köpenick,613,W,6,84,nan,1303,987,316,0,641,0,22,619,335,284
09W614,nan,09,Treptow-Köpenick,614,W,6,84,nan,2651,1938,713,0,1444,6,33,1411,805,606
09W615,nan,09,Treptow-Köpenick,615,W,6,84,nan,1219,750,469,0,622,3,6,616,443,173
09W616,nan,09,Treptow-Köpenick,616,W,6,84,nan,1558,1083,475,0,843,12,10,833,568,265
09W617,nan,09,Treptow-Köpenick,617,W,6,84,nan,1893,1353,540,0,1110,6,17,1093,861,232
09W618,nan,09,Treptow-Köpenick,618,W,6,84,nan,1491,1114,377,0,829,5,11,818,599,219
09W619,nan,09,Treptow-Köpenick,619,W,6,84,nan,1379,1018,361,0,834,5,10,824,670,154
10W101,nan,10,Marzahn-Hellersdorf,101,W,1,85,nan,1808,1594,214,0,805,1,14,791,461,330
10W102,nan,10,Marzahn-Hellersdorf,102,W,1,85,nan,1067,871,196,0,549,1,16,533,283,250
10W103,nan,10,Marzahn-Hellersdorf,103,W,1,85,nan,1235,1070,165,0,506,2,13,493,288,205
10W104,nan,10,Marzahn-Hellersdorf,104,W,1,85,nan,1384,1210,174,0,698,1,16,682,369,313
10W105,nan,10,Marzahn-Hellersdorf,105,W,1,85,nan,1316,1152,164,0,627,0,15,612,335,277
10W106,nan,10,Marzahn-Hellersdorf,106,W,1,85,nan,1309,1173,136,0,632,0,14,618,388,230
10W107,nan,10,Marzahn-Hellersdorf,107,W,1,85,nan,1656,1406,250,0,808,2,18,790,470,320
10W108,nan,10,Marzahn-Hellersdorf,108,W,1,85,nan,1664,1480,184,0,701,0,20,681,412,269
10W109,nan,10,Marzahn-Hellersdorf,109,W,1,85,nan,1674,1440,234,0,698,4,14,684,423,261
10W110,nan,10,Marzahn-Hellersdorf,110,W,1,85,nan,1750,1557,193,0,822,2,16,806,481,325
10W111,nan,10,Marzahn-Hellersdorf,111,W,1,85,nan,1979,1673,306,0,943,2,25,918,537,381
10W112,nan,10,Marzahn-Hellersdorf,112,W,1,85,nan,1633,1422,211,0,795,1,18,777,484,293
10W113,nan,10,Marzahn-Hellersdorf,113,W,1,85,nan,1737,1528,209,0,772,3,22,750,450,300
10W114,nan,10,Marzahn-Hellersdorf,114,W,1,85,nan,1934,1587,347,0,876,0,25,851,439,412
10W115,nan,10,Marzahn-Hellersdorf,115,W,1,85,nan,2106,1718,388,0,1152,5,19,1133,568,565
10W116,nan,10,Marzahn-Hellersdorf,116,W,1,85,nan,1686,1407,279,0,717,2,19,698,424,274
10W117,nan,10,Marzahn-Hellersdorf,117,W,1,85,nan,1826,1528,298,0,937,1,22,915,554,361
10W118,nan,10,Marzahn-Hellersdorf,118,W,1,85,nan,1466,1289,177,0,676,2,12,664,405,259
10W119,nan,10,Marzahn-Hellersdorf,119,W,1,85,nan,1565,1261,304,0,755,1,16,739,408,331
10W120,nan,10,Marzahn-Hellersdorf,120,W,1,85,nan,1378,1138,240,0,607,0,18,589,357,232
10W201,nan,10,Marzahn-Hellersdorf,201,W,2,85,nan,1839,1429,410,0,921,1,15,906,498,408
10W202,nan,10,Marzahn-Hellersdorf,202,W,2,85,nan,1880,1590,290,0,848,0,4,844,472,372
10W203,nan,10,Marzahn-Hellersdorf,203,W,2,85,nan,2004,1646,358,0,945,4,29,916,507,409
10W204,nan,10,Marzahn-Hellersdorf,204,W,2,85,nan,2117,1642,475,0,1049,1,42,1007,509,498
10W205,nan,10,Marzahn-Hellersdorf,205,W,2,85,nan,1952,1584,368,0,867,4,18,849,493,356
10W206,nan,10,Marzahn-Hellersdorf,206,W,2,85,nan,1669,1275,394,0,720,0,12,708,408,300
10W207,nan,10,Marzahn-Hellersdorf,207,W,2,85,nan,1703,1364,339,0,881,3,8,873,469,404
10W208,nan,10,Marzahn-Hellersdorf,208,W,2,85,nan,1781,1462,319,0,885,2,16,869,481,388
10W209,nan,10,Marzahn-Hellersdorf,209,W,2,85,nan,1690,1449,241,0,817,2,10,807,447,360
10W210,nan,10,Marzahn-Hellersdorf,210,W,2,85,nan,1927,1577,350,0,901,3,22,879,471,408
10W211,nan,10,Marzahn-Hellersdorf,211,W,2,85,nan,1418,1210,208,0,679,3,22,657,371,286
10W212,nan,10,Marzahn-Hellersdorf,212,W,2,85,nan,1520,1154,366,0,770,0,16,754,346,408
10W213,nan,10,Marzahn-Hellersdorf,213,W,2,85,nan,1849,1505,344,0,878,0,10,868,517,351
10W214,nan,10,Marzahn-Hellersdorf,214,W,2,85,nan,1702,1293,409,0,930,1,21,909,434,475
10W215,nan,10,Marzahn-Hellersdorf,215,W,2,85,nan,1635,1252,383,0,870,0,25,845,456,389
10W216,nan,10,Marzahn-Hellersdorf,216,W,2,85,nan,1932,1475,457,0,1037,1,24,1013,505,508
10W217,nan,10,Marzahn-Hellersdorf,217,W,2,85,nan,1597,1320,277,0,730,0,8,722,438,284
10W218,nan,10,Marzahn-Hellersdorf,218,W,2,85,nan,1431,1102,329,0,751,2,22,729,376,353
10W219,nan,10,Marzahn-Hellersdorf,219,W,2,85,nan,1283,1071,212,0,564,2,15,549,319,230
10W220,nan,10,Marzahn-Hellersdorf,220,W,2,85,nan,1489,1202,287,0,779,2,28,751,406,345
10W301,nan,10,Marzahn-Hellersdorf,301,W,3,85,nan,1924,1553,371,0,1094,2,30,1064,563,501
10W302,nan,10,Marzahn-Hellersdorf,302,W,3,85,nan,1656,1492,164,0,720,5,17,703,433,270
10W303,nan,10,Marzahn-Hellersdorf,303,W,3,85,nan,1291,1163,128,0,571,0,19,552,361,191
10W304,nan,10,Marzahn-Hellersdorf,304,W,3,85,nan,1427,1262,165,0,574,0,6,568,351,217
10W305,nan,10,Marzahn-Hellersdorf,305,W,3,85,nan,1706,1536,170,0,776,1,3,773,509,264
10W306,nan,10,Marzahn-Hellersdorf,306,W,3,85,nan,2105,1849,256,0,1003,0,28,975,588,387
10W307,nan,10,Marzahn-Hellersdorf,307,W,3,85,nan,1968,1698,270,0,924,2,24,900,571,329
10W308,nan,10,Marzahn-Hellersdorf,308,W,3,85,nan,1435,1240,195,0,710,0,18,692,404,288
10W309,nan,10,Marzahn-Hellersdorf,309,W,3,85,nan,2063,1723,340,0,933,1,11,922,562,360
10W310,nan,10,Marzahn-Hellersdorf,310,W,3,85,nan,1472,1286,186,0,759,0,17,742,452,290
10W311,nan,10,Marzahn-Hellersdorf,311,W,3,85,nan,1413,1219,194,0,648,0,13,635,493,142
10W312,nan,10,Marzahn-Hellersdorf,312,W,3,85,nan,1044,892,152,0,454,2,13,441,290,151
10W313,nan,10,Marzahn-Hellersdorf,313,W,3,85,nan,1483,1320,163,0,540,0,13,527,363,164
10W314,nan,10,Marzahn-Hellersdorf,314,W,3,85,nan,1513,1317,196,0,730,1,20,710,407,303
10W315,nan,10,Marzahn-Hellersdorf,315,W,3,85,nan,1921,1650,271,0,746,2,14,732,479,253
10W316,nan,10,Marzahn-Hellersdorf,316,W,3,85,nan,1674,1435,239,0,765,2,9,756,430,326
10W317,nan,10,Marzahn-Hellersdorf,317,W,3,85,nan,1821,1423,398,0,867,0,19,848,511,337
10W318,nan,10,Marzahn-Hellersdorf,318,W,3,85,nan,1750,1441,309,0,827,0,12,815,506,309
10W319,nan,10,Marzahn-Hellersdorf,319,W,3,85,nan,1966,1513,453,0,974,3,16,958,576,382
10W320,nan,10,Marzahn-Hellersdorf,320,W,3,85,nan,1724,1406,318,0,902,2,19,883,549,334
10W401,nan,10,Marzahn-Hellersdorf,401,W,4,85,nan,2006,1620,386,0,975,2,29,946,520,426
10W402,nan,10,Marzahn-Hellersdorf,402,W,4,85,nan,1938,1607,331,0,1013,0,26,987,554,433
10W403,nan,10,Marzahn-Hellersdorf,403,W,4,85,nan,1694,1365,329,0,817,3,14,803,428,375
10W404,nan,10,Marzahn-Hellersdorf,404,W,4,85,nan,2125,1617,508,0,936,3,25,911,474,437
10W405,nan,10,Marzahn-Hellersdorf,405,W,4,85,nan,1996,1570,426,0,1047,2,30,1017,577,440
10W406,nan,10,Marzahn-Hellersdorf,406,W,4,85,nan,2050,1570,480,0,1028,0,38,990,506,484
10W407,nan,10,Marzahn-Hellersdorf,407,W,4,85,nan,1921,1362,559,0,1040,8,30,1010,443,567
10W408,nan,10,Marzahn-Hellersdorf,408,W,4,85,nan,1704,1180,524,0,903,5,18,885,405,480
10W409,nan,10,Marzahn-Hellersdorf,409,W,4,85,nan,1762,1120,642,0,829,0,11,818,422,396
10W410,nan,10,Marzahn-Hellersdorf,410,W,4,85,nan,1376,1140,236,0,602,3,24,578,327,251
10W411,nan,10,Marzahn-Hellersdorf,411,W,4,85,nan,1396,1046,350,0,818,0,17,801,367,434
10W412,nan,10,Marzahn-Hellersdorf,412,W,4,85,nan,1607,1339,268,0,750,0,25,725,401,324
10W413,nan,10,Marzahn-Hellersdorf,413,W,4,85,nan,1840,1189,651,0,955,2,19,936,443,493
10W414,nan,10,Marzahn-Hellersdorf,414,W,4,85,nan,1881,1249,632,0,1006,3,16,990,453,537
10W415,nan,10,Marzahn-Hellersdorf,415,W,4,85,nan,2182,1580,602,0,1128,11,22,1106,545,561
10W416,nan,10,Marzahn-Hellersdorf,416,W,4,85,nan,1734,1103,631,0,888,0,10,878,403,475
10W417,nan,10,Marzahn-Hellersdorf,417,W,4,85,nan,1912,1392,520,0,1128,2,19,1109,553,556
10W418,nan,10,Marzahn-Hellersdorf,418,W,4,85,nan,1242,968,274,0,772,7,18,754,368,386
10W419,nan,10,Marzahn-Hellersdorf,419,W,4,85,nan,1585,1281,304,0,912,0,16,896,436,460
10W501,nan,10,Marzahn-Hellersdorf,501,W,5,85,nan,1979,1378,601,0,1105,4,33,1072,543,529
10W502,nan,10,Marzahn-Hellersdorf,502,W,5,85,nan,2075,1379,696,0,1115,0,20,1095,580,515
10W503,nan,10,Marzahn-Hellersdorf,503,W,5,85,nan,2077,1533,544,0,1249,3,20,1229,588,641
10W504,nan,10,Marzahn-Hellersdorf,504,W,5,85,nan,2152,1522,630,0,1230,4,21,1209,615,594
10W505,nan,10,Marzahn-Hellersdorf,505,W,5,85,nan,1975,1395,580,0,1059,6,19,1040,573,467
10W506,nan,10,Marzahn-Hellersdorf,506,W,5,85,nan,1874,1292,582,0,1084,11,12,1072,571,501
10W507,nan,10,Marzahn-Hellersdorf,507,W,5,85,nan,1768,1301,467,0,1072,10,30,1042,504,538
10W508,nan,10,Marzahn-Hellersdorf,508,W,5,85,nan,1671,1194,477,0,941,3,11,930,450,480
10W509,nan,10,Marzahn-Hellersdorf,509,W,5,85,nan,1647,1133,514,0,907,8,14,893,422,471
10W510,nan,10,Marzahn-Hellersdorf,510,W,5,85,nan,2051,1451,600,0,1173,10,18,1155,551,604
10W511,nan,10,Marzahn-Hellersdorf,511,W,5,85,nan,2068,1411,657,0,1108,3,30,1078,492,586
10W512,nan,10,Marzahn-Hellersdorf,512,W,5,85,nan,1746,1295,451,0,1007,0,27,980,472,508
10W513,nan,10,Marzahn-Hellersdorf,513,W,5,85,nan,1677,1202,475,0,957,3,15,942,420,522
10W514,nan,10,Marzahn-Hellersdorf,514,W,5,85,nan,2112,1547,565,0,1232,5,19,1213,553,660
10W515,nan,10,Marzahn-Hellersdorf,515,W,5,85,nan,2007,1389,618,0,1102,1,11,1091,490,601
10W516,nan,10,Marzahn-Hellersdorf,516,W,5,85,nan,2104,1537,567,0,1293,12,15,1278,572,706
10W517,nan,10,Marzahn-Hellersdorf,517,W,5,85,nan,2083,1389,694,0,1111,6,23,1088,464,624
10W601,nan,10,Marzahn-Hellersdorf,601,W,6,85,nan,1679,1477,202,0,811,3,16,795,505,290
10W602,nan,10,Marzahn-Hellersdorf,602,W,6,85,nan,1959,1671,288,0,914,0,16,898,569,329
10W603,nan,10,Marzahn-Hellersdorf,603,W,6,85,nan,1937,1591,346,0,953,4,17,936,585,351
10W604,nan,10,Marzahn-Hellersdorf,604,W,6,85,nan,1547,1280,267,0,839,1,12,827,463,364
10W605,nan,10,Marzahn-Hellersdorf,605,W,6,85,nan,1185,1004,181,0,578,0,21,557,316,241
10W606,nan,10,Marzahn-Hellersdorf,606,W,6,85,nan,2001,1614,387,0,1033,1,19,1014,554,460
10W607,nan,10,Marzahn-Hellersdorf,607,W,6,85,nan,2065,1694,371,0,1007,1,24,983,590,393
10W608,nan,10,Marzahn-Hellersdorf,608,W,6,85,nan,1666,1367,299,0,773,1,20,753,451,302
10W609,nan,10,Marzahn-Hellersdorf,609,W,6,85,nan,1609,1295,314,0,840,1,20,820,456,364
10W610,nan,10,Marzahn-Hellersdorf,610,W,6,85,nan,1914,1469,445,0,1031,8,23,1008,540,468
10W611,nan,10,Marzahn-Hellersdorf,611,W,6,85,nan,1865,1539,326,0,911,0,16,895,486,409
10W612,nan,10,Marzahn-Hellersdorf,612,W,6,85,nan,1851,1363,488,0,1048,1,17,1031,535,496
10W613,nan,10,Marzahn-Hellersdorf,613,W,6,85,nan,1875,1479,396,0,985,3,21,964,495,469
10W614,nan,10,Marzahn-Hellersdorf,614,W,6,85,nan,2009,1377,632,0,1116,0,18,1098,515,583
10W615,nan,10,Marzahn-Hellersdorf,615,W,6,85,nan,1898,1650,248,0,939,3,14,925,581,344
10W616,nan,10,Marzahn-Hellersdorf,616,W,6,85,nan,1918,1584,334,0,909,0,28,881,534,347
10W617,nan,10,Marzahn-Hellersdorf,617,W,6,85,nan,1864,1632,232,0,797,0,18,779,479,300
10W618,nan,10,Marzahn-Hellersdorf,618,W,6,85,nan,1855,1554,301,0,790,2,23,767,472,295
11W101,nan,11,Lichtenberg,101,W,1,86,nan,1079,853,226,0,571,1,10,561,198,363
11W102,nan,11,Lichtenberg,102,W,1,86,nan,1034,768,266,0,618,1,7,611,108,503
11W103,nan,11,Lichtenberg,103,W,1,86,nan,1059,852,207,0,637,2,4,633,183,450
11W104,nan,11,Lichtenberg,104,W,1,86,nan,1167,970,197,0,615,1,13,602,244,358
11W105,nan,11,Lichtenberg,105,W,1,86,nan,983,777,206,0,571,2,6,565,122,443
11W106,nan,11,Lichtenberg,106,W,1,86,nan,1093,963,130,0,571,1,10,561,290,271
11W107,nan,11,Lichtenberg,107,W,1,86,nan,894,767,127,0,388,0,11,377,182,195
11W108,nan,11,Lichtenberg,108,W,1,86,nan,1055,879,176,0,472,1,10,462,227,235
11W109,nan,11,Lichtenberg,109,W,1,86,nan,1067,897,170,0,548,1,1,547,287,260
11W110,nan,11,Lichtenberg,110,W,1,86,nan,1137,898,239,0,499,1,1,498,230,268
11W111,nan,11,Lichtenberg,111,W,1,86,nan,999,742,257,0,533,0,4,529,210,319
11W112,nan,11,Lichtenberg,112,W,1,86,nan,1236,1021,215,0,564,0,7,557,314,243
11W113,nan,11,Lichtenberg,113,W,1,86,nan,893,683,210,0,411,1,4,407,205,202
11W114,nan,11,Lichtenberg,114,W,1,86,nan,998,779,219,0,502,1,7,495,252,243
11W115,nan,11,Lichtenberg,115,W,1,86,nan,914,713,201,0,463,1,9,454,203,251
11W116,nan,11,Lichtenberg,116,W,1,86,nan,986,804,182,0,537,1,9,528,251,277
11W117,nan,11,Lichtenberg,117,W,1,86,nan,1117,949,168,0,480,1,10,470,281,189
11W118,nan,11,Lichtenberg,118,W,1,86,nan,1044,864,180,0,492,2,29,463,240,223
11W119,nan,11,Lichtenberg,119,W,1,86,nan,1304,1154,150,0,598,2,14,584,347,237
11W120,nan,11,Lichtenberg,120,W,1,86,nan,1347,1145,202,0,566,4,22,544,305,239
11W121,nan,11,Lichtenberg,121,W,1,86,nan,1066,913,153,0,507,1,7,500,294,206
11W122,nan,11,Lichtenberg,122,W,1,86,nan,1245,1028,217,0,653,2,12,641,340,301
11W123,nan,11,Lichtenberg,123,W,1,86,nan,1223,977,246,0,644,0,4,640,289,351
11W124,nan,11,Lichtenberg,124,W,1,86,nan,1050,883,167,0,489,2,10,479,266,213
11W125,nan,11,Lichtenberg,125,W,1,86,nan,1229,1027,202,0,603,0,11,592,314,278
11W126,nan,11,Lichtenberg,126,W,1,86,nan,1175,987,188,0,542,0,14,528,291,237
11W127,nan,11,Lichtenberg,127,W,1,86,nan,1211,994,217,0,634,1,14,620,284,336
11W201,nan,11,Lichtenberg,201,W,2,86,nan,967,735,232,0,467,7,3,464,160,304
11W202,nan,11,Lichtenberg,202,W,2,86,nan,1273,1015,258,0,675,4,23,652,294,358
11W203,nan,11,Lichtenberg,203,W,2,86,nan,1244,1001,243,0,632,2,7,625,284,341
11W204,nan,11,Lichtenberg,204,W,2,86,nan,1094,894,200,0,525,0,9,516,262,254
11W205,nan,11,Lichtenberg,205,W,2,86,nan,1146,956,190,0,552,1,3,549,282,267
11W206,nan,11,Lichtenberg,206,W,2,86,nan,1138,944,194,0,552,3,12,540,288,252
11W207,nan,11,Lichtenberg,207,W,2,86,nan,1059,895,164,0,510,0,8,502,282,220
11W208,nan,11,Lichtenberg,208,W,2,86,nan,878,734,144,0,391,1,2,389,227,162
11W209,nan,11,Lichtenberg,209,W,2,86,nan,960,803,157,0,476,0,10,466,267,199
11W210,nan,11,Lichtenberg,210,W,2,86,nan,1178,805,373,0,625,4,11,614,231,383
11W211,nan,11,Lichtenberg,211,W,2,86,nan,1065,719,346,0,577,2,2,575,185,390
11W212,nan,11,Lichtenberg,212,W,2,86,nan,1116,897,219,0,561,2,13,548,280,268
11W213,nan,11,Lichtenberg,213,W,2,86,nan,1377,1068,309,0,752,1,12,740,358,382
11W214,nan,11,Lichtenberg,214,W,2,86,nan,915,691,224,0,497,3,2,495,243,252
11W215,nan,11,Lichtenberg,215,W,2,86,nan,988,732,256,0,447,0,8,439,239,200
11W216,nan,11,Lichtenberg,216,W,2,86,nan,1367,1052,315,0,793,2,21,772,341,431
11W217,nan,11,Lichtenberg,217,W,2,86,nan,1184,889,295,0,621,1,14,607,288,319
11W218,nan,11,Lichtenberg,218,W,2,86,nan,1635,1356,279,0,799,3,12,787,420,367
11W219,nan,11,Lichtenberg,219,W,2,86,nan,993,703,290,0,535,1,4,531,228,303
11W220,nan,11,Lichtenberg,220,W,2,86,nan,1128,784,344,0,656,4,2,654,253,401
11W221,nan,11,Lichtenberg,221,W,2,86,nan,1193,935,258,0,678,3,8,670,356,314
11W222,nan,11,Lichtenberg,222,W,2,86,nan,1286,983,303,0,669,2,22,647,299,348
11W223,nan,11,Lichtenberg,223,W,2,86,nan,1157,970,187,0,611,1,29,582,308,274
11W224,nan,11,Lichtenberg,224,W,2,86,nan,1420,1000,420,0,777,2,9,768,347,421
11W225,nan,11,Lichtenberg,225,W,2,86,nan,1218,957,261,0,636,6,23,613,330,283
11W226,nan,11,Lichtenberg,226,W,2,86,nan,1250,974,276,0,711,5,28,683,323,360
11W227,nan,11,Lichtenberg,227,W,2,86,nan,1232,995,237,0,697,6,21,676,379,297
11W228,nan,11,Lichtenberg,228,W,2,86,nan,1175,882,293,0,657,8,10,647,306,341
11W301,nan,11,Lichtenberg,301,W,3,86,nan,1165,918,247,0,594,2,26,568,308,260
11W302,nan,11,Lichtenberg,302,W,3,86,nan,917,704,213,0,525,1,10,515,255,260
11W303,nan,11,Lichtenberg,303,W,3,86,nan,1005,880,125,0,448,0,8,440,259,181
11W304,nan,11,Lichtenberg,304,W,3,86,nan,1295,1032,263,0,644,4,21,623,358,265
11W305,nan,11,Lichtenberg,305,W,3,86,nan,1173,935,238,0,624,2,12,612,322,290
11W306,nan,11,Lichtenberg,306,W,3,86,nan,1430,1121,309,0,679,4,11,668,384,284
11W307,nan,11,Lichtenberg,307,W,3,86,nan,1717,1271,446,0,911,12,19,892,404,488
11W308,nan,11,Lichtenberg,308,W,3,86,nan,1366,1090,276,0,736,6,18,718,387,331
11W309,nan,11,Lichtenberg,309,W,3,86,nan,1225,988,237,0,604,0,14,590,356,234
11W310,nan,11,Lichtenberg,310,W,3,86,nan,1283,1006,277,0,655,1,9,646,338,308
11W311,nan,11,Lichtenberg,311,W,3,86,nan,1173,910,263,0,560,1,9,551,317,234
11W312,nan,11,Lichtenberg,312,W,3,86,nan,1064,827,237,0,474,2,3,471,230,241
11W313,nan,11,Lichtenberg,313,W,3,86,nan,1332,1060,272,0,732,2,7,725,399,326
11W314,nan,11,Lichtenberg,314,W,3,86,nan,1258,1065,193,0,659,0,20,639,365,274
11W315,nan,11,Lichtenberg,315,W,3,86,nan,1207,959,248,0,741,2,9,732,368,364
11W316,nan,11,Lichtenberg,316,W,3,86,nan,1106,836,270,0,544,2,11,533,279,254
11W317,nan,11,Lichtenberg,317,W,3,86,nan,799,617,182,0,442,3,11,431,229,202
11W318,nan,11,Lichtenberg,318,W,3,86,nan,1312,1034,278,0,671,2,12,659,355,304
11W319,nan,11,Lichtenberg,319,W,3,86,nan,1085,807,278,0,482,0,13,469,255,214
11W320,nan,11,Lichtenberg,320,W,3,86,nan,1034,737,297,0,470,5,12,458,228,230
11W321,nan,11,Lichtenberg,321,W,3,86,nan,1052,793,259,0,488,0,10,478,257,221
11W322,nan,11,Lichtenberg,322,W,3,86,nan,1180,962,218,0,590,1,14,576,312,264
11W323,nan,11,Lichtenberg,323,W,3,86,nan,1301,1024,277,0,640,3,14,626,334,292
11W324,nan,11,Lichtenberg,324,W,3,86,nan,975,829,146,0,467,0,14,453,256,197
11W325,nan,11,Lichtenberg,325,W,3,86,nan,1305,1049,256,0,582,3,13,569,311,258
11W326,nan,11,Lichtenberg,326,W,3,86,nan,1728,1429,299,0,671,5,15,656,305,351
11W327,nan,11,Lichtenberg,327,W,3,86,nan,1218,927,291,0,608,7,31,577,306,271
11W328,nan,11,Lichtenberg,328,W,3,86,nan,1329,1041,288,0,743,3,19,724,362,362
11W329,nan,11,Lichtenberg,329,W,3,86,nan,1293,1041,252,0,621,3,17,604,304,300
11W401,nan,11,Lichtenberg,401,W,4,86,nan,1200,912,288,0,575,6,25,550,291,259
11W402,nan,11,Lichtenberg,402,W,4,86,nan,1231,943,288,0,680,9,15,665,336,329
11W403,nan,11,Lichtenberg,403,W,4,86,nan,1341,994,347,0,659,4,8,651,331,320
11W404,nan,11,Lichtenberg,404,W,4,86,nan,1019,769,250,0,556,1,14,542,256,286
11W405,nan,11,Lichtenberg,405,W,4,86,nan,1171,881,290,0,548,0,8,540,296,244
11W406,nan,11,Lichtenberg,406,W,4,86,nan,1307,992,315,0,663,4,16,647,325,322
11W407,nan,11,Lichtenberg,407,W,4,86,nan,1341,1061,280,0,715,4,26,689,334,355
11W408,nan,11,Lichtenberg,408,W,4,86,nan,1307,990,317,0,591,1,26,565,273,292
11W409,nan,11,Lichtenberg,409,W,4,86,nan,1196,955,241,0,593,4,11,582,318,264
11W410,nan,11,Lichtenberg,410,W,4,86,nan,1254,934,320,0,608,5,22,586,317,269
11W411,nan,11,Lichtenberg,411,W,4,86,nan,1544,1167,377,0,710,11,17,693,333,360
11W412,nan,11,Lichtenberg,412,W,4,86,nan,957,678,279,0,473,5,11,462,209,253
11W413,nan,11,Lichtenberg,413,W,4,86,nan,1498,1028,470,0,749,9,17,732,389,343
11W414,nan,11,Lichtenberg,414,W,4,86,nan,1221,895,326,0,577,1,9,568,272,296
11W415,nan,11,Lichtenberg,415,W,4,86,nan,1312,1047,265,0,716,6,35,681,341,340
11W416,nan,11,Lichtenberg,416,W,4,86,nan,1345,970,375,0,707,4,22,685,342,343
11W417,nan,11,Lichtenberg,417,W,4,86,nan,1334,974,360,0,654,4,20,634,335,299
11W418,nan,11,Lichtenberg,418,W,4,86,nan,1256,978,278,0,647,8,12,635,350,285
11W419,nan,11,Lichtenberg,419,W,4,86,nan,1263,909,354,0,636,4,11,625,328,297
11W420,nan,11,Lichtenberg,420,W,4,86,nan,1521,1176,345,0,785,1,26,759,361,398
11W421,nan,11,Lichtenberg,421,W,4,86,nan,1206,856,350,0,566,9,27,539,287,252
11W422,nan,11,Lichtenberg,422,W,4,86,nan,1300,966,334,0,661,2,14,647,354,293
11W423,nan,11,Lichtenberg,423,W,4,86,nan,1403,1026,377,0,712,5,18,694,374,320
11W424,nan,11,Lichtenberg,424,W,4,86,nan,1130,914,216,0,556,2,14,542,312,230
11W425,nan,11,Lichtenberg,425,W,4,86,nan,1219,916,303,0,656,6,12,644,295,349
11W426,nan,11,Lichtenberg,426,W,4,86,nan,970,747,223,0,486,4,6,480,250,230
11W427,nan,11,Lichtenberg,427,W,4,86,nan,1160,901,259,0,600,3,11,589,297,292
11W428,nan,11,Lichtenberg,428,W,4,86,nan,975,768,207,0,534,7,12,522,280,242
11W501,nan,11,Lichtenberg,501,W,5,86,nan,1303,1004,299,0,541,3,8,533,276,257
11W502,nan,11,Lichtenberg,502,W,5,86,nan,1573,1250,323,0,787,1,18,769,459,310
11W503,nan,11,Lichtenberg,503,W,5,86,nan,1343,1123,220,0,700,2,16,684,413,271
11W504,nan,11,Lichtenberg,504,W,5,86,nan,1057,815,242,0,471,4,11,460,247,213
11W505,nan,11,Lichtenberg,505,W,5,86,nan,1067,871,196,0,547,2,8,539,311,228
11W506,nan,11,Lichtenberg,506,W,5,86,nan,1126,894,232,0,546,2,11,535,301,234
11W507,nan,11,Lichtenberg,507,W,5,86,nan,958,748,210,0,496,2,19,477,287,190
11W508,nan,11,Lichtenberg,508,W,5,86,nan,1430,1176,254,0,748,0,15,733,400,333
11W509,nan,11,Lichtenberg,509,W,5,86,nan,1459,1184,275,0,737,4,18,719,375,344
11W510,nan,11,Lichtenberg,510,W,5,86,nan,1267,938,329,0,646,8,13,633,333,300
11W511,nan,11,Lichtenberg,511,W,5,86,nan,1064,808,256,0,568,2,11,557,312,245
11W512,nan,11,Lichtenberg,512,W,5,86,nan,1242,917,325,0,666,2,9,657,327,330
11W513,nan,11,Lichtenberg,513,W,5,86,nan,1216,897,319,0,567,4,12,555,291,264
11W514,nan,11,Lichtenberg,514,W,5,86,nan,1298,956,342,0,582,6,7,575,307,268
11W515,nan,11,Lichtenberg,515,W,5,86,nan,1125,866,259,0,579,10,15,564,321,243
11W516,nan,11,Lichtenberg,516,W,5,86,nan,1090,835,255,0,564,3,12,552,290,262
11W517,nan,11,Lichtenberg,517,W,5,86,nan,1063,763,300,0,580,7,14,566,287,279
11W518,nan,11,Lichtenberg,518,W,5,86,nan,1259,915,344,0,593,5,22,571,315,256
11W519,nan,11,Lichtenberg,519,W,5,86,nan,1476,1057,419,0,838,12,25,813,308,505
11W520,nan,11,Lichtenberg,520,W,5,86,nan,1264,930,334,0,744,12,22,722,284,438
11W521,nan,11,Lichtenberg,521,W,5,86,nan,1345,961,384,0,694,10,29,665,298,367
11W522,nan,11,Lichtenberg,522,W,5,86,nan,1051,777,274,0,571,10,15,556,257,299
11W523,nan,11,Lichtenberg,523,W,5,86,nan,1325,1011,314,0,694,0,5,689,339,350
11W524,nan,11,Lichtenberg,524,W,5,86,nan,1269,923,346,0,650,5,14,636,346,290
11W525,nan,11,Lichtenberg,525,W,5,86,nan,1269,988,281,0,629,1,22,607,328,279
11W526,nan,11,Lichtenberg,526,W,5,86,nan,1286,935,351,0,678,5,20,658,294,364
11W527,nan,11,Lichtenberg,527,W,5,86,nan,1139,850,289,0,583,3,13,570,275,295
11W528,nan,11,Lichtenberg,528,W,5,86,nan,1283,972,311,0,672,3,21,651,310,341
11W601,nan,11,Lichtenberg,601,W,6,86,nan,1269,1005,264,0,660,1,19,641,324,317
11W602,nan,11,Lichtenberg,602,W,6,86,nan,1299,961,338,0,704,1,22,682,303,379
11W603,nan,11,Lichtenberg,603,W,6,86,nan,1083,850,233,0,555,1,18,537,289,248
11W604,nan,11,Lichtenberg,604,W,6,86,nan,1006,738,268,0,515,6,13,502,247,255
11W605,nan,11,Lichtenberg,605,W,6,86,nan,1228,882,346,0,647,3,13,634,308,326
11W606,nan,11,Lichtenberg,606,W,6,86,nan,1173,877,296,0,593,0,12,581,298,283
11W607,nan,11,Lichtenberg,607,W,6,86,nan,1222,945,277,0,628,3,18,610,318,292
11W608,nan,11,Lichtenberg,608,W,6,86,nan,1087,862,225,0,547,2,14,533,267,266
11W609,nan,11,Lichtenberg,609,W,6,86,nan,1347,974,373,0,726,4,17,709,359,350
11W610,nan,11,Lichtenberg,610,W,6,86,nan,1395,1050,345,0,679,0,11,668,377,291
11W611,nan,11,Lichtenberg,611,W,6,86,nan,1628,1322,306,0,840,4,44,796,435,361
11W612,nan,11,Lichtenberg,612,W,6,86,nan,1290,1010,280,0,604,0,13,591,291,300
11W613,nan,11,Lichtenberg,613,W,6,86,nan,1249,886,363,0,723,10,20,703,287,416
11W614,nan,11,Lichtenberg,614,W,6,86,nan,1174,848,326,0,731,6,11,720,289,431
11W615,nan,11,Lichtenberg,615,W,6,86,nan,1275,997,278,0,712,14,14,698,349,349
11W616,nan,11,Lichtenberg,616,W,6,86,nan,1815,1362,453,0,961,5,6,955,487,468
11W617,nan,11,Lichtenberg,617,W,6,86,nan,981,674,307,0,549,2,7,542,253,289
11W618,nan,11,Lichtenberg,618,W,6,86,nan,1113,814,299,0,567,2,13,554,260,294
11W619,nan,11,Lichtenberg,619,W,6,86,nan,1174,865,309,0,670,10,9,661,317,344
11W620,nan,11,Lichtenberg,620,W,6,86,nan,1059,754,305,0,575,0,17,558,239,319
11W621,nan,11,Lichtenberg,621,W,6,86,nan,1461,1090,371,0,876,8,14,862,389,473
11W622,nan,11,Lichtenberg,622,W,6,86,nan,1302,932,370,0,744,5,19,725,319,406
11W623,nan,11,Lichtenberg,623,W,6,86,nan,1181,861,320,0,714,6,13,701,298,403
11W624,nan,11,Lichtenberg,624,W,6,86,nan,959,639,320,0,527,3,17,510,215,295
11W625,nan,11,Lichtenberg,625,W,6,86,nan,1158,857,301,0,709,10,15,694,293,401
11W626,nan,11,Lichtenberg,626,W,6,86,nan,1281,961,320,0,781,11,13,768,347,421
11W627,nan,11,Lichtenberg,627,W,6,86,nan,1399,948,451,0,775,9,16,759,299,460
11W628,nan,11,Lichtenberg,628,W,6,86,nan,1218,826,392,0,687,6,11,676,263,413
11W629,nan,11,Lichtenberg,629,W,6,86,nan,1144,797,347,0,641,2,19,622,278,344
11W630,nan,11,Lichtenberg,630,W,6,86,nan,963,708,255,0,632,0,6,626,217,409
12W101,nan,12,Reinickendorf,101,W,1,77,nan,1186,835,351,0,574,2,4,570,292,278
12W102,nan,12,Reinickendorf,102,W,1,77,nan,903,725,178,0,417,4,10,407,256,151
12W103,nan,12,Reinickendorf,103,W,1,77,nan,849,675,174,0,386,1,6,380,245,135
12W104,nan,12,Reinickendorf,104,W,1,77,nan,914,762,152,0,460,3,8,452,264,188
12W105,nan,12,Reinickendorf,105,W,1,77,nan,816,658,158,0,355,2,2,353,211,142
12W106,nan,12,Reinickendorf,106,W,1,77,nan,1142,946,196,0,551,0,9,542,282,260
12W107,nan,12,Reinickendorf,107,W,1,77,nan,892,737,155,0,508,1,4,504,242,262
12W108,nan,12,Reinickendorf,108,W,1,77,nan,1223,988,235,0,676,0,12,664,387,277
12W109,nan,12,Reinickendorf,109,W,1,77,nan,910,734,176,0,399,1,4,395,210,185
12W110,nan,12,Reinickendorf,110,W,1,77,nan,934,697,237,0,402,1,7,395,208,187
12W111,nan,12,Reinickendorf,111,W,1,77,nan,1183,979,204,0,593,2,4,589,324,265
12W112,nan,12,Reinickendorf,112,W,1,77,nan,1232,811,421,0,552,3,3,549,304,245
12W113,nan,12,Reinickendorf,113,W,1,77,nan,671,514,157,0,317,0,2,315,183,132
12W114,nan,12,Reinickendorf,114,W,1,77,nan,1747,1465,282,0,801,1,12,789,499,290
12W115,nan,12,Reinickendorf,115,W,1,77,nan,674,564,110,0,335,2,5,330,179,151
12W116,nan,12,Reinickendorf,116,W,1,77,nan,1071,846,225,0,519,3,8,511,305,206
12W117,nan,12,Reinickendorf,117,W,1,77,nan,1587,1194,393,0,677,0,11,666,355,311
12W118,nan,12,Reinickendorf,118,W,1,77,nan,1470,1182,288,0,570,1,14,556,302,254
12W119,nan,12,Reinickendorf,119,W,1,77,nan,1317,1081,236,0,691,2,12,679,359,320
12W120,nan,12,Reinickendorf,120,W,1,77,nan,1360,1127,233,0,674,2,8,666,317,349
12W121,nan,12,Reinickendorf,121,W,1,77,nan,1189,939,250,0,554,2,9,545,309,236
12W122,nan,12,Reinickendorf,122,W,1,77,nan,1477,1148,329,0,711,1,6,705,383,322
12W123,nan,12,Reinickendorf,123,W,1,77,nan,1511,1170,341,0,673,2,7,666,361,305
12W124,nan,12,Reinickendorf,124,W,1,77,nan,1048,848,200,0,481,0,8,473,282,191
12W125,nan,12,Reinickendorf,125,W,1,77,nan,1238,1019,219,0,557,1,8,549,323,226
12W126,nan,12,Reinickendorf,126,W,1,77,nan,1160,925,235,0,565,4,10,555,301,254
12W201,nan,12,Reinickendorf,201,W,2,77,nan,1096,882,214,0,602,2,1,601,444,157
12W202,nan,12,Reinickendorf,202,W,2,77,nan,1173,814,359,0,537,0,6,531,323,208
12W203,nan,12,Reinickendorf,203,W,2,77,nan,1418,957,461,0,715,3,4,711,335,376
12W204,nan,12,Reinickendorf,204,W,2,77,nan,763,553,210,0,410,2,2,408,223,185
12W205,nan,12,Reinickendorf,205,W,2,77,nan,782,591,191,0,438,1,5,433,215,218
12W206,nan,12,Reinickendorf,206,W,2,77,nan,1211,833,378,0,457,2,0,457,232,225
12W207,nan,12,Reinickendorf,207,W,2,77,nan,1458,1206,252,0,733,1,17,716,494,222
12W208,nan,12,Reinickendorf,208,W,2,77,nan,1309,1135,174,0,674,2,28,646,428,218
12W209,nan,12,Reinickendorf,209,W,2,77,nan,1250,944,306,0,542,0,5,537,355,182
12W210,nan,12,Reinickendorf,210,W,2,77,nan,1466,1051,415,0,703,2,2,701,442,259
12W211,nan,12,Reinickendorf,211,W,2,77,nan,1227,904,323,0,605,1,9,596,358,238
12W212,nan,12,Reinickendorf,212,W,2,77,nan,1657,1214,443,0,790,3,7,783,480,303
12W213,nan,12,Reinickendorf,213,W,2,77,nan,1647,1300,347,0,802,4,14,788,517,271
12W214,nan,12,Reinickendorf,214,W,2,77,nan,1079,826,253,0,572,7,13,559,344,215
12W215,nan,12,Reinickendorf,215,W,2,77,nan,1443,1142,301,0,720,4,8,712,419,293
12W216,nan,12,Reinickendorf,216,W,2,77,nan,1576,1230,346,0,749,0,8,741,466,275
12W217,nan,12,Reinickendorf,217,W,2,77,nan,1414,1150,264,0,677,4,7,670,379,291
12W218,nan,12,Reinickendorf,218,W,2,77,nan,1049,854,195,0,409,1,5,404,240,164
12W219,nan,12,Reinickendorf,219,W,2,77,nan,1106,798,308,0,539,7,0,539,229,310
12W220,nan,12,Reinickendorf,220,W,2,77,nan,1325,1117,208,0,555,3,13,542,394,148
12W221,nan,12,Reinickendorf,221,W,2,77,nan,1467,1081,386,0,656,1,5,651,395,256
12W222,nan,12,Reinickendorf,222,W,2,77,nan,983,828,155,0,423,0,6,417,224,193
12W223,nan,12,Reinickendorf,223,W,2,77,nan,584,408,176,0,327,2,1,326,85,241
12W224,nan,12,Reinickendorf,224,W,2,77,nan,354,268,86,0,184,0,1,183,139,44
12W225,nan,12,Reinickendorf,225,W,2,77,nan,1179,874,305,0,543,1,2,541,320,221
12W301,nan,12,Reinickendorf,301,W,3,77,nan,1536,1069,466,1,952,8,19,933,602,331
12W302,nan,12,Reinickendorf,302,W,3,77,nan,1010,706,304,0,574,1,6,568,375,193
12W303,nan,12,Reinickendorf,303,W,3,77,nan,1134,824,310,0,662,0,17,645,463,182
12W304,nan,12,Reinickendorf,304,W,3,77,nan,980,629,351,0,455,5,3,452,279,173
12W305,nan,12,Reinickendorf,305,W,3,77,nan,1405,893,512,0,771,3,10,761,486,275
12W306,nan,12,Reinickendorf,306,W,3,77,nan,1392,934,458,0,807,3,5,802,558,244
12W307,nan,12,Reinickendorf,307,W,3,77,nan,1395,969,426,0,809,8,3,806,574,232
12W308,nan,12,Reinickendorf,308,W,3,77,nan,1274,826,448,0,664,4,7,657,398,259
12W309,nan,12,Reinickendorf,309,W,3,77,nan,1340,982,358,0,681,1,8,673,453,220
12W310,nan,12,Reinickendorf,310,W,3,77,nan,1114,770,344,0,650,7,10,640,424,216
12W311,nan,12,Reinickendorf,311,W,3,77,nan,1258,768,490,0,624,2,10,614,410,204
12W312,nan,12,Reinickendorf,312,W,3,77,nan,1416,998,418,0,844,3,18,826,541,285
12W313,nan,12,Reinickendorf,313,W,3,77,nan,1262,788,474,0,642,8,6,636,363,273
12W314,nan,12,Reinickendorf,314,W,3,77,nan,1824,1261,563,0,999,4,15,984,657,327
12W315,nan,12,Reinickendorf,315,W,3,77,nan,1249,815,434,0,675,5,9,666,379,287
12W316,nan,12,Reinickendorf,316,W,3,77,nan,1674,1170,504,0,897,0,15,882,560,322
12W317,nan,12,Reinickendorf,317,W,3,77,nan,1702,1231,471,0,877,5,9,868,580,288
12W318,nan,12,Reinickendorf,318,W,3,77,nan,1197,822,375,0,709,7,8,701,359,342
12W319,nan,12,Reinickendorf,319,W,3,77,nan,1605,1316,289,0,871,1,14,857,618,239
12W320,nan,12,Reinickendorf,320,W,3,77,nan,960,773,187,0,482,2,4,478,323,155
12W321,nan,12,Reinickendorf,321,W,3,77,nan,1294,1022,272,0,643,3,10,633,422,211
12W322,nan,12,Reinickendorf,322,W,3,77,nan,1568,1221,347,0,819,4,10,809,524,285
12W323,nan,12,Reinickendorf,323,W,3,77,nan,1117,757,360,0,649,5,5,644,258,386
12W324,nan,12,Reinickendorf,324,W,3,77,nan,254,165,89,0,127,0,0,127,23,104
12W401,nan,12,Reinickendorf,401,W,4,77,nan,1383,934,449,0,753,7,9,744,476,268
12W402,nan,12,Reinickendorf,402,W,4,77,nan,1218,875,342,1,632,1,9,623,448,175
12W403,nan,12,Reinickendorf,403,W,4,77,nan,777,487,290,0,391,3,1,390,250,140
12W404,nan,12,Reinickendorf,404,W,4,77,nan,1521,1280,241,0,722,0,13,709,558,151
12W405,nan,12,Reinickendorf,405,W,4,77,nan,1618,1323,295,0,818,3,13,805,579,226
12W406,nan,12,Reinickendorf,406,W,4,77,nan,1809,1333,476,0,924,6,21,903,600,303
12W407,nan,12,Reinickendorf,407,W,4,77,nan,1172,820,352,0,689,4,3,686,455,231
12W408,nan,12,Reinickendorf,408,W,4,77,nan,1372,998,374,0,814,5,8,806,496,310
12W409,nan,12,Reinickendorf,409,W,4,77,nan,1113,792,321,0,590,4,9,581,414,167
12W410,nan,12,Reinickendorf,410,W,4,77,nan,1089,833,256,0,621,2,6,615,446,169
12W411,nan,12,Reinickendorf,411,W,4,77,nan,870,666,204,0,478,0,6,472,338,134
12W412,nan,12,Reinickendorf,412,W,4,77,nan,1652,1204,448,0,968,8,9,959,644,315
12W413,nan,12,Reinickendorf,413,W,4,77,nan,1468,971,497,0,799,6,7,792,504,288
12W414,nan,12,Reinickendorf,414,W,4,77,nan,1448,1023,425,0,736,5,5,731,454,277
12W415,nan,12,Reinickendorf,415,W,4,77,nan,1684,1161,523,0,775,0,8,767,541,226
12W416,nan,12,Reinickendorf,416,W,4,77,nan,1825,1426,399,0,1003,6,16,987,706,281
12W417,nan,12,Reinickendorf,417,W,4,77,nan,1596,1074,522,0,833,7,8,825,466,359
12W418,nan,12,Reinickendorf,418,W,4,77,nan,1169,965,204,0,580,2,4,576,413,163
12W419,nan,12,Reinickendorf,419,W,4,77,nan,1578,1182,396,0,758,0,4,754,519,235
12W420,nan,12,Reinickendorf,420,W,4,77,nan,1027,816,211,0,602,1,8,594,437,157
12W421,nan,12,Reinickendorf,421,W,4,77,nan,1046,788,258,0,618,4,13,605,399,206
12W422,nan,12,Reinickendorf,422,W,4,77,nan,1599,1232,367,0,831,2,6,825,532,293
12W423,nan,12,Reinickendorf,423,W,4,77,nan,1364,1026,338,0,730,3,9,721,497,224
12W424,nan,12,Reinickendorf,424,W,4,77,nan,772,594,178,0,391,0,5,386,239,147
12W425,nan,12,Reinickendorf,425,W,4,77,nan,1809,1360,448,1,970,6,1,969,630,339
12W426,nan,12,Reinickendorf,426,W,4,77,nan,655,486,169,0,350,0,2,348,221,127
12W501,nan,12,Reinickendorf,501,W,5,77,nan,854,575,279,0,491,2,2,489,299,190
12W502,nan,12,Reinickendorf,502,W,5,77,nan,1267,889,378,0,711,5,13,698,480,218
12W503,nan,12,Reinickendorf,503,W,5,77,nan,1722,1259,463,0,1030,5,11,1019,718,301
12W504,nan,12,Reinickendorf,504,W,5,77,nan,1295,1061,234,0,626,1,35,591,455,136
12W505,nan,12,Reinickendorf,505,W,5,77,nan,852,628,224,0,470,0,10,460,346,114
12W506,nan,12,Reinickendorf,506,W,5,77,nan,876,691,185,0,461,1,7,454,338,116
12W507,nan,12,Reinickendorf,507,W,5,77,nan,841,659,182,0,403,3,6,397,302,95
12W508,nan,12,Reinickendorf,508,W,5,77,nan,639,565,74,0,292,0,8,284,209,75
12W509,nan,12,Reinickendorf,509,W,5,77,nan,979,860,119,0,472,0,12,460,360,100
12W510,nan,12,Reinickendorf,510,W,5,77,nan,761,641,120,0,355,2,5,350,279,71
12W511,nan,12,Reinickendorf,511,W,5,77,nan,902,770,132,0,389,0,8,381,304,77
12W512,nan,12,Reinickendorf,512,W,5,77,nan,971,828,143,0,505,0,1,504,394,110
12W513,nan,12,Reinickendorf,513,W,5,77,nan,1460,1245,215,0,630,0,10,620,465,155
12W514,nan,12,Reinickendorf,514,W,5,77,nan,1337,1075,262,0,455,0,3,452,324,128
12W515,nan,12,Reinickendorf,515,W,5,77,nan,854,733,121,0,403,1,1,402,292,110
12W516,nan,12,Reinickendorf,516,W,5,77,nan,1267,1094,173,0,598,0,7,591,460,131
12W517,nan,12,Reinickendorf,517,W,5,77,nan,942,775,167,0,418,3,9,409,319,90
12W518,nan,12,Reinickendorf,518,W,5,77,nan,987,746,241,0,530,0,5,525,383,142
12W519,nan,12,Reinickendorf,519,W,5,77,nan,1088,881,207,0,546,0,13,533,396,137
12W520,nan,12,Reinickendorf,520,W,5,77,nan,1026,861,165,0,374,0,15,359,273,86
12W521,nan,12,Reinickendorf,521,W,5,77,nan,1069,789,280,0,523,0,3,520,371,149
12W522,nan,12,Reinickendorf,522,W,5,77,nan,811,673,138,0,363,0,1,362,259,103
12W523,nan,12,Reinickendorf,523,W,5,77,nan,1068,907,161,0,521,0,9,512,378,134
12W524,nan,12,Reinickendorf,524,W,5,77,nan,1157,1025,132,0,522,0,5,517,399,118
12W525,nan,12,Reinickendorf,525,W,5,77,nan,805,593,212,0,480,0,5,475,339,136
12W526,nan,12,Reinickendorf,526,W,5,77,nan,1448,1244,204,0,766,2,4,762,598,164
12W601,nan,12,Reinickendorf,601,W,6,77,nan,260,211,49,0,163,0,1,162,97,65
12W602,nan,12,Reinickendorf,602,W,6,77,nan,1389,908,481,0,814,4,9,805,557,248
12W603,nan,12,Reinickendorf,603,W,6,77,nan,1203,786,417,0,646,0,7,639,433,206
12W604,nan,12,Reinickendorf,604,W,6,77,nan,1055,698,357,0,598,5,5,593,385,208
12W605,nan,12,Reinickendorf,605,W,6,77,nan,929,556,373,0,486,8,12,474,301,173
12W606,nan,12,Reinickendorf,606,W,6,77,nan,1249,808,441,0,710,3,10,700,495,205
12W607,nan,12,Reinickendorf,607,W,6,77,nan,1020,693,327,0,567,3,5,562,394,168
12W608,nan,12,Reinickendorf,608,W,6,77,nan,765,504,261,0,415,1,9,406,297,109
12W609,nan,12,Reinickendorf,609,W,6,77,nan,1453,904,549,0,790,7,7,783,506,277
12W610,nan,12,Reinickendorf,610,W,6,77,nan,1013,656,357,0,569,5,6,563,383,180
12W611,nan,12,Reinickendorf,611,W,6,77,nan,841,568,273,0,497,6,7,490,332,158
12W612,nan,12,Reinickendorf,612,W,6,77,nan,1097,688,409,0,549,3,8,541,354,187
12W613,nan,12,Reinickendorf,613,W,6,77,nan,1127,721,406,0,600,7,14,586,384,202
12W614,nan,12,Reinickendorf,614,W,6,77,nan,1426,914,512,0,707,9,8,699,436,263
12W615,nan,12,Reinickendorf,615,W,6,77,nan,1790,1177,613,0,959,3,14,945,650,295
12W616,nan,12,Reinickendorf,616,W,6,77,nan,1442,932,510,0,823,3,6,817,550,267
12W617,nan,12,Reinickendorf,617,W,6,77,nan,1131,759,372,0,630,5,11,619,416,203
12W618,nan,12,Reinickendorf,618,W,6,77,nan,1433,943,490,0,794,5,13,781,512,269
12W619,nan,12,Reinickendorf,619,W,6,77,nan,1715,1121,594,0,952,1,16,936,604,332
12W620,nan,12,Reinickendorf,620,W,6,77,nan,1020,665,355,0,578,4,2,576,373,203
12W621,nan,12,Reinickendorf,621,W,6,77,nan,932,598,334,0,486,3,2,484,320,164
12W622,nan,12,Reinickendorf,622,W,6,77,nan,1071,685,386,0,593,3,3,590,381,209
12W623,nan,12,Reinickendorf,623,W,6,77,nan,891,536,355,0,487,4,7,480,307,173
12W624,nan,12,Reinickendorf,624,W,6,77,nan,1194,868,326,0,722,4,9,713,473,240
12W625,nan,12,Reinickendorf,625,W,6,77,nan,1104,773,331,0,661,10,11,650,428,222
01B1A,nan,01,Mitte,1A,B,1,75,O,0,0,0,0,1982,1982,2,1980,1223,757
01B1B,nan,01,Mitte,1B,B,1,75,O,0,0,0,0,1184,1184,5,1179,767,412
01B1C,nan,01,Mitte,1C,B,1,75,O,0,0,0,0,1063,1063,9,1054,611,443
01B1D,nan,01,Mitte,1D,B,1,75,O,0,0,0,0,1433,1433,208,1225,688,537
01B1E,nan,01,Mitte,1E,B,1,75,O,0,0,0,0,1494,1494,5,1489,860,629
01B2A,nan,01,Mitte,2A,B,2,75,O,0,0,0,0,1522,1522,7,1515,925,590
01B2B,nan,01,Mitte,2B,B,2,75,O,0,0,0,0,1334,1334,12,1322,733,589
01B2C,nan,01,Mitte,2C,B,2,75,O,0,0,0,0,1171,1171,10,1161,638,523
01B2D,nan,01,Mitte,2D,B,2,75,O,0,0,0,0,926,926,3,923,440,483
01B2E,nan,01,Mitte,2E,B,2,75,O,0,0,0,0,1104,1104,7,1097,557,540
01B2F,nan,01,Mitte,2F,B,2,75,O,0,0,0,0,1277,1277,10,1267,615,652
01B3A,nan,01,Mitte,3A,B,3,75,W,0,0,0,0,1026,1026,14,1012,587,425
01B3B,nan,01,Mitte,3B,B,3,75,W,0,0,0,0,1490,1490,159,1331,729,602
01B3C,nan,01,Mitte,3C,B,3,75,W,0,0,0,0,1344,1344,134,1210,721,489
01B3D,nan,01,Mitte,3D,B,3,75,W,0,0,0,0,1009,1009,10,999,616,383
01B3E,nan,01,Mitte,3E,B,3,75,W,0,0,0,0,1457,1457,12,1445,990,455
01B3F,nan,01,Mitte,3F,B,3,75,W,0,0,0,0,718,718,1,717,418,299
01B4A,nan,01,Mitte,4A,B,4,75,W,0,0,0,0,1144,1144,8,1136,742,394
01B4B,nan,01,Mitte,4B,B,4,75,W,0,0,0,0,1250,1250,11,1239,725,514
01B4C,nan,01,Mitte,4C,B,4,75,W,0,0,0,0,1061,1061,10,1051,589,462
01B4D,nan,01,Mitte,4D,B,4,75,W,0,0,0,0,1142,1142,12,1130,656,474
01B4E,nan,01,Mitte,4E,B,4,75,W,0,0,0,0,1487,1487,9,1478,792,686
01B5A,nan,01,Mitte,5A,B,5,75,W,0,0,0,0,1101,1101,4,1097,561,536
01B5B,nan,01,Mitte,5B,B,5,75,W,0,0,0,0,1024,1024,3,1021,478,543
01B5C,nan,01,Mitte,5C,B,5,75,W,0,0,0,0,893,893,5,888,460,428
01B5D,nan,01,Mitte,5D,B,5,75,W,0,0,0,0,1288,1288,12,1276,594,682
01B5E,nan,01,Mitte,5E,B,5,75,W,0,0,0,0,855,855,66,789,397,392
01B6A,nan,01,Mitte,6A,B,6,75,W,0,0,0,0,768,768,0,768,303,465
01B6B,nan,01,Mitte,6B,B,6,75,W,0,0,0,0,733,733,3,730,334,396
01B6C,nan,01,Mitte,6C,B,6,75,W,0,0,0,0,1016,1016,6,1010,470,540
01B6D,nan,01,Mitte,6D,B,6,75,W,0,0,0,0,797,797,10,787,410,377
01B6E,nan,01,Mitte,6E,B,6,75,W,0,0,0,0,879,879,79,800,411,389
01B7A,nan,01,Mitte,7A,B,7,75,W,0,0,0,0,1041,1041,10,1031,530,501
01B7B,nan,01,Mitte,7B,B,7,75,W,0,0,0,0,1163,1163,7,1156,619,537
01B7C,nan,01,Mitte,7C,B,7,75,W,0,0,0,0,759,759,9,750,451,299
01B7D,nan,01,Mitte,7D,B,7,75,W,0,0,0,0,571,571,3,568,366,202
01B7E,nan,01,Mitte,7E,B,7,75,W,0,0,0,0,934,934,6,928,548,380
02B1A,nan,02,Friedrichshain-Kreuzberg,1A,B,1,83,W,0,0,0,0,772,772,14,758,374,384
02B1B,nan,02,Friedrichshain-Kreuzberg,1B,B,1,83,W,0,0,0,0,707,707,7,700,307,393
02B1C,nan,02,Friedrichshain-Kreuzberg,1C,B,1,83,W,0,0,0,0,770,770,8,762,359,403
02B1D,nan,02,Friedrichshain-Kreuzberg,1D,B,1,83,W,0,0,0,0,688,688,8,680,281,399
02B1E,nan,02,Friedrichshain-Kreuzberg,1E,B,1,83,W,0,0,0,0,661,661,5,656,289,367
02B1F,nan,02,Friedrichshain-Kreuzberg,1F,B,1,83,W,0,0,0,0,734,734,9,725,325,400
02B1G,nan,02,Friedrichshain-Kreuzberg,1G,B,1,83,W,0,0,0,0,661,661,6,655,276,379
02B1H,nan,02,Friedrichshain-Kreuzberg,1H,B,1,83,W,0,0,0,0,638,638,6,632,244,388
02B1J,nan,02,Friedrichshain-Kreuzberg,1J,B,1,83,W,0,0,0,0,573,573,14,559,241,318
02B1K,nan,02,Friedrichshain-Kreuzberg,1K,B,1,83,W,0,0,0,0,441,441,6,435,169,266
02B1L,nan,02,Friedrichshain-Kreuzberg,1L,B,1,83,W,0,0,0,0,419,419,7,412,196,216
02B1M,nan,02,Friedrichshain-Kreuzberg,1M,B,1,83,W,0,0,0,0,449,449,6,443,226,217
02B1N,nan,02,Friedrichshain-Kreuzberg,1N,B,1,83,W,0,0,0,0,494,494,4,490,234,256
02B2A,nan,02,Friedrichshain-Kreuzberg,2A,B,2,83,W,0,0,0,0,439,439,7,432,192,240
02B2B,nan,02,Friedrichshain-Kreuzberg,2B,B,2,83,W,0,0,0,0,579,579,7,572,261,311
02B2C,nan,02,Friedrichshain-Kreuzberg,2C,B,2,83,W,0,0,0,0,430,430,3,427,180,247
02B2D,nan,02,Friedrichshain-Kreuzberg,2D,B,2,83,W,0,0,0,0,521,521,4,517,198,319
02B2E,nan,02,Friedrichshain-Kreuzberg,2E,B,2,83,W,0,0,0,0,388,388,8,380,165,215
02B2F,nan,02,Friedrichshain-Kreuzberg,2F,B,2,83,W,0,0,0,0,412,412,7,405,143,262
02B2G,nan,02,Friedrichshain-Kreuzberg,2G,B,2,83,W,0,0,0,0,425,425,9,416,180,236
02B2H,nan,02,Friedrichshain-Kreuzberg,2H,B,2,83,O,0,0,0,0,824,824,12,812,381,431
02B2J,nan,02,Friedrichshain-Kreuzberg,2J,B,2,83,O,0,0,0,0,756,756,14,742,303,439
02B2K,nan,02,Friedrichshain-Kreuzberg,2K,B,2,83,O,0,0,0,0,597,597,5,592,302,290
02B2L,nan,02,Friedrichshain-Kreuzberg,2L,B,2,83,O,0,0,0,0,595,595,8,587,278,309
02B2M,nan,02,Friedrichshain-Kreuzberg,2M,B,2,83,O,0,0,0,0,672,672,5,667,314,353
02B2N,nan,02,Friedrichshain-Kreuzberg,2N,B,2,83,O,0,0,0,0,558,558,8,550,245,305
02B3A,nan,02,Friedrichshain-Kreuzberg,3A,B,3,83,W,0,0,0,0,391,391,2,389,242,147
02B3B,nan,02,Friedrichshain-Kreuzberg,3B,B,3,83,W,0,0,0,0,331,331,5,326,166,160
02B3C,nan,02,Friedrichshain-Kreuzberg,3C,B,3,83,W,0,0,0,0,607,607,5,602,376,226
02B3D,nan,02,Friedrichshain-Kreuzberg,3D,B,3,83,W,0,0,0,0,551,551,10,541,337,204
02B3E,nan,02,Friedrichshain-Kreuzberg,3E,B,3,83,W,0,0,0,0,637,637,8,629,277,352
02B3F,nan,02,Friedrichshain-Kreuzberg,3F,B,3,83,W,0,0,0,0,461,461,4,457,270,187
02B3G,nan,02,Friedrichshain-Kreuzberg,3G,B,3,83,W,0,0,0,0,448,448,15,433,207,226
02B3H,nan,02,Friedrichshain-Kreuzberg,3H,B,3,83,W,0,0,0,0,693,693,7,686,246,440
02B3J,nan,02,Friedrichshain-Kreuzberg,3J,B,3,83,W,0,0,0,0,641,641,4,637,275,362
02B4A,nan,02,Friedrichshain-Kreuzberg,4A,B,4,83,O,0,0,0,0,531,531,5,526,262,264
02B4B,nan,02,Friedrichshain-Kreuzberg,4B,B,4,83,O,0,0,0,0,435,435,3,432,194,238
02B4C,nan,02,Friedrichshain-Kreuzberg,4C,B,4,83,O,0,0,0,0,506,506,7,499,243,256
02B4D,nan,02,Friedrichshain-Kreuzberg,4D,B,4,83,O,0,0,0,0,600,600,7,593,291,302
02B4E,nan,02,Friedrichshain-Kreuzberg,4E,B,4,83,O,0,0,0,0,522,522,6,516,229,287
02B4F,nan,02,Friedrichshain-Kreuzberg,4F,B,4,83,O,0,0,0,0,412,412,2,410,208,202
02B4G,nan,02,Friedrichshain-Kreuzberg,4G,B,4,83,O,0,0,0,0,566,566,7,559,251,308
02B4H,nan,02,Friedrichshain-Kreuzberg,4H,B,4,83,O,0,0,0,0,691,691,9,682,315,367
02B4J,nan,02,Friedrichshain-Kreuzberg,4J,B,4,83,O,0,0,0,0,482,482,1,481,249,232
02B4K,nan,02,Friedrichshain-Kreuzberg,4K,B,4,83,O,0,0,0,0,555,555,1,554,250,304
02B4L,nan,02,Friedrichshain-Kreuzberg,4L,B,4,83,O,0,0,0,0,598,598,5,593,271,322
02B4M,nan,02,Friedrichshain-Kreuzberg,4M,B,4,83,O,0,0,0,0,475,475,7,468,214,254
02B4N,nan,02,Friedrichshain-Kreuzberg,4N,B,4,83,O,0,0,0,0,584,584,4,580,299,281
02B5A,nan,02,Friedrichshain-Kreuzberg,5A,B,5,83,O,0,0,0,0,649,649,9,640,318,322
02B5B,nan,02,Friedrichshain-Kreuzberg,5B,B,5,83,O,0,0,0,0,527,527,12,515,210,305
02B5C,nan,02,Friedrichshain-Kreuzberg,5C,B,5,83,O,0,0,0,0,650,650,5,645,311,334
02B5D,nan,02,Friedrichshain-Kreuzberg,5D,B,5,83,O,0,0,0,0,820,820,11,809,377,432
02B5E,nan,02,Friedrichshain-Kreuzberg,5E,B,5,83,O,0,0,0,0,831,831,14,817,371,446
02B5F,nan,02,Friedrichshain-Kreuzberg,5F,B,5,83,O,0,0,0,0,467,467,4,463,229,234
02B5G,nan,02,Friedrichshain-Kreuzberg,5G,B,5,83,O,0,0,0,0,551,551,4,547,258,289
02B5H,nan,02,Friedrichshain-Kreuzberg,5H,B,5,83,O,0,0,0,0,544,544,9,535,251,284
02B5J,nan,02,Friedrichshain-Kreuzberg,5J,B,5,83,O,0,0,0,0,629,629,10,619,267,352
02B5K,nan,02,Friedrichshain-Kreuzberg,5K,B,5,83,O,0,0,0,0,649,649,9,640,269,371
02B5L,nan,02,Friedrichshain-Kreuzberg,5L,B,5,83,O,0,0,0,0,528,528,6,522,244,278
02B5M,nan,02,Friedrichshain-Kreuzberg,5M,B,5,83,O,0,0,0,0,817,817,16,801,378,423
02B5N,nan,02,Friedrichshain-Kreuzberg,5N,B,5,83,O,0,0,0,0,629,629,6,623,308,315
03B1A,nan,03,Pankow,1A,B,1,76,nan,0,0,0,0,824,824,2,822,406,416
03B1B,nan,03,Pankow,1B,B,1,76,nan,0,0,0,0,484,484,5,479,254,225
03B1C,nan,03,Pankow,1C,B,1,76,nan,0,0,0,0,371,371,3,368,215,153
03B1D,nan,03,Pankow,1D,B,1,76,nan,0,0,0,0,615,615,2,613,349,264
03B1E,nan,03,Pankow,1E,B,1,76,nan,0,0,0,0,397,397,5,392,208,184
03B1F,nan,03,Pankow,1F,B,1,76,nan,0,0,0,0,542,542,4,538,266,272
03B1G,nan,03,Pankow,1G,B,1,76,nan,0,0,0,0,608,608,2,606,308,298
03B1H,nan,03,Pankow,1H,B,1,76,nan,0,0,0,0,397,397,1,396,238,158
03B1I,nan,03,Pankow,1I,B,1,76,nan,0,0,0,0,600,600,3,597,271,326
03B1K,nan,03,Pankow,1K,B,1,76,nan,0,0,0,0,686,686,0,686,321,365
03B1L,nan,03,Pankow,1L,B,1,76,nan,0,0,0,0,578,578,0,578,314,264
03B2A,nan,03,Pankow,2A,B,2,76,nan,0,0,0,0,632,632,3,629,350,279
03B2B,nan,03,Pankow,2B,B,2,76,nan,0,0,0,0,488,488,6,482,270,212
03B2C,nan,03,Pankow,2C,B,2,76,nan,0,0,0,0,611,611,6,605,355,250
03B2D,nan,03,Pankow,2D,B,2,76,nan,0,0,0,0,930,930,3,927,465,462
03B2E,nan,03,Pankow,2E,B,2,76,nan,0,0,0,0,1022,1022,3,1019,416,603
03B2F,nan,03,Pankow,2F,B,2,76,nan,0,0,0,0,602,602,6,596,311,285
03B2G,nan,03,Pankow,2G,B,2,76,nan,0,0,0,0,721,721,2,719,334,385
03B2H,nan,03,Pankow,2H,B,2,76,nan,0,0,0,0,1027,1027,3,1024,437,587
03B2I,nan,03,Pankow,2I,B,2,76,nan,0,0,0,0,993,993,5,988,313,675
03B3A,nan,03,Pankow,3A,B,3,76,nan,0,0,0,0,649,649,3,646,273,373
03B3B,nan,03,Pankow,3B,B,3,76,nan,0,0,0,0,752,752,4,748,288,460
03B3C,nan,03,Pankow,3C,B,3,76,nan,0,0,0,0,803,803,6,797,281,516
03B3D,nan,03,Pankow,3D,B,3,76,nan,0,0,0,0,640,640,4,636,156,480
03B3E,nan,03,Pankow,3E,B,3,76,nan,0,0,0,0,616,616,3,613,196,417
03B3F,nan,03,Pankow,3F,B,3,76,nan,0,0,0,0,654,654,4,650,199,451
03B3G,nan,03,Pankow,3G,B,3,76,nan,0,0,0,0,1091,1091,8,1083,207,876
03B3H,nan,03,Pankow,3H,B,3,76,nan,0,0,0,0,1251,1251,5,1246,292,954
03B3I,nan,03,Pankow,3I,B,3,76,nan,0,0,0,0,1355,1355,6,1349,302,1047
03B4A,nan,03,Pankow,4A,B,4,76,nan,0,0,0,0,699,699,4,695,279,416
03B4B,nan,03,Pankow,4B,B,4,76,nan,0,0,0,0,900,900,6,894,350,544
03B4C,nan,03,Pankow,4C,B,4,76,nan,0,0,0,0,575,575,6,569,224,345
03B4D,nan,03,Pankow,4D,B,4,76,nan,0,0,0,0,554,554,4,550,274,276
03B4E,nan,03,Pankow,4E,B,4,76,nan,0,0,0,0,509,509,7,502,189,313
03B4F,nan,03,Pankow,4F,B,4,76,nan,0,0,0,0,504,504,2,502,220,282
03B4G,nan,03,Pankow,4G,B,4,76,nan,0,0,0,0,810,810,4,806,194,612
03B4H,nan,03,Pankow,4H,B,4,76,nan,0,0,0,0,1085,1085,1,1084,351,733
03B4I,nan,03,Pankow,4I,B,4,76,nan,0,0,0,0,415,415,1,414,202,212
03B5A,nan,03,Pankow,5A,B,5,76,nan,0,0,0,0,629,629,1,628,205,423
03B5B,nan,03,Pankow,5B,B,5,76,nan,0,0,0,0,651,651,2,649,221,428
03B5C,nan,03,Pankow,5C,B,5,76,nan,0,0,0,0,610,610,4,606,195,411
03B5D,nan,03,Pankow,5D,B,5,76,nan,0,0,0,0,582,582,6,576,224,352
03B5E,nan,03,Pankow,5E,B,5,76,nan,0,0,0,0,813,813,3,810,333,477
03B5F,nan,03,Pankow,5F,B,5,76,nan,0,0,0,0,728,728,3,725,255,470
03B5G,nan,03,Pankow,5G,B,5,76,nan,0,0,0,0,629,629,3,626,214,412
03B5H,nan,03,Pankow,5H,B,5,76,nan,0,0,0,0,688,688,8,680,199,481
03B5I,nan,03,Pankow,5I,B,5,76,nan,0,0,0,0,466,466,1,465,149,316
03B5K,nan,03,Pankow,5K,B,5,76,nan,0,0,0,0,691,691,4,687,110,577
03B6A,nan,03,Pankow,6A,B,6,76,nan,0,0,0,0,627,627,5,622,223,399
03B6B,nan,03,Pankow,6B,B,6,76,nan,0,0,0,0,633,633,9,624,282,342
03B6C,nan,03,Pankow,6C,B,6,76,nan,0,0,0,0,638,638,2,636,266,370
03B6D,nan,03,Pankow,6D,B,6,76,nan,0,0,0,0,913,913,4,909,423,486
03B6E,nan,03,Pankow,6E,B,6,76,nan,0,0,0,0,748,748,8,740,342,398
03B6F,nan,03,Pankow,6F,B,6,76,nan,0,0,0,0,707,707,7,700,315,385
03B6G,nan,03,Pankow,6G,B,6,76,nan,0,0,0,0,771,771,2,769,357,412
03B6H,nan,03,Pankow,6H,B,6,76,nan,0,0,0,0,997,997,11,986,483,503
03B6I,nan,03,Pankow,6I,B,6,76,nan,0,0,0,0,897,897,5,892,452,440
03B6K,nan,03,Pankow,6K,B,6,76,nan,0,0,0,0,809,809,5,804,352,452
03B7A,nan,03,Pankow,7A,B,7,76,nan,0,0,0,0,848,848,2,846,426,420
03B7B,nan,03,Pankow,7B,B,7,76,nan,0,0,0,0,518,518,4,514,255,259
03B7C,nan,03,Pankow,7C,B,7,83,O,0,0,0,0,632,632,5,627,275,352
03B7D,nan,03,Pankow,7D,B,7,83,O,0,0,0,0,783,783,6,777,406,371
03B7E,nan,03,Pankow,7E,B,7,83,O,0,0,0,0,581,581,1,580,278,302
03B7F,nan,03,Pankow,7F,B,7,76,nan,0,0,0,0,713,713,3,710,328,382
03B7G,nan,03,Pankow,7G,B,7,76,nan,0,0,0,0,1024,1024,0,1024,490,534
03B7H,nan,03,Pankow,7H,B,7,76,nan,0,0,0,0,719,719,3,716,314,402
03B7I,nan,03,Pankow,7I,B,7,76,nan,0,0,0,0,511,511,3,508,220,288
03B8A,nan,03,Pankow,8A,B,8,83,O,0,0,0,0,635,635,8,627,306,321
03B8B,nan,03,Pankow,8B,B,8,83,O,0,0,0,0,674,674,3,671,339,332
03B8C,nan,03,Pankow,8C,B,8,83,O,0,0,0,0,1049,1049,6,1043,521,522
03B8D,nan,03,Pankow,8D,B,8,83,O,0,0,0,0,751,751,4,747,368,379
03B8E,nan,03,Pankow,8E,B,8,76,nan,0,0,0,0,764,764,8,756,403,353
03B8F,nan,03,Pankow,8F,B,8,76,nan,0,0,0,0,773,773,5,768,369,399
03B8G,nan,03,Pankow,8G,B,8,76,nan,0,0,0,0,971,971,5,966,515,451
03B8H,nan,03,Pankow,8H,B,8,76,nan,0,0,0,0,688,688,2,686,329,357
03B8I,nan,03,Pankow,8I,B,8,76,nan,0,0,0,0,906,906,2,904,490,414
03B9A,nan,03,Pankow,9A,B,9,76,nan,0,0,0,0,516,516,0,516,214,302
03B9B,nan,03,Pankow,9B,B,9,76,nan,0,0,0,0,677,677,4,673,296,377
03B9C,nan,03,Pankow,9C,B,9,83,O,0,0,0,0,594,594,5,589,264,325
03B9D,nan,03,Pankow,9D,B,9,83,O,0,0,0,0,643,643,5,638,325,313
03B9E,nan,03,Pankow,9E,B,9,83,O,0,0,0,0,768,768,3,765,373,392
03B9F,nan,03,Pankow,9F,B,9,83,O,0,0,0,0,597,597,3,594,291,303
03B9G,nan,03,Pankow,9G,B,9,83,O,0,0,0,0,622,622,4,618,273,345
03B9H,nan,03,Pankow,9H,B,9,83,O,0,0,0,0,739,739,5,734,354,380
03B9I,nan,03,Pankow,9I,B,9,83,O,0,0,0,0,1051,1051,2,1049,455,594
03B9K,nan,03,Pankow,9K,B,9,83,O,0,0,0,0,375,375,3,372,191,181
04B1A,nan,04,Charlottenburg-Wilmersdorf,1A,B,1,78,nan,0,0,0,0,689,689,4,685,498,187
04B1B,nan,04,Charlottenburg-Wilmersdorf,1B,B,1,78,nan,0,0,0,0,697,697,3,694,459,235
04B1C,nan,04,Charlottenburg-Wilmersdorf,1C,B,1,78,nan,0,0,0,0,658,658,8,650,462,188
04B1D,nan,04,Charlottenburg-Wilmersdorf,1D,B,1,78,nan,0,0,0,0,1004,1004,10,994,745,249
04B1E,nan,04,Charlottenburg-Wilmersdorf,1E,B,1,78,nan,0,0,0,0,1070,1070,3,1067,741,326
04B2A,nan,04,Charlottenburg-Wilmersdorf,2A,B,2,80,nan,0,0,0,0,1001,1001,28,973,678,295
04B2B,nan,04,Charlottenburg-Wilmersdorf,2B,B,2,80,nan,0,0,0,0,815,815,1,814,586,228
04B2C,nan,04,Charlottenburg-Wilmersdorf,2C,B,2,80,nan,0,0,0,0,641,641,3,638,464,174
04B2D,nan,04,Charlottenburg-Wilmersdorf,2D,B,2,80,nan,0,0,0,0,894,894,4,890,627,263
04B2E,nan,04,Charlottenburg-Wilmersdorf,2E,B,2,80,nan,0,0,0,0,939,939,4,935,690,245
04B2F,nan,04,Charlottenburg-Wilmersdorf,2F,B,2,80,nan,0,0,0,0,774,774,0,774,590,184
04B2G,nan,04,Charlottenburg-Wilmersdorf,2G,B,2,80,nan,0,0,0,0,958,958,4,954,724,230
04B2H,nan,04,Charlottenburg-Wilmersdorf,2H,B,2,80,nan,0,0,0,0,949,949,5,944,681,263
04B2J,nan,04,Charlottenburg-Wilmersdorf,2J,B,2,80,nan,0,0,0,0,1040,1040,9,1031,763,268
04B3A,nan,04,Charlottenburg-Wilmersdorf,3A,B,3,80,nan,0,0,0,0,1162,1162,10,1152,808,344
04B3B,nan,04,Charlottenburg-Wilmersdorf,3B,B,3,80,nan,0,0,0,0,956,956,8,948,625,323
04B3C,nan,04,Charlottenburg-Wilmersdorf,3C,B,3,80,nan,0,0,0,0,995,995,6,989,715,274
04B3D,nan,04,Charlottenburg-Wilmersdorf,3D,B,3,80,nan,0,0,0,0,932,932,7,925,667,258
04B3E,nan,04,Charlottenburg-Wilmersdorf,3E,B,3,80,nan,0,0,0,0,1005,1005,4,1001,662,339
04B3F,nan,04,Charlottenburg-Wilmersdorf,3F,B,3,80,nan,0,0,0,0,1019,1019,9,1010,668,342
04B3G,nan,04,Charlottenburg-Wilmersdorf,3G,B,3,80,nan,0,0,0,0,891,891,7,884,612,272
04B3H,nan,04,Charlottenburg-Wilmersdorf,3H,B,3,80,nan,0,0,0,0,801,801,7,794,600,194
04B4A,nan,04,Charlottenburg-Wilmersdorf,4A,B,4,80,nan,0,0,0,0,891,891,10,881,610,271
04B4B,nan,04,Charlottenburg-Wilmersdorf,4B,B,4,80,nan,0,0,0,0,1282,1282,9,1273,1008,265
04B4C,nan,04,Charlottenburg-Wilmersdorf,4C,B,4,80,nan,0,0,0,0,940,940,4,936,671,265
04B4D,nan,04,Charlottenburg-Wilmersdorf,4D,B,4,80,nan,0,0,0,0,1056,1056,8,1048,755,293
04B4E,nan,04,Charlottenburg-Wilmersdorf,4E,B,4,80,nan,0,0,0,0,942,942,7,935,681,254
04B4F,nan,04,Charlottenburg-Wilmersdorf,4F,B,4,80,nan,0,0,0,0,974,974,8,966,710,256
04B4G,nan,04,Charlottenburg-Wilmersdorf,4G,B,4,80,nan,0,0,0,0,944,944,2,942,740,202
04B4H,nan,04,Charlottenburg-Wilmersdorf,4H,B,4,80,nan,0,0,0,0,860,860,5,855,670,185
04B5A,nan,04,Charlottenburg-Wilmersdorf,5A,B,5,80,nan,0,0,0,0,789,789,2,787,640,147
04B5B,nan,04,Charlottenburg-Wilmersdorf,5B,B,5,80,nan,0,0,0,0,823,823,4,819,628,191
04B5C,nan,04,Charlottenburg-Wilmersdorf,5C,B,5,80,nan,0,0,0,0,811,811,6,805,565,240
04B5D,nan,04,Charlottenburg-Wilmersdorf,5D,B,5,80,nan,0,0,0,0,947,947,3,944,707,237
04B5E,nan,04,Charlottenburg-Wilmersdorf,5E,B,5,80,nan,0,0,0,0,927,927,3,924,668,256
04B5F,nan,04,Charlottenburg-Wilmersdorf,5F,B,5,80,nan,0,0,0,0,1119,1119,10,1109,876,233
04B5G,nan,04,Charlottenburg-Wilmersdorf,5G,B,5,80,nan,0,0,0,0,648,648,3,645,510,135
04B5H,nan,04,Charlottenburg-Wilmersdorf,5H,B,5,80,nan,0,0,0,0,987,987,6,981,839,142
04B5J,nan,04,Charlottenburg-Wilmersdorf,5J,B,5,80,nan,0,0,0,0,827,827,4,823,655,168
04B6A,nan,04,Charlottenburg-Wilmersdorf,6A,B,6,80,nan,0,0,0,0,981,981,3,978,734,244
04B6B,nan,04,Charlottenburg-Wilmersdorf,6B,B,6,80,nan,0,0,0,0,763,763,2,761,529,232
04B6C,nan,04,Charlottenburg-Wilmersdorf,6C,B,6,80,nan,0,0,0,0,1284,1284,10,1274,915,359
04B6D,nan,04,Charlottenburg-Wilmersdorf,6D,B,6,80,nan,0,0,0,0,1058,1058,9,1049,685,364
04B6E,nan,04,Charlottenburg-Wilmersdorf,6E,B,6,80,nan,0,0,0,0,934,934,7,927,589,338
04B6F,nan,04,Charlottenburg-Wilmersdorf,6F,B,6,80,nan,0,0,0,0,879,879,3,876,586,290
04B6G,nan,04,Charlottenburg-Wilmersdorf,6G,B,6,80,nan,0,0,0,0,822,822,5,817,473,344
04B6H,nan,04,Charlottenburg-Wilmersdorf,6H,B,6,80,nan,0,0,0,0,893,893,4,889,616,273
04B7A,nan,04,Charlottenburg-Wilmersdorf,7A,B,7,80,nan,0,0,0,0,907,907,9,898,636,262
04B7B,nan,04,Charlottenburg-Wilmersdorf,7B,B,7,80,nan,0,0,0,0,813,813,6,807,606,201
04B7C,nan,04,Charlottenburg-Wilmersdorf,7C,B,7,80,nan,0,0,0,0,1008,1008,10,998,632,366
04B7D,nan,04,Charlottenburg-Wilmersdorf,7D,B,7,80,nan,0,0,0,0,1058,1058,9,1049,679,370
04B7E,nan,04,Charlottenburg-Wilmersdorf,7E,B,7,80,nan,0,0,0,0,1061,1061,9,1052,757,295
04B7F,nan,04,Charlottenburg-Wilmersdorf,7F,B,7,80,nan,0,0,0,0,1105,1105,7,1098,738,360
04B7G,nan,04,Charlottenburg-Wilmersdorf,7G,B,7,80,nan,0,0,0,0,1096,1096,2,1094,706,388
04B7H,nan,04,Charlottenburg-Wilmersdorf,7H,B,7,80,nan,0,0,0,0,861,861,5,856,627,229
04B8A,nan,04,Charlottenburg-Wilmersdorf,8A,B,1,80,nan,0,0,0,0,988,988,17,971,676,295
04B8B,nan,04,Charlottenburg-Wilmersdorf,8B,B,1,80,nan,0,0,0,0,1183,1183,10,1173,676,497
05B1A,nan,05,Spandau,1A,B,1,78,nan,0,0,0,0,780,780,4,776,424,352
05B1B,nan,05,Spandau,1B,B,1,78,nan,0,0,0,0,639,639,2,637,342,295
05B1C,nan,05,Spandau,1C,B,1,78,nan,0,0,0,0,942,942,5,937,446,491
05B1D,nan,05,Spandau,1D,B,1,78,nan,0,0,0,0,716,716,3,713,341,372
05B1E,nan,05,Spandau,1E,B,1,78,nan,0,0,0,0,787,787,2,785,359,426
05B1F,nan,05,Spandau,1F,B,1,78,nan,0,0,0,0,770,770,3,767,254,513
05B1G,nan,05,Spandau,1G,B,1,78,nan,0,0,0,0,760,760,1,759,412,347
05B1H,nan,05,Spandau,1H,B,1,78,nan,0,0,0,0,722,722,1,721,362,359
05B2A,nan,05,Spandau,2A,B,2,78,nan,0,0,0,0,694,694,2,692,316,376
05B2B,nan,05,Spandau,2B,B,2,78,nan,0,0,0,0,718,718,3,715,351,364
05B2C,nan,05,Spandau,2C,B,2,78,nan,0,0,0,0,716,716,0,716,430,286
05B2D,nan,05,Spandau,2D,B,2,78,nan,0,0,0,0,715,715,4,711,360,351
05B2E,nan,05,Spandau,2E,B,2,78,nan,0,0,0,0,611,611,5,606,272,334
05B2F,nan,05,Spandau,2F,B,2,78,nan,0,0,0,0,709,709,4,705,511,194
05B2G,nan,05,Spandau,2G,B,2,78,nan,0,0,0,0,751,751,3,748,525,223
05B3A,nan,05,Spandau,3A,B,3,78,nan,0,0,0,0,687,687,3,684,465,219
05B3B,nan,05,Spandau,3B,B,3,78,nan,0,0,0,0,701,701,3,698,467,231
05B3C,nan,05,Spandau,3C,B,3,78,nan,0,0,0,0,669,669,5,664,450,214
05B3D,nan,05,Spandau,3D,B,3,78,nan,0,0,0,0,905,905,1,904,640,264
05B3E,nan,05,Spandau,3E,B,3,78,nan,0,0,0,0,777,777,3,774,512,262
05B3F,nan,05,Spandau,3F,B,3,78,nan,0,0,0,0,807,807,4,803,444,359
05B3G,nan,05,Spandau,3G,B,3,78,nan,0,0,0,0,793,793,3,790,443,347
05B3H,nan,05,Spandau,3H,B,3,78,nan,0,0,0,0,875,875,1,874,366,508
05B4A,nan,05,Spandau,4A,B,4,78,nan,0,0,0,0,980,980,3,977,227,750
05B4B,nan,05,Spandau,4B,B,4,78,nan,0,0,0,0,552,552,1,551,233,318
05B4C,nan,05,Spandau,4C,B,4,78,nan,0,0,0,0,872,872,3,869,326,543
05B4D,nan,05,Spandau,4D,B,4,78,nan,0,0,0,0,673,673,2,671,388,283
05B4E,nan,05,Spandau,4E,B,4,78,nan,0,0,0,0,675,675,0,675,424,251
05B4F,nan,05,Spandau,4F,B,4,78,nan,0,0,0,0,817,817,2,815,530,285
05B4G,nan,05,Spandau,4G,B,4,78,nan,0,0,0,0,892,892,5,887,508,379
05B4H,nan,05,Spandau,4H,B,4,78,nan,0,0,0,0,845,845,0,845,203,642
05B5A,nan,05,Spandau,5A,B,5,78,nan,0,0,0,0,747,747,2,745,497,248
05B5B,nan,05,Spandau,5B,B,5,78,nan,0,0,0,0,737,737,8,729,422,307
05B5C,nan,05,Spandau,5C,B,5,78,nan,0,0,0,0,766,766,12,754,506,248
05B5D,nan,05,Spandau,5D,B,5,78,nan,0,0,0,0,642,642,5,637,452,185
05B5E,nan,05,Spandau,5E,B,5,78,nan,0,0,0,0,618,618,7,611,426,185
05B5F,nan,05,Spandau,5F,B,5,78,nan,0,0,0,0,871,871,4,867,585,282
05B5G,nan,05,Spandau,5G,B,5,78,nan,0,0,0,0,905,905,8,897,645,252
05B5H,nan,05,Spandau,5H,B,5,78,nan,0,0,0,0,709,709,0,709,511,198
05B5I,nan,05,Spandau,5I,B,5,78,nan,0,0,0,0,547,547,2,545,404,141
05B5J,nan,05,Spandau,5J,B,5,78,nan,0,0,0,0,490,490,0,490,378,112
05B5K,nan,05,Spandau,5K,B,5,78,nan,0,0,0,0,568,568,2,566,408,158
05B5L,nan,05,Spandau,5L,B,5,78,nan,0,0,0,0,614,614,3,611,443,168
06B1A,nan,06,Steglitz-Zehlendorf,1A,B,1,79,nan,0,0,0,0,1098,1098,17,1081,734,347
06B1B,nan,06,Steglitz-Zehlendorf,1B,B,1,79,nan,0,0,0,0,1113,1113,5,1108,740,368
06B1C,nan,06,Steglitz-Zehlendorf,1C,B,1,79,nan,0,0,0,0,913,913,8,905,583,322
06B1D,nan,06,Steglitz-Zehlendorf,1D,B,1,79,nan,0,0,0,0,782,782,3,779,509,270
06B1E,nan,06,Steglitz-Zehlendorf,1E,B,1,79,nan,0,0,0,0,816,816,8,808,575,233
06B1F,nan,06,Steglitz-Zehlendorf,1F,B,1,79,nan,0,0,0,0,804,804,9,795,561,234
06B1G,nan,06,Steglitz-Zehlendorf,1G,B,1,79,nan,0,0,0,0,1116,1116,13,1103,724,379
06B1H,nan,06,Steglitz-Zehlendorf,1H,B,1,79,nan,0,0,0,0,970,970,4,966,629,337
06B1I,nan,06,Steglitz-Zehlendorf,1I,B,1,79,nan,0,0,0,0,1016,1016,6,1010,659,351
06B2A,nan,06,Steglitz-Zehlendorf,2A,B,2,79,nan,0,0,0,0,968,968,6,962,611,351
06B2B,nan,06,Steglitz-Zehlendorf,2B,B,2,79,nan,0,0,0,0,802,802,4,798,546,252
06B2C,nan,06,Steglitz-Zehlendorf,2C,B,2,79,nan,0,0,0,0,708,708,2,706,502,204
06B2D,nan,06,Steglitz-Zehlendorf,2D,B,2,79,nan,0,0,0,0,911,911,12,899,650,249
06B2E,nan,06,Steglitz-Zehlendorf,2E,B,2,79,nan,0,0,0,0,863,863,7,856,577,279
06B2F,nan,06,Steglitz-Zehlendorf,2F,B,2,79,nan,0,0,0,0,805,805,4,801,574,227
06B2G,nan,06,Steglitz-Zehlendorf,2G,B,2,79,nan,0,0,0,0,1048,1048,10,1038,710,328
06B2H,nan,06,Steglitz-Zehlendorf,2H,B,2,79,nan,0,0,0,0,738,738,9,729,488,241
06B2I,nan,06,Steglitz-Zehlendorf,2I,B,2,79,nan,0,0,0,0,893,893,9,884,595,289
06B3A,nan,06,Steglitz-Zehlendorf,3A,B,3,79,nan,0,0,0,0,1095,1095,4,1091,767,324
06B3B,nan,06,Steglitz-Zehlendorf,3B,B,3,79,nan,0,0,0,0,972,972,5,967,641,326
06B3C,nan,06,Steglitz-Zehlendorf,3C,B,3,79,nan,0,0,0,0,950,950,6,944,673,271
06B3D,nan,06,Steglitz-Zehlendorf,3D,B,3,79,nan,0,0,0,0,1048,1048,7,1041,699,342
06B3E,nan,06,Steglitz-Zehlendorf,3E,B,3,79,nan,0,0,0,0,1241,1241,1,1240,888,352
06B3F,nan,06,Steglitz-Zehlendorf,3F,B,3,79,nan,0,0,0,0,1039,1039,4,1035,746,289
06B3G,nan,06,Steglitz-Zehlendorf,3G,B,3,79,nan,0,0,0,0,1172,1172,10,1162,854,308
06B3H,nan,06,Steglitz-Zehlendorf,3H,B,3,79,nan,0,0,0,0,1084,1084,9,1075,788,287
06B3I,nan,06,Steglitz-Zehlendorf,3I,B,3,79,nan,0,0,0,0,1151,1151,8,1143,847,296
06B4A,nan,06,Steglitz-Zehlendorf,4A,B,4,79,nan,0,0,0,0,875,875,4,871,643,228
06B4B,nan,06,Steglitz-Zehlendorf,4B,B,4,79,nan,0,0,0,0,934,934,6,928,667,261
06B4C,nan,06,Steglitz-Zehlendorf,4C,B,4,79,nan,0,0,0,0,1026,1026,6,1020,679,341
06B4D,nan,06,Steglitz-Zehlendorf,4D,B,4,79,nan,0,0,0,0,805,805,4,801,578,223
06B4E,nan,06,Steglitz-Zehlendorf,4E,B,4,79,nan,0,0,0,0,1014,1014,8,1006,732,274
06B4F,nan,06,Steglitz-Zehlendorf,4F,B,4,79,nan,0,0,0,0,889,889,0,889,672,217
06B4G,nan,06,Steglitz-Zehlendorf,4G,B,4,79,nan,0,0,0,0,876,876,7,869,643,226
06B4H,nan,06,Steglitz-Zehlendorf,4H,B,4,79,nan,0,0,0,0,846,846,3,843,597,246
06B5A,nan,06,Steglitz-Zehlendorf,5A,B,5,79,nan,0,0,0,0,750,750,5,745,522,223
06B5B,nan,06,Steglitz-Zehlendorf,5B,B,5,79,nan,0,0,0,0,981,981,8,973,684,289
06B5C,nan,06,Steglitz-Zehlendorf,5C,B,5,79,nan,0,0,0,0,649,649,8,641,467,174
06B5D,nan,06,Steglitz-Zehlendorf,5D,B,5,79,nan,0,0,0,0,845,845,3,842,597,245
06B5E,nan,06,Steglitz-Zehlendorf,5E,B,5,79,nan,0,0,0,0,748,748,6,742,523,219
06B5F,nan,06,Steglitz-Zehlendorf,5F,B,5,79,nan,0,0,0,0,580,580,0,580,450,130
06B5G,nan,06,Steglitz-Zehlendorf,5G,B,5,79,nan,0,0,0,0,701,701,8,693,545,148
06B5H,nan,06,Steglitz-Zehlendorf,5H,B,5,79,nan,0,0,0,0,785,785,0,785,599,186
06B5I,nan,06,Steglitz-Zehlendorf,5I,B,5,79,nan,0,0,0,0,553,553,2,551,422,129
06B6A,nan,06,Steglitz-Zehlendorf,6A,B,6,79,nan,0,0,0,0,882,882,5,877,610,267
06B6B,nan,06,Steglitz-Zehlendorf,6B,B,6,79,nan,0,0,0,0,872,872,11,861,582,279
06B6C,nan,06,Steglitz-Zehlendorf,6C,B,6,79,nan,0,0,0,0,1004,1004,4,1000,692,308
06B6D,nan,06,Steglitz-Zehlendorf,6D,B,6,79,nan,0,0,0,0,1060,1060,7,1053,734,319
06B6E,nan,06,Steglitz-Zehlendorf,6E,B,6,79,nan,0,0,0,0,1164,1164,8,1156,860,296
06B6F,nan,06,Steglitz-Zehlendorf,6F,B,6,79,nan,0,0,0,0,1069,1069,10,1059,739,320
06B6G,nan,06,Steglitz-Zehlendorf,6G,B,6,79,nan,0,0,0,0,880,880,8,872,641,231
06B6H,nan,06,Steglitz-Zehlendorf,6H,B,6,79,nan,0,0,0,0,1024,1024,11,1013,690,323
06B6I,nan,06,Steglitz-Zehlendorf,6I,B,6,79,nan,0,0,0,0,1563,1563,5,1558,1256,302
06B7A,nan,06,Steglitz-Zehlendorf,7A,B,7,79,nan,0,0,0,0,832,832,5,827,614,213
06B7B,nan,06,Steglitz-Zehlendorf,7B,B,7,79,nan,0,0,0,0,1000,1000,4,996,753,243
06B7C,nan,06,Steglitz-Zehlendorf,7C,B,7,79,nan,0,0,0,0,819,819,0,819,611,208
06B7D,nan,06,Steglitz-Zehlendorf,7D,B,7,79,nan,0,0,0,0,1157,1157,3,1154,846,308
06B7E,nan,06,Steglitz-Zehlendorf,7E,B,7,79,nan,0,0,0,0,891,891,7,884,642,242
06B7F,nan,06,Steglitz-Zehlendorf,7F,B,7,79,nan,0,0,0,0,908,908,5,903,629,274
06B7G,nan,06,Steglitz-Zehlendorf,7G,B,7,79,nan,0,0,0,0,1181,1181,1,1180,875,305
06B7H,nan,06,Steglitz-Zehlendorf,7H,B,7,79,nan,0,0,0,0,1270,1270,10,1260,900,360
06B7I,nan,06,Steglitz-Zehlendorf,7I,B,7,79,nan,0,0,0,0,1067,1067,8,1059,788,271
07B1A,nan,07,Tempelhof-Schöneberg,1A,B,1,81,nan,0,0,0,0,860,860,4,856,620,236
07B1B,nan,07,Tempelhof-Schöneberg,1B,B,1,81,nan,0,0,0,0,630,630,7,623,364,259
07B1C,nan,07,Tempelhof-Schöneberg,1C,B,1,81,nan,0,0,0,0,762,762,12,750,378,372
07B1D,nan,07,Tempelhof-Schöneberg,1D,B,1,81,nan,0,0,0,0,781,781,3,778,428,350
07B1E,nan,07,Tempelhof-Schöneberg,1E,B,1,81,nan,0,0,0,0,1173,1173,1,1172,719,453
07B1F,nan,07,Tempelhof-Schöneberg,1F,B,1,81,nan,0,0,0,0,1055,1055,1,1054,700,354
07B1G,nan,07,Tempelhof-Schöneberg,1G,B,1,81,nan,0,0,0,0,1068,1068,11,1057,650,407
07B1H,nan,07,Tempelhof-Schöneberg,1H,B,1,81,nan,0,0,0,0,989,989,3,986,666,320
07B1I,nan,07,Tempelhof-Schöneberg,1I,B,1,81,nan,0,0,0,0,883,883,8,875,515,360
07B2A,nan,07,Tempelhof-Schöneberg,2A,B,2,81,nan,0,0,0,0,1110,1110,13,1097,668,429
07B2B,nan,07,Tempelhof-Schöneberg,2B,B,2,81,nan,0,0,0,0,1103,1103,20,1083,901,182
07B2C,nan,07,Tempelhof-Schöneberg,2C,B,2,81,nan,0,0,0,0,791,791,6,785,398,387
07B2D,nan,07,Tempelhof-Schöneberg,2D,B,2,81,nan,0,0,0,0,732,732,7,725,403,322
07B2E,nan,07,Tempelhof-Schöneberg,2E,B,2,81,nan,0,0,0,0,803,803,16,787,385,402
07B2F,nan,07,Tempelhof-Schöneberg,2F,B,2,81,nan,0,0,0,0,821,821,9,812,334,478
07B2G,nan,07,Tempelhof-Schöneberg,2G,B,2,81,nan,0,0,0,0,956,956,10,946,574,372
07B2H,nan,07,Tempelhof-Schöneberg,2H,B,2,81,nan,0,0,0,0,950,950,6,944,466,478
07B2I,nan,07,Tempelhof-Schöneberg,2I,B,2,81,nan,0,0,0,0,604,604,5,599,268,331
07B3A,nan,07,Tempelhof-Schöneberg,3A,B,3,81,nan,0,0,0,0,1005,1005,11,994,565,429
07B3B,nan,07,Tempelhof-Schöneberg,3B,B,3,81,nan,0,0,0,0,885,885,7,878,488,390
07B3C,nan,07,Tempelhof-Schöneberg,3C,B,3,81,nan,0,0,0,0,1077,1077,6,1071,584,487
07B3D,nan,07,Tempelhof-Schöneberg,3D,B,3,81,nan,0,0,0,0,1043,1043,5,1038,552,486
07B3E,nan,07,Tempelhof-Schöneberg,3E,B,3,81,nan,0,0,0,0,1139,1139,5,1134,623,511
07B3F,nan,07,Tempelhof-Schöneberg,3F,B,3,81,nan,0,0,0,0,900,900,4,896,545,351
07B3G,nan,07,Tempelhof-Schöneberg,3G,B,3,81,nan,0,0,0,0,1164,1164,5,1159,696,463
07B3H,nan,07,Tempelhof-Schöneberg,3H,B,3,81,nan,0,0,0,0,620,620,6,614,306,308
07B3I,nan,07,Tempelhof-Schöneberg,3I,B,3,81,nan,0,0,0,0,635,635,9,626,380,246
07B3K,nan,07,Tempelhof-Schöneberg,3K,B,3,81,nan,0,0,0,0,702,702,3,699,519,180
07B4A,nan,07,Tempelhof-Schöneberg,4A,B,4,81,nan,0,0,0,0,938,938,7,931,476,455
07B4B,nan,07,Tempelhof-Schöneberg,4B,B,4,81,nan,0,0,0,0,843,843,7,836,462,374
07B4C,nan,07,Tempelhof-Schöneberg,4C,B,4,81,nan,0,0,0,0,855,855,16,839,558,281
07B4D,nan,07,Tempelhof-Schöneberg,4D,B,4,81,nan,0,0,0,0,1055,1055,9,1046,749,297
07B4E,nan,07,Tempelhof-Schöneberg,4E,B,4,81,nan,0,0,0,0,1069,1069,7,1062,703,359
07B4F,nan,07,Tempelhof-Schöneberg,4F,B,4,81,nan,0,0,0,0,819,819,6,813,506,307
07B4G,nan,07,Tempelhof-Schöneberg,4G,B,4,81,nan,0,0,0,0,1018,1018,15,1003,574,429
07B4H,nan,07,Tempelhof-Schöneberg,4H,B,4,81,nan,0,0,0,0,1010,1010,8,1002,620,382
07B4I,nan,07,Tempelhof-Schöneberg,4I,B,4,81,nan,0,0,0,0,326,326,2,324,198,126
07B5A,nan,07,Tempelhof-Schöneberg,5A,B,5,81,nan,0,0,0,0,824,824,4,820,581,239
07B5B,nan,07,Tempelhof-Schöneberg,5B,B,5,81,nan,0,0,0,0,756,756,9,747,504,243
07B5C,nan,07,Tempelhof-Schöneberg,5C,B,5,81,nan,0,0,0,0,741,741,4,737,495,242
07B5D,nan,07,Tempelhof-Schöneberg,5D,B,5,81,nan,0,0,0,0,875,875,8,867,629,238
07B5E,nan,07,Tempelhof-Schöneberg,5E,B,5,81,nan,0,0,0,0,993,993,5,988,724,264
07B5F,nan,07,Tempelhof-Schöneberg,5F,B,5,81,nan,0,0,0,0,681,681,3,678,489,189
07B5G,nan,07,Tempelhof-Schöneberg,5G,B,5,81,nan,0,0,0,0,853,853,6,847,661,186
07B5H,nan,07,Tempelhof-Schöneberg,5H,B,5,81,nan,0,0,0,0,915,915,6,909,636,273
07B5I,nan,07,Tempelhof-Schöneberg,5I,B,5,81,nan,0,0,0,0,519,519,3,516,361,155
07B6A,nan,07,Tempelhof-Schöneberg,6A,B,6,81,nan,0,0,0,0,877,877,12,865,622,243
07B6B,nan,07,Tempelhof-Schöneberg,6B,B,6,81,nan,0,0,0,0,1202,1202,10,1192,844,348
07B6C,nan,07,Tempelhof-Schöneberg,6C,B,6,81,nan,0,0,0,0,813,813,10,803,582,221
07B6D,nan,07,Tempelhof-Schöneberg,6D,B,6,81,nan,0,0,0,0,655,655,1,654,460,194
07B6E,nan,07,Tempelhof-Schöneberg,6E,B,6,81,nan,0,0,0,0,834,834,1,833,664,169
07B6F,nan,07,Tempelhof-Schöneberg,6F,B,6,81,nan,0,0,0,0,568,568,6,562,424,138
07B6G,nan,07,Tempelhof-Schöneberg,6G,B,6,81,nan,0,0,0,0,644,644,1,643,492,151
07B6H,nan,07,Tempelhof-Schöneberg,6H,B,6,81,nan,0,0,0,0,1059,1059,2,1057,804,253
07B6I,nan,07,Tempelhof-Schöneberg,6I,B,6,81,nan,0,0,0,0,572,572,0,572,428,144
07B7A,nan,07,Tempelhof-Schöneberg,7A,B,7,81,nan,0,0,0,0,984,984,8,976,740,236
07B7B,nan,07,Tempelhof-Schöneberg,7B,B,7,81,nan,0,0,0,0,1018,1018,4,1014,763,251
07B7C,nan,07,Tempelhof-Schöneberg,7C,B,7,81,nan,0,0,0,0,857,857,4,853,642,211
07B7D,nan,07,Tempelhof-Schöneberg,7D,B,7,81,nan,0,0,0,0,1008,1008,7,1001,781,220
07B7E,nan,07,Tempelhof-Schöneberg,7E,B,7,81,nan,0,0,0,0,706,706,7,699,539,160
07B7F,nan,07,Tempelhof-Schöneberg,7F,B,7,81,nan,0,0,0,0,683,683,7,676,551,125
07B7G,nan,07,Tempelhof-Schöneberg,7G,B,7,81,nan,0,0,0,0,804,804,6,798,624,174
07B7H,nan,07,Tempelhof-Schöneberg,7H,B,7,81,nan,0,0,0,0,877,877,11,866,724,142
07B7I,nan,07,Tempelhof-Schöneberg,7I,B,7,81,nan,0,0,0,0,874,874,5,869,626,243
08B1A,nan,08,Neukölln,1A,B,1,82,nan,0,0,0,0,1114,1114,16,1098,462,636
08B1B,nan,08,Neukölln,1B,B,1,82,nan,0,0,0,0,1054,1054,20,1034,415,619
08B1C,nan,08,Neukölln,1C,B,1,82,nan,0,0,0,0,941,941,12,929,419,510
08B1D,nan,08,Neukölln,1D,B,1,82,nan,0,0,0,0,1034,1034,21,1013,478,535
08B1E,nan,08,Neukölln,1E,B,1,82,nan,0,0,0,0,909,909,14,895,452,443
08B1F,nan,08,Neukölln,1F,B,1,82,nan,0,0,0,0,886,886,15,871,437,434
08B2A,nan,08,Neukölln,2A,B,2,82,nan,0,0,0,0,469,469,13,456,286,170
08B2B,nan,08,Neukölln,2B,B,2,82,nan,0,0,0,0,1247,1247,16,1231,547,684
08B2C,nan,08,Neukölln,2C,B,2,82,nan,0,0,0,0,1197,1197,19,1178,470,708
08B2D,nan,08,Neukölln,2D,B,2,82,nan,0,0,0,0,1222,1222,13,1209,552,657
08B2E,nan,08,Neukölln,2E,B,2,82,nan,0,0,0,0,1373,1373,21,1352,612,740
08B3A,nan,08,Neukölln,3A,B,3,82,nan,0,0,0,0,967,967,15,952,352,600
08B3B,nan,08,Neukölln,3B,B,3,82,nan,0,0,0,0,937,937,14,923,361,562
08B3C,nan,08,Neukölln,3C,B,3,82,nan,0,0,0,0,1181,1181,115,1066,451,615
08B3D,nan,08,Neukölln,3D,B,3,82,nan,0,0,0,0,1005,1005,11,994,520,474
08B3E,nan,08,Neukölln,3E,B,3,82,nan,0,0,0,0,1003,1003,15,988,663,325
08B4A,nan,08,Neukölln,4A,B,4,82,nan,0,0,0,0,1121,1121,13,1108,613,495
08B4B,nan,08,Neukölln,4B,B,4,82,nan,0,0,0,0,1035,1035,11,1024,696,328
08B4C,nan,08,Neukölln,4C,B,4,82,nan,0,0,0,0,1198,1198,11,1187,809,378
08B4D,nan,08,Neukölln,4D,B,4,82,nan,0,0,0,0,847,847,5,842,582,260
08B4E,nan,08,Neukölln,4E,B,4,82,nan,0,0,0,0,1215,1215,4,1211,889,322
08B4F,nan,08,Neukölln,4F,B,4,82,nan,0,0,0,0,986,986,4,982,732,250
08B5A,nan,08,Neukölln,5A,B,5,82,nan,0,0,0,0,1060,1060,110,950,709,241
08B5B,nan,08,Neukölln,5B,B,5,82,nan,0,0,0,0,944,944,2,942,663,279
08B5C,nan,08,Neukölln,5C,B,5,82,nan,0,0,0,0,1049,1049,4,1045,767,278
08B5D,nan,08,Neukölln,5D,B,5,82,nan,0,0,0,0,932,932,3,929,712,217
08B5E,nan,08,Neukölln,5E,B,5,82,nan,0,0,0,0,1114,1114,5,1109,820,289
08B5F,nan,08,Neukölln,5F,B,5,82,nan,0,0,0,0,810,810,62,748,544,204
08B6A,nan,08,Neukölln,6A,B,6,82,nan,0,0,0,0,826,826,4,822,595,227
08B6B,nan,08,Neukölln,6B,B,6,82,nan,0,0,0,0,709,709,1,708,534,174
08B6C,nan,08,Neukölln,6C,B,6,82,nan,0,0,0,0,870,870,5,865,636,229
08B6D,nan,08,Neukölln,6D,B,6,82,nan,0,0,0,0,756,756,4,752,564,188
08B6E,nan,08,Neukölln,6E,B,6,82,nan,0,0,0,0,875,875,11,864,629,235
08B6F,nan,08,Neukölln,6F,B,6,82,nan,0,0,0,0,716,716,6,710,523,187
08B7A,nan,08,Neukölln,7A,B,7,82,nan,0,0,0,0,1161,1161,9,1152,830,322
08B7B,nan,08,Neukölln,7B,B,7,82,nan,0,0,0,0,1012,1012,106,906,676,230
08B7C,nan,08,Neukölln,7C,B,7,82,nan,0,0,0,0,1062,1062,10,1052,744,308
08B7D,nan,08,Neukölln,7D,B,7,82,nan,0,0,0,0,860,860,3,857,636,221
08B7E,nan,08,Neukölln,7E,B,7,82,nan,0,0,0,0,1026,1026,2,1024,737,287
08B7F,nan,08,Neukölln,7F,B,7,82,nan,0,0,0,0,803,803,2,801,579,222
09B1A,nan,09,Treptow-Köpenick,1A,B,1,84,nan,0,0,0,0,1319,1319,15,1304,542,762
09B1B,nan,09,Treptow-Köpenick,1B,B,1,84,nan,0,0,0,0,1858,1858,19,1839,820,1019
09B1C,nan,09,Treptow-Köpenick,1C,B,1,84,nan,0,0,0,0,1032,1032,0,1032,514,518
09B1D,nan,09,Treptow-Köpenick,1D,B,1,84,nan,0,0,0,0,1036,1036,9,1027,485,542
09B1E,nan,09,Treptow-Köpenick,1E,B,1,84,nan,0,0,0,0,1442,1442,14,1428,719,709
09B2A,nan,09,Treptow-Köpenick,2A,B,2,84,nan,0,0,0,0,1405,1405,11,1394,743,651
09B2B,nan,09,Treptow-Köpenick,2B,B,2,84,nan,0,0,0,0,1198,1198,0,1198,636,562
09B2C,nan,09,Treptow-Köpenick,2C,B,2,84,nan,0,0,0,0,802,802,3,799,425,374
09B2D,nan,09,Treptow-Köpenick,2D,B,2,84,nan,0,0,0,0,788,788,7,781,409,372
09B2E,nan,09,Treptow-Köpenick,2E,B,2,84,nan,0,0,0,0,1016,1016,14,1002,503,499
09B2F,nan,09,Treptow-Köpenick,2F,B,2,84,nan,0,0,0,0,1218,1218,18,1200,620,580
09B3A,nan,09,Treptow-Köpenick,3A,B,3,84,nan,0,0,0,0,1334,1334,16,1318,642,676
09B3B,nan,09,Treptow-Köpenick,3B,B,3,84,nan,0,0,0,0,1348,1348,14,1334,706,628
09B3C,nan,09,Treptow-Köpenick,3C,B,3,84,nan,0,0,0,0,1328,1328,5,1323,810,513
09B3D,nan,09,Treptow-Köpenick,3D,B,3,84,nan,0,0,0,0,1128,1128,5,1123,668,455
09B3E,nan,09,Treptow-Köpenick,3E,B,3,84,nan,0,0,0,0,824,824,4,820,488,332
09B4A,nan,09,Treptow-Köpenick,4A,B,4,84,nan,0,0,0,0,1391,1391,11,1380,1328,52
09B4B,nan,09,Treptow-Köpenick,4B,B,4,84,nan,0,0,0,0,1139,1139,12,1127,672,455
09B4C,nan,09,Treptow-Köpenick,4C,B,4,84,nan,0,0,0,0,1347,1347,9,1338,687,651
09B4D,nan,09,Treptow-Köpenick,4D,B,4,84,nan,0,0,0,0,1172,1172,20,1152,614,538
09B4E,nan,09,Treptow-Köpenick,4E,B,4,84,nan,0,0,0,0,1429,1429,4,1425,1179,246
09B5A,nan,09,Treptow-Köpenick,5A,B,5,84,nan,0,0,0,0,1068,1068,10,1058,591,467
09B5B,nan,09,Treptow-Köpenick,5B,B,5,84,nan,0,0,0,0,1126,1126,11,1115,616,499
09B5C,nan,09,Treptow-Köpenick,5C,B,5,84,nan,0,0,0,0,897,897,11,886,524,362
09B5D,nan,09,Treptow-Köpenick,5D,B,5,84,nan,0,0,0,0,1281,1281,34,1247,758,489
09B5E,nan,09,Treptow-Köpenick,5E,B,5,84,nan,0,0,0,0,1109,1109,4,1105,966,139
09B6A,nan,09,Treptow-Köpenick,6A,B,6,84,nan,0,0,0,0,1339,1339,9,1330,837,493
09B6B,nan,09,Treptow-Köpenick,6B,B,6,84,nan,0,0,0,0,1376,1376,13,1363,851,512
09B6C,nan,09,Treptow-Köpenick,6C,B,6,84,nan,0,0,0,0,1148,1148,1,1147,640,507
09B6D,nan,09,Treptow-Köpenick,6D,B,6,84,nan,0,0,0,0,1193,1193,15,1178,622,556
09B6E,nan,09,Treptow-Köpenick,6E,B,6,84,nan,0,0,0,0,1502,1502,5,1497,1129,368
10B1A,nan,10,Marzahn-Hellersdorf,1A,B,1,85,nan,0,0,0,0,386,386,2,384,190,194
10B1B,nan,10,Marzahn-Hellersdorf,1B,B,1,85,nan,0,0,0,0,321,321,0,321,177,144
10B1C,nan,10,Marzahn-Hellersdorf,1C,B,1,85,nan,0,0,0,0,454,454,3,451,240,211
10B1D,nan,10,Marzahn-Hellersdorf,1D,B,1,85,nan,0,0,0,0,438,438,1,437,216,221
10B1E,nan,10,Marzahn-Hellersdorf,1E,B,1,85,nan,0,0,0,0,640,640,11,629,321,308
10B1F,nan,10,Marzahn-Hellersdorf,1F,B,1,85,nan,0,0,0,0,570,570,1,569,286,283
10B1G,nan,10,Marzahn-Hellersdorf,1G,B,1,85,nan,0,0,0,0,315,315,0,315,151,164
10B1H,nan,10,Marzahn-Hellersdorf,1H,B,1,85,nan,0,0,0,0,396,396,3,393,221,172
10B2A,nan,10,Marzahn-Hellersdorf,2A,B,2,85,nan,0,0,0,0,515,515,0,515,281,234
10B2B,nan,10,Marzahn-Hellersdorf,2B,B,2,85,nan,0,0,0,0,495,495,6,489,236,253
10B2C,nan,10,Marzahn-Hellersdorf,2C,B,2,85,nan,0,0,0,0,400,400,2,398,202,196
10B2D,nan,10,Marzahn-Hellersdorf,2D,B,2,85,nan,0,0,0,0,513,513,3,510,239,271
10B2E,nan,10,Marzahn-Hellersdorf,2E,B,2,85,nan,0,0,0,0,372,372,4,368,193,175
10B2F,nan,10,Marzahn-Hellersdorf,2F,B,2,85,nan,0,0,0,0,412,412,3,409,186,223
10B2G,nan,10,Marzahn-Hellersdorf,2G,B,2,85,nan,0,0,0,0,501,501,3,498,230,268
10B2H,nan,10,Marzahn-Hellersdorf,2H,B,2,85,nan,0,0,0,0,277,277,2,275,101,174
10B2J,nan,10,Marzahn-Hellersdorf,2J,B,2,85,nan,0,0,0,0,295,295,2,293,153,140
10B2K,nan,10,Marzahn-Hellersdorf,2K,B,2,85,nan,0,0,0,0,325,325,4,321,149,172
10B2L,nan,10,Marzahn-Hellersdorf,2L,B,2,85,nan,0,0,0,0,426,426,0,426,218,208
10B2M,nan,10,Marzahn-Hellersdorf,2M,B,2,85,nan,0,0,0,0,343,343,1,342,183,159
10B3A,nan,10,Marzahn-Hellersdorf,3A,B,3,85,nan,0,0,0,0,360,360,1,359,188,171
10B3B,nan,10,Marzahn-Hellersdorf,3B,B,3,85,nan,0,0,0,0,306,306,3,303,186,117
10B3C,nan,10,Marzahn-Hellersdorf,3C,B,3,85,nan,0,0,0,0,448,448,0,448,233,215
10B3D,nan,10,Marzahn-Hellersdorf,3D,B,3,85,nan,0,0,0,0,390,390,3,387,216,171
10B3E,nan,10,Marzahn-Hellersdorf,3E,B,3,85,nan,0,0,0,0,473,473,0,473,275,198
10B3F,nan,10,Marzahn-Hellersdorf,3F,B,3,85,nan,0,0,0,0,482,482,2,480,260,220
10B3G,nan,10,Marzahn-Hellersdorf,3G,B,3,85,nan,0,0,0,0,515,515,9,506,263,243
10B3H,nan,10,Marzahn-Hellersdorf,3H,B,3,85,nan,0,0,0,0,556,556,2,554,310,244
10B4A,nan,10,Marzahn-Hellersdorf,4A,B,4,85,nan,0,0,0,0,276,276,3,273,122,151
10B4B,nan,10,Marzahn-Hellersdorf,4B,B,4,85,nan,0,0,0,0,576,576,9,567,300,267
10B4C,nan,10,Marzahn-Hellersdorf,4C,B,4,85,nan,0,0,0,0,323,323,2,321,151,170
10B4D,nan,10,Marzahn-Hellersdorf,4D,B,4,85,nan,0,0,0,0,513,513,7,506,223,283
10B4E,nan,10,Marzahn-Hellersdorf,4E,B,4,85,nan,0,0,0,0,337,337,2,335,126,209
10B4F,nan,10,Marzahn-Hellersdorf,4F,B,4,85,nan,0,0,0,0,406,406,2,404,167,237
10B4G,nan,10,Marzahn-Hellersdorf,4G,B,4,85,nan,0,0,0,0,529,529,2,527,246,281
10B4H,nan,10,Marzahn-Hellersdorf,4H,B,4,85,nan,0,0,0,0,448,448,0,448,190,258
10B4J,nan,10,Marzahn-Hellersdorf,4J,B,4,85,nan,0,0,0,0,443,443,8,435,215,220
10B4K,nan,10,Marzahn-Hellersdorf,4K,B,4,85,nan,0,0,0,0,574,574,10,564,288,276
10B4L,nan,10,Marzahn-Hellersdorf,4L,B,4,85,nan,0,0,0,0,458,458,4,454,193,261
10B4M,nan,10,Marzahn-Hellersdorf,4M,B,4,85,nan,0,0,0,0,441,441,4,437,191,246
10B4N,nan,10,Marzahn-Hellersdorf,4N,B,4,85,nan,0,0,0,0,425,425,3,422,182,240
10B4P,nan,10,Marzahn-Hellersdorf,4P,B,4,85,nan,0,0,0,0,537,537,1,536,260,276
10B5A,nan,10,Marzahn-Hellersdorf,5A,B,5,85,nan,0,0,0,0,443,443,6,437,213,224
10B5B,nan,10,Marzahn-Hellersdorf,5B,B,5,85,nan,0,0,0,0,480,480,2,478,204,274
10B5C,nan,10,Marzahn-Hellersdorf,5C,B,5,85,nan,0,0,0,0,407,407,3,404,194,210
10B5D,nan,10,Marzahn-Hellersdorf,5D,B,5,85,nan,0,0,0,0,453,453,0,453,191,262
10B5E,nan,10,Marzahn-Hellersdorf,5E,B,5,85,nan,0,0,0,0,399,399,1,398,191,207
10B5F,nan,10,Marzahn-Hellersdorf,5F,B,5,85,nan,0,0,0,0,410,410,7,403,179,224
10B5G,nan,10,Marzahn-Hellersdorf,5G,B,5,85,nan,0,0,0,0,335,335,5,330,159,171
10B5H,nan,10,Marzahn-Hellersdorf,5H,B,5,85,nan,0,0,0,0,333,333,0,333,157,176
10B5J,nan,10,Marzahn-Hellersdorf,5J,B,5,85,nan,0,0,0,0,349,349,3,346,186,160
10B5K,nan,10,Marzahn-Hellersdorf,5K,B,5,85,nan,0,0,0,0,399,399,1,398,182,216
10B5L,nan,10,Marzahn-Hellersdorf,5L,B,5,85,nan,0,0,0,0,443,443,1,442,212,230
10B5M,nan,10,Marzahn-Hellersdorf,5M,B,5,85,nan,0,0,0,0,319,319,2,317,135,182
10B5N,nan,10,Marzahn-Hellersdorf,5N,B,5,85,nan,0,0,0,0,423,423,4,419,175,244
10B5P,nan,10,Marzahn-Hellersdorf,5P,B,5,85,nan,0,0,0,0,516,516,5,511,279,232
10B5Q,nan,10,Marzahn-Hellersdorf,5Q,B,5,85,nan,0,0,0,0,461,461,1,460,216,244
10B5R,nan,10,Marzahn-Hellersdorf,5R,B,5,85,nan,0,0,0,0,425,425,3,422,186,236
10B5S,nan,10,Marzahn-Hellersdorf,5S,B,5,85,nan,0,0,0,0,507,507,4,503,202,301
10B6A,nan,10,Marzahn-Hellersdorf,6A,B,6,85,nan,0,0,0,0,360,360,5,355,204,151
10B6B,nan,10,Marzahn-Hellersdorf,6B,B,6,85,nan,0,0,0,0,547,547,7,540,318,222
10B6C,nan,10,Marzahn-Hellersdorf,6C,B,6,85,nan,0,0,0,0,320,320,5,315,153,162
10B6D,nan,10,Marzahn-Hellersdorf,6D,B,6,85,nan,0,0,0,0,636,636,0,636,315,321
10B6E,nan,10,Marzahn-Hellersdorf,6E,B,6,85,nan,0,0,0,0,405,405,2,403,199,204
10B6F,nan,10,Marzahn-Hellersdorf,6F,B,6,85,nan,0,0,0,0,296,296,6,290,140,150
10B6G,nan,10,Marzahn-Hellersdorf,6G,B,6,85,nan,0,0,0,0,655,655,6,649,307,342
10B6H,nan,10,Marzahn-Hellersdorf,6H,B,6,85,nan,0,0,0,0,482,482,2,480,192,288
10B6J,nan,10,Marzahn-Hellersdorf,6J,B,6,85,nan,0,0,0,0,420,420,6,414,231,183
10B6K,nan,10,Marzahn-Hellersdorf,6K,B,6,85,nan,0,0,0,0,396,396,5,391,222,169
11B1A,nan,11,Lichtenberg,1A,B,1,86,nan,0,0,0,0,394,394,2,392,136,256
11B1B,nan,11,Lichtenberg,1B,B,1,86,nan,0,0,0,0,774,774,0,774,192,582
11B1C,nan,11,Lichtenberg,1C,B,1,86,nan,0,0,0,0,474,474,2,472,181,291
11B1D,nan,11,Lichtenberg,1D,B,1,86,nan,0,0,0,0,582,582,5,577,247,330
11B1E,nan,11,Lichtenberg,1E,B,1,86,nan,0,0,0,0,538,538,2,536,239,297
11B1F,nan,11,Lichtenberg,1F,B,1,86,nan,0,0,0,0,489,489,1,488,201,287
11B1G,nan,11,Lichtenberg,1G,B,1,86,nan,0,0,0,0,473,473,2,471,220,251
11B1H,nan,11,Lichtenberg,1H,B,1,86,nan,0,0,0,0,579,579,8,571,260,311
11B2A,nan,11,Lichtenberg,2A,B,2,86,nan,0,0,0,0,514,514,1,513,165,348
11B2B,nan,11,Lichtenberg,2B,B,2,86,nan,0,0,0,0,430,430,0,430,186,244
11B2C,nan,11,Lichtenberg,2C,B,2,86,nan,0,0,0,0,323,323,0,323,152,171
11B2D,nan,11,Lichtenberg,2D,B,2,86,nan,0,0,0,0,550,550,1,549,273,276
11B2E,nan,11,Lichtenberg,2E,B,2,86,nan,0,0,0,0,761,761,5,756,230,526
11B2F,nan,11,Lichtenberg,2F,B,2,86,nan,0,0,0,0,604,604,7,597,268,329
11B2G,nan,11,Lichtenberg,2G,B,2,86,nan,0,0,0,0,696,696,6,690,274,416
11B2H,nan,11,Lichtenberg,2H,B,2,86,nan,0,0,0,0,483,483,1,482,209,273
11B2I,nan,11,Lichtenberg,2I,B,2,86,nan,0,0,0,0,369,369,4,365,184,181
11B2J,nan,11,Lichtenberg,2J,B,2,86,nan,0,0,0,0,473,473,2,471,253,218
11B3A,nan,11,Lichtenberg,3A,B,3,86,nan,0,0,0,0,536,536,22,514,294,220
11B3B,nan,11,Lichtenberg,3B,B,3,86,nan,0,0,0,0,542,542,4,538,266,272
11B3C,nan,11,Lichtenberg,3C,B,3,86,nan,0,0,0,0,382,382,1,381,203,178
11B3D,nan,11,Lichtenberg,3D,B,3,86,nan,0,0,0,0,346,346,3,343,175,168
11B3E,nan,11,Lichtenberg,3E,B,3,86,nan,0,0,0,0,462,462,1,461,231,230
11B3F,nan,11,Lichtenberg,3F,B,3,86,nan,0,0,0,0,505,505,2,503,235,268
11B3G,nan,11,Lichtenberg,3G,B,3,86,nan,0,0,0,0,511,511,6,505,236,269
11B3H,nan,11,Lichtenberg,3H,B,3,86,nan,0,0,0,0,579,579,2,577,293,284
11B3I,nan,11,Lichtenberg,3I,B,3,86,nan,0,0,0,0,478,478,0,478,249,229
11B3J,nan,11,Lichtenberg,3J,B,3,86,nan,0,0,0,0,390,390,6,384,208,176
11B3K,nan,11,Lichtenberg,3K,B,3,86,nan,0,0,0,0,520,520,1,519,250,269
11B4A,nan,11,Lichtenberg,4A,B,4,86,nan,0,0,0,0,654,654,5,649,320,329
11B4B,nan,11,Lichtenberg,4B,B,4,86,nan,0,0,0,0,606,606,0,606,265,341
11B4C,nan,11,Lichtenberg,4C,B,4,86,nan,0,0,0,0,613,613,5,608,318,290
11B4D,nan,11,Lichtenberg,4D,B,4,86,nan,0,0,0,0,722,722,7,715,354,361
11B4E,nan,11,Lichtenberg,4E,B,4,86,nan,0,0,0,0,663,663,9,654,295,359
11B4F,nan,11,Lichtenberg,4F,B,4,86,nan,0,0,0,0,712,712,9,703,370,333
11B4G,nan,11,Lichtenberg,4G,B,4,86,nan,0,0,0,0,722,722,7,715,337,378
11B4H,nan,11,Lichtenberg,4H,B,4,86,nan,0,0,0,0,670,670,6,664,342,322
11B4I,nan,11,Lichtenberg,4I,B,4,86,nan,0,0,0,0,481,481,4,477,234,243
11B4J,nan,11,Lichtenberg,4J,B,4,86,nan,0,0,0,0,517,517,5,512,244,268
11B5A,nan,11,Lichtenberg,5A,B,5,86,nan,0,0,0,0,363,363,5,358,193,165
11B5B,nan,11,Lichtenberg,5B,B,5,86,nan,0,0,0,0,390,390,2,388,207,181
11B5C,nan,11,Lichtenberg,5C,B,5,86,nan,0,0,0,0,593,593,4,589,293,296
11B5D,nan,11,Lichtenberg,5D,B,5,86,nan,0,0,0,0,458,458,4,454,231,223
11B5E,nan,11,Lichtenberg,5E,B,5,86,nan,0,0,0,0,680,680,4,676,324,352
11B5F,nan,11,Lichtenberg,5F,B,5,86,nan,0,0,0,0,598,598,3,595,321,274
11B5G,nan,11,Lichtenberg,5G,B,5,86,nan,0,0,0,0,620,620,6,614,290,324
11B5H,nan,11,Lichtenberg,5H,B,5,86,nan,0,0,0,0,662,662,6,656,313,343
11B5I,nan,11,Lichtenberg,5I,B,5,86,nan,0,0,0,0,800,800,7,793,327,466
11B5J,nan,11,Lichtenberg,5J,B,5,86,nan,0,0,0,0,666,666,4,662,324,338
11B6A,nan,11,Lichtenberg,6A,B,6,86,nan,0,0,0,0,418,418,4,414,189,225
11B6B,nan,11,Lichtenberg,6B,B,6,86,nan,0,0,0,0,446,446,4,442,176,266
11B6C,nan,11,Lichtenberg,6C,B,6,86,nan,0,0,0,0,350,350,4,346,155,191
11B6D,nan,11,Lichtenberg,6D,B,6,86,nan,0,0,0,0,518,518,4,514,213,301
11B6E,nan,11,Lichtenberg,6E,B,6,86,nan,0,0,0,0,454,454,4,450,200,250
11B6F,nan,11,Lichtenberg,6F,B,6,86,nan,0,0,0,0,350,350,5,345,165,180
11B6G,nan,11,Lichtenberg,6G,B,6,86,nan,0,0,0,0,498,498,2,496,209,287
11B6H,nan,11,Lichtenberg,6H,B,6,86,nan,0,0,0,0,505,505,5,500,267,233
11B6I,nan,11,Lichtenberg,6I,B,6,86,nan,0,0,0,0,421,421,0,421,186,235
11B6J,nan,11,Lichtenberg,6J,B,6,86,nan,0,0,0,0,498,498,4,494,204,290
11B6K,nan,11,Lichtenberg,6K,B,6,86,nan,0,0,0,0,736,736,5,731,298,433
11B6L,nan,11,Lichtenberg,6L,B,6,86,nan,0,0,0,0,407,407,4,403,163,240
11B6M,nan,11,Lichtenberg,6M,B,6,86,nan,0,0,0,0,533,533,8,525,194,331
11B6N,nan,11,Lichtenberg,6N,B,6,86,nan,0,0,0,0,753,753,8,745,281,464
12B1A,nan,12,Reinickendorf,1A,B,1,77,nan,0,0,0,0,795,795,7,788,441,347
12B1B,nan,12,Reinickendorf,1B,B,1,77,nan,0,0,0,0,907,907,5,902,480,422
12B1C,nan,12,Reinickendorf,1C,B,1,77,nan,0,0,0,0,748,748,3,745,412,333
12B1D,nan,12,Reinickendorf,1D,B,1,77,nan,0,0,0,0,800,800,3,797,398,399
12B1E,nan,12,Reinickendorf,1E,B,1,77,nan,0,0,0,0,777,777,6,771,366,405
12B1F,nan,12,Reinickendorf,1F,B,1,77,nan,0,0,0,0,848,848,0,848,461,387
12B2A,nan,12,Reinickendorf,2A,B,2,77,nan,0,0,0,0,793,793,17,776,455,321
12B2B,nan,12,Reinickendorf,2B,B,2,77,nan,0,0,0,0,693,693,2,691,316,375
12B2C,nan,12,Reinickendorf,2C,B,2,77,nan,0,0,0,0,750,750,5,745,453,292
12B2D,nan,12,Reinickendorf,2D,B,2,77,nan,0,0,0,0,667,667,2,665,345,320
12B2E,nan,12,Reinickendorf,2E,B,2,77,nan,0,0,0,0,574,574,2,572,331,241
12B2F,nan,12,Reinickendorf,2F,B,2,77,nan,0,0,0,0,697,697,0,697,370,327
12B2G,nan,12,Reinickendorf,2G,B,2,77,nan,0,0,0,0,579,579,1,578,293,285
12B2H,nan,12,Reinickendorf,2H,B,2,77,nan,0,0,0,0,798,798,0,798,426,372
12B3A,nan,12,Reinickendorf,3A,B,3,77,nan,0,0,0,0,843,843,2,841,612,229
12B3B,nan,12,Reinickendorf,3B,B,3,77,nan,0,0,0,0,718,718,5,713,487,226
12B3C,nan,12,Reinickendorf,3C,B,3,77,nan,0,0,0,0,715,715,3,712,491,221
12B3D,nan,12,Reinickendorf,3D,B,3,77,nan,0,0,0,0,1144,1144,0,1144,741,403
12B3E,nan,12,Reinickendorf,3E,B,3,77,nan,0,0,0,0,696,696,6,690,405,285
12B3F,nan,12,Reinickendorf,3F,B,3,77,nan,0,0,0,0,1084,1084,5,1079,675,404
12B3G,nan,12,Reinickendorf,3G,B,3,77,nan,0,0,0,0,583,583,4,579,405,174
12B3H,nan,12,Reinickendorf,3H,B,3,77,nan,0,0,0,0,587,587,1,586,398,188
12B3I,nan,12,Reinickendorf,3I,B,3,77,nan,0,0,0,0,1090,1090,3,1087,555,532
12B4A,nan,12,Reinickendorf,4A,B,4,77,nan,0,0,0,0,612,612,1,611,388,223
12B4B,nan,12,Reinickendorf,4B,B,4,77,nan,0,0,0,0,829,829,4,825,583,242
12B4C,nan,12,Reinickendorf,4C,B,4,77,nan,0,0,0,0,637,637,0,637,429,208
12B4D,nan,12,Reinickendorf,4D,B,4,77,nan,0,0,0,0,798,798,5,793,565,228
12B4E,nan,12,Reinickendorf,4E,B,4,77,nan,0,0,0,0,931,931,1,930,609,321
12B4F,nan,12,Reinickendorf,4F,B,4,77,nan,0,0,0,0,863,863,6,857,536,321
12B4G,nan,12,Reinickendorf,4G,B,4,77,nan,0,0,0,0,718,718,0,718,476,242
12B4H,nan,12,Reinickendorf,4H,B,4,77,nan,0,0,0,0,953,953,3,950,609,341
12B4I,nan,12,Reinickendorf,4I,B,4,77,nan,0,0,0,0,719,719,3,716,472,244
12B5A,nan,12,Reinickendorf,5A,B,5,77,nan,0,0,0,0,760,760,6,754,548,206
12B5B,nan,12,Reinickendorf,5B,B,5,77,nan,0,0,0,0,789,789,3,786,565,221
12B5C,nan,12,Reinickendorf,5C,B,5,77,nan,0,0,0,0,772,772,4,768,606,162
12B5D,nan,12,Reinickendorf,5D,B,5,77,nan,0,0,0,0,886,886,4,882,664,218
12B5E,nan,12,Reinickendorf,5E,B,5,77,nan,0,0,0,0,698,698,2,696,524,172
12B6A,nan,12,Reinickendorf,6A,B,6,77,nan,0,0,0,0,723,723,2,721,505,216
12B6B,nan,12,Reinickendorf,6B,B,6,77,nan,0,0,0,0,929,929,5,924,666,258
12B6C,nan,12,Reinickendorf,6C,B,6,77,nan,0,0,0,0,643,643,3,640,428,212
12B6D,nan,12,Reinickendorf,6D,B,6,77,nan,0,0,0,0,759,759,2,757,567,190
12B6E,nan,12,Reinickendorf,6E,B,6,77,nan,0,0,0,0,597,597,0,597,441,156
12B6F,nan,12,Reinickendorf,6F,B,6,77,nan,0,0,0,0,779,779,7,772,526,246
12B6G,nan,12,Reinickendorf,6G,B,6,77,nan,0,0,0,0,1025,1025,3,1022,751,271
12B6H,nan,12,Reinickendorf,6H,B,6,77,nan,0,0,0,0,853,853,8,845,579,266
12B6I,nan,12,Reinickendorf,6I,B,6,77,nan,0,0,0,0,931,931,2,929,642,287
12B6J,nan,12,Reinickendorf,6J,B,6,77,nan,0,0,0,0,815,815,4,811,539,272
