id,district_id,electoral_district_id,eligible_voters,voters,invalid_votes,valid_votes,vote_yes,vote_no,voter_turnout,invalid_votes_percentage,valid_votes_percentage,vote_yes_percentage,vote_no_percentage
01100,01,100,1269,572,13,559,358,201,45.07486209613869,2.272727272727273,97.72727272727273,62.58741258741259,35.13986013986014
01101,01,101,1490,757,3,754,413,341,50.80536912751678,0.3963011889035667,99.60369881109644,54.557463672391016,45.04623513870541
01102,01,102,1306,603,10,593,357,236,46.17151607963246,1.658374792703151,98.34162520729684,59.20398009950249,39.13764510779436
01103,01,103,1555,772,13,759,466,293,49.646302250803856,1.6839378238341969,98.31606217616581,60.362694300518136,37.95336787564767
01104,01,104,1241,611,16,595,336,259,49.234488315874295,2.618657937806874,97.38134206219313,54.99181669394435,42.38952536824877
01105,01,105,1049,509,15,494,273,221,48.52240228789323,2.9469548133595285,97.05304518664047,53.63457760314342,43.418467583497055
01106,01,106,1407,662,8,654,408,246,47.05046197583511,1.2084592145015105,98.79154078549848,61.631419939577036,37.160120845921455
01107,01,107,1111,612,8,604,341,263,55.08550855085509,1.3071895424836601,98.69281045751634,55.71895424836602,42.97385620915033
01108,01,108,1004,483,7,476,270,206,48.10756972111554,1.4492753623188406,98.55072463768117,55.90062111801242,42.65010351966873
01109,01,109,1133,536,16,520,352,168,47.30803177405119,2.9850746268656714,97.01492537313433,65.67164179104478,31.343283582089555
01110,01,110,1552,841,13,828,424,404,54.1881443298969,1.5457788347205708,98.45422116527944,50.416171224732466,48.03804994054697
01111,01,111,1010,549,6,543,300,243,54.35643564356436,1.092896174863388,98.90710382513662,54.644808743169406,44.26229508196721
01112,01,112,1194,599,16,583,299,284,50.16750418760469,2.671118530884808,97.32888146911519,49.91652754590985,47.412353923205345
01113,01,113,1172,673,19,654,320,334,57.423208191126285,2.823179791976226,97.17682020802377,47.5482912332838,49.62852897473997
01114,01,114,1447,740,18,722,400,322,51.14029025570145,2.4324324324324325,97.56756756756756,54.054054054054056,43.513513513513516
01115,01,115,866,481,6,475,293,182,55.54272517321016,1.2474012474012475,98.75259875259876,60.91476091476091,37.83783783783784
01116,01,116,697,378,10,368,214,154,54.23242467718795,2.6455026455026456,97.35449735449735,56.613756613756614,40.74074074074074
01117,01,117,1486,861,22,839,415,424,57.940780619111706,2.5551684088269457,97.44483159117306,48.199767711962835,49.24506387921022
01118,01,118,1148,664,20,644,316,328,57.8397212543554,3.0120481927710845,96.98795180722891,47.59036144578313,49.39759036144578
01119,01,119,877,506,7,499,211,288,57.69669327251995,1.383399209486166,98.61660079051383,41.699604743083,56.916996047430835
01120,01,120,1066,544,13,531,262,269,51.031894934333955,2.389705882352941,97.61029411764706,48.161764705882355,49.44852941176471
01121,01,121,1089,554,16,538,286,252,50.872359963269055,2.888086642599278,97.11191335740072,51.624548736462096,45.48736462093863
01122,01,122,1204,643,13,630,313,317,53.40531561461794,2.021772939346812,97.97822706065318,48.67807153965785,49.30015552099534
01123,01,123,1006,520,13,507,261,246,51.689860834990064,2.5,97.5,50.19230769230769,47.30769230769231
01200,01,200,896,448,9,439,265,174,50.0,2.0089285714285716,97.99107142857143,59.15178571428571,38.839285714285715
01201,01,201,1114,532,3,529,357,172,47.755834829443444,0.5639097744360901,99.43609022556392,67.10526315789474,32.33082706766917
01202,01,202,1131,470,8,462,289,173,41.55614500442087,1.702127659574468,98.29787234042553,61.48936170212767,36.80851063829787
01203,01,203,1071,392,8,384,210,174,36.60130718954248,2.0408163265306123,97.95918367346938,53.57142857142857,44.38775510204081
01204,01,204,1931,832,12,820,514,306,43.0864836872087,1.4423076923076923,98.5576923076923,61.77884615384615,36.77884615384615
01205,01,205,1222,563,11,552,297,255,46.07201309328969,1.9538188277087036,98.04618117229128,52.753108348134994,45.293072824156305
01206,01,206,1355,561,23,538,298,240,41.40221402214022,4.09982174688057,95.90017825311944,53.11942959001783,42.780748663101605
01207,01,207,1138,531,19,512,263,249,46.660808435852374,3.5781544256120528,96.42184557438794,49.52919020715631,46.89265536723164
01208,01,208,894,432,8,424,222,202,48.322147651006716,1.8518518518518516,98.14814814814815,51.388888888888886,46.75925925925926
01209,01,209,1235,640,21,619,316,303,51.821862348178136,3.28125,96.71875,49.375,47.34375
01210,01,210,1135,585,16,569,303,266,51.541850220264315,2.735042735042735,97.26495726495726,51.7948717948718,45.47008547008547
01211,01,211,880,465,13,452,226,226,52.84090909090909,2.795698924731183,97.20430107526882,48.60215053763441,48.60215053763441
01212,01,212,866,480,19,461,266,195,55.42725173210161,3.958333333333333,96.04166666666667,55.41666666666667,40.625
01213,01,213,640,295,8,287,168,119,46.09375,2.711864406779661,97.28813559322033,56.949152542372886,40.33898305084746
01214,01,214,830,354,8,346,168,178,42.65060240963855,2.2598870056497176,97.74011299435028,47.45762711864407,50.282485875706215
01215,01,215,1016,526,5,521,268,253,51.77165354330708,0.9505703422053232,99.04942965779468,50.950570342205324,48.09885931558935
01216,01,216,945,491,15,476,237,239,51.957671957671955,3.054989816700611,96.94501018329939,48.26883910386965,48.676171079429736
01217,01,217,1072,449,11,438,224,214,41.884328358208954,2.4498886414253898,97.55011135857461,49.88864142538976,47.66146993318486
01218,01,218,1525,801,24,777,403,374,52.52459016393443,2.9962546816479403,97.00374531835206,50.31210986267166,46.6916354556804
01219,01,219,342,172,8,164,99,65,50.29239766081871,4.651162790697675,95.34883720930233,57.55813953488372,37.7906976744186
01220,01,220,785,345,12,333,163,170,43.94904458598726,3.4782608695652173,96.52173913043478,47.2463768115942,49.275362318840585
01221,01,221,1491,717,17,700,384,316,48.08853118712273,2.3709902370990235,97.62900976290098,53.55648535564853,44.07252440725244
01222,01,222,903,425,5,420,214,206,47.06533776301218,1.1764705882352942,98.82352941176471,50.35294117647059,48.470588235294116
01223,01,223,1499,771,16,755,327,428,51.434289526350895,2.075226977950713,97.92477302204928,42.4124513618677,55.512321660181584
01224,01,224,837,402,17,385,201,184,48.028673835125446,4.228855721393035,95.77114427860697,50.0,45.77114427860697
01225,01,225,1367,677,16,661,327,334,49.524506217995615,2.363367799113737,97.63663220088627,48.301329394387,49.33530280649926
01226,01,226,758,393,18,375,173,202,51.84696569920845,4.580152671755725,95.41984732824427,44.02035623409669,51.399491094147585
01227,01,227,1362,711,10,701,292,409,52.20264317180616,1.4064697609001406,98.59353023909986,41.068917018284104,57.52461322081576
01228,01,228,2280,1095,21,1074,534,540,48.026315789473685,1.9178082191780823,98.08219178082192,48.76712328767123,49.31506849315068
01300,01,300,1302,608,12,596,373,223,46.6973886328725,1.9736842105263157,98.02631578947368,61.348684210526315,36.67763157894737
01301,01,301,871,438,7,431,241,190,50.28702640642939,1.5981735159817352,98.40182648401826,55.02283105022832,43.37899543378995
01302,01,302,1187,577,11,566,364,202,48.60994102780118,1.9064124783362217,98.09358752166378,63.084922010398614,35.008665511265164
01303,01,303,888,427,17,410,275,135,48.085585585585584,3.9812646370023423,96.01873536299766,64.40281030444966,31.61592505854801
01304,01,304,942,527,5,522,305,217,55.9447983014862,0.9487666034155597,99.05123339658444,57.874762808349146,41.17647058823529
01305,01,305,1043,558,17,541,320,221,53.49952061361457,3.046594982078853,96.95340501792114,57.34767025089605,39.60573476702509
01306,01,306,1356,707,9,698,378,320,52.138643067846616,1.272984441301273,98.72701555869872,53.46534653465347,45.26166902404526
01307,01,307,1137,657,19,638,383,255,57.78364116094987,2.89193302891933,97.10806697108066,58.29528158295282,38.81278538812785
01308,01,308,1145,629,8,621,339,282,54.93449781659388,1.2718600953895072,98.72813990461049,53.89507154213037,44.83306836248013
01309,01,309,1268,731,17,714,399,315,57.64984227129337,2.3255813953488373,97.67441860465115,54.58276333789329,43.09165526675787
01310,01,310,900,487,10,477,285,192,54.11111111111111,2.0533880903490758,97.94661190965093,58.52156057494866,39.42505133470226
01311,01,311,1037,478,11,467,272,195,46.09450337512054,2.301255230125523,97.69874476987448,56.903765690376574,40.79497907949791
01312,01,312,783,380,8,372,220,152,48.53128991060026,2.1052631578947367,97.89473684210527,57.89473684210527,40.0
01313,01,313,825,407,6,401,245,156,49.333333333333336,1.4742014742014742,98.52579852579852,60.1965601965602,38.32923832923833
01314,01,314,1085,559,11,548,358,190,51.52073732718894,1.9677996422182469,98.03220035778175,64.04293381037567,33.98926654740608
01315,01,315,831,386,10,376,233,143,46.450060168471715,2.5906735751295336,97.40932642487047,60.362694300518136,37.04663212435233
01316,01,316,1215,634,12,622,448,174,52.181069958847736,1.8927444794952681,98.10725552050474,70.66246056782335,27.444794952681388
01317,01,317,745,387,2,385,225,160,51.946308724832214,0.516795865633075,99.48320413436691,58.139534883720934,41.343669250645995
01318,01,318,1116,545,12,533,340,193,48.83512544802867,2.2018348623853212,97.79816513761467,62.38532110091744,35.41284403669725
01319,01,319,998,471,6,465,293,172,47.19438877755511,1.2738853503184715,98.72611464968153,62.20806794055201,36.51804670912951
01320,01,320,591,322,7,315,168,147,54.483925549915405,2.1739130434782608,97.82608695652173,52.17391304347826,45.65217391304348
01321,01,321,997,465,10,455,300,155,46.63991975927783,2.1505376344086025,97.84946236559139,64.51612903225806,33.33333333333333
01322,01,322,1127,487,6,481,354,127,43.21206743566992,1.2320328542094456,98.76796714579056,72.68993839835728,26.07802874743326
01323,01,323,1153,597,17,580,371,209,51.77797051170858,2.8475711892797317,97.15242881072027,62.14405360134003,35.00837520938023
01324,01,324,1583,630,13,617,423,194,39.79785217940619,2.0634920634920633,97.93650793650794,67.14285714285714,30.793650793650794
01325,01,325,998,403,13,390,251,139,40.3807615230461,3.225806451612903,96.7741935483871,62.28287841191067,34.49131513647642
01326,01,326,1174,593,10,583,342,241,50.51107325383305,1.6863406408094435,98.31365935919055,57.67284991568297,40.640809443507585
01327,01,327,1471,691,11,680,357,323,46.97484704282801,1.5918958031837915,98.4081041968162,51.6642547033285,46.7438494934877
01400,01,400,1351,629,14,615,404,211,46.558105107327904,2.2257551669316373,97.77424483306835,64.22893481717011,33.54531001589825
01401,01,401,924,456,6,450,278,172,49.35064935064935,1.3157894736842104,98.68421052631578,60.96491228070175,37.719298245614034
01402,01,402,1308,617,14,603,399,204,47.17125382262997,2.2690437601296596,97.73095623987034,64.6677471636953,33.06320907617504
01403,01,403,1010,506,18,488,259,229,50.0990099009901,3.557312252964427,96.44268774703558,51.18577075098815,45.25691699604743
01404,01,404,704,350,10,340,208,132,49.715909090909086,2.857142857142857,97.14285714285714,59.42857142857143,37.714285714285715
01405,01,405,790,407,8,399,257,142,51.518987341772146,1.9656019656019657,98.03439803439802,63.14496314496314,34.88943488943489
01406,01,406,847,449,22,427,231,196,53.010625737898465,4.8997772828507795,95.10022271714922,51.44766146993318,43.652561247216035
01407,01,407,1191,642,11,631,393,238,53.904282115869016,1.7133956386292832,98.28660436137072,61.21495327102804,37.07165109034268
01408,01,408,995,543,16,527,273,254,54.57286432160804,2.9465930018416207,97.05340699815838,50.27624309392266,46.77716390423573
01409,01,409,960,494,8,486,303,183,51.45833333333333,1.6194331983805668,98.38056680161942,61.336032388663966,37.044534412955464
01410,01,410,1274,686,11,675,394,281,53.84615384615385,1.6034985422740524,98.39650145772595,57.434402332361515,40.96209912536443
01411,01,411,1076,522,5,517,333,184,48.51301115241636,0.9578544061302682,99.04214559386973,63.793103448275865,35.24904214559387
01412,01,412,894,460,17,443,252,191,51.45413870246085,3.6956521739130435,96.30434782608695,54.78260869565217,41.52173913043478
01413,01,413,863,444,10,434,263,171,51.44843568945539,2.2522522522522523,97.74774774774775,59.23423423423423,38.513513513513516
01414,01,414,838,420,2,418,231,187,50.11933174224343,0.4761904761904762,99.52380952380952,55.00000000000001,44.52380952380952
01415,01,415,861,464,13,451,245,206,53.89082462253194,2.8017241379310347,97.19827586206897,52.80172413793104,44.396551724137936
01416,01,416,1075,550,16,534,339,195,51.162790697674424,2.909090909090909,97.0909090909091,61.63636363636363,35.45454545454545
01417,01,417,1168,540,8,532,310,222,46.23287671232877,1.4814814814814816,98.51851851851852,57.407407407407405,41.11111111111111
01418,01,418,1119,501,7,494,321,173,44.77211796246649,1.3972055888223553,98.60279441117764,64.07185628742515,34.5309381237525
01419,01,419,1268,672,11,661,382,279,52.99684542586751,1.636904761904762,98.36309523809523,56.845238095238095,41.517857142857146
01420,01,420,983,541,13,528,305,223,55.03560528992879,2.4029574861367835,97.59704251386322,56.37707948243993,41.21996303142329
01421,01,421,813,434,5,429,271,158,53.38253382533825,1.1520737327188941,98.84792626728111,62.44239631336406,36.405529953917046
01422,01,422,1008,447,9,438,238,200,44.345238095238095,2.013422818791946,97.98657718120806,53.24384787472036,44.742729306487696
01423,01,423,876,413,12,401,245,156,47.146118721461185,2.9055690072639226,97.09443099273608,59.32203389830508,37.77239709443099
01424,01,424,1229,627,17,610,337,273,51.017087062652564,2.711323763955343,97.28867623604465,53.74800637958532,43.54066985645933
01425,01,425,1316,685,11,674,335,339,52.0516717325228,1.6058394160583942,98.3941605839416,48.9051094890511,49.48905109489051
01426,01,426,1268,596,13,583,313,270,47.003154574132495,2.1812080536912752,97.81879194630872,52.51677852348994,45.302013422818796
01427,01,427,866,400,4,396,207,189,46.18937644341801,1.0,99.0,51.74999999999999,47.25
01428,01,428,819,360,9,351,205,146,43.956043956043956,2.5,97.5,56.94444444444444,40.55555555555556
01500,01,500,1017,464,6,458,281,177,45.624385447394296,1.293103448275862,98.70689655172413,60.560344827586206,38.146551724137936
01501,01,501,834,417,7,410,218,192,50.0,1.6786570743405276,98.32134292565947,52.27817745803357,46.043165467625904
01502,01,502,547,232,3,229,128,101,42.413162705667276,1.293103448275862,98.70689655172413,55.172413793103445,43.53448275862069
01503,01,503,1064,558,5,553,199,354,52.443609022556394,0.8960573476702508,99.10394265232975,35.66308243727598,63.44086021505376
01504,01,504,667,308,4,304,204,100,46.17691154422789,1.2987012987012987,98.7012987012987,66.23376623376623,32.467532467532465
01505,01,505,956,434,5,429,251,178,45.39748953974895,1.1520737327188941,98.84792626728111,57.83410138248848,41.013824884792626
01506,01,506,983,496,3,493,226,267,50.45778229908443,0.6048387096774194,99.39516129032258,45.564516129032256,53.83064516129033
01507,01,507,1480,748,8,740,324,416,50.54054054054053,1.06951871657754,98.93048128342245,43.31550802139038,55.61497326203209
01508,01,508,1211,654,3,651,315,336,54.004954582989264,0.45871559633027525,99.54128440366972,48.1651376146789,51.37614678899083
01509,01,509,1125,534,4,530,299,231,47.46666666666667,0.7490636704119851,99.25093632958801,55.99250936329588,43.258426966292134
01510,01,510,1057,544,10,534,312,222,51.466414380321666,1.8382352941176472,98.16176470588235,57.35294117647059,40.80882352941176
01511,01,511,1118,495,6,489,289,200,44.27549194991055,1.2121212121212122,98.7878787878788,58.38383838383838,40.4040404040404
01512,01,512,1027,399,9,390,235,155,38.85102239532619,2.2556390977443606,97.74436090225564,58.89724310776943,38.847117794486216
01513,01,513,1357,698,8,690,346,344,51.43699336772292,1.146131805157593,98.8538681948424,49.570200573065904,49.28366762177651
01514,01,514,1035,487,10,477,270,207,47.05314009661836,2.0533880903490758,97.94661190965093,55.441478439425055,42.50513347022588
01515,01,515,1324,676,10,666,386,280,51.057401812688816,1.4792899408284024,98.5207100591716,57.100591715976336,41.42011834319527
01516,01,516,985,457,5,452,272,180,46.39593908629442,1.0940919037199124,98.90590809628009,59.51859956236324,39.38730853391685
01517,01,517,1364,592,7,585,305,280,43.401759530791786,1.1824324324324325,98.81756756756756,51.520270270270274,47.2972972972973
01518,01,518,1292,562,6,556,316,240,43.4984520123839,1.0676156583629894,98.93238434163702,56.22775800711744,42.704626334519574
01519,01,519,1314,674,26,648,333,315,51.2937595129376,3.857566765578635,96.14243323442136,49.40652818991098,46.73590504451038
01520,01,520,1371,672,11,661,329,332,49.01531728665208,1.636904761904762,98.36309523809523,48.95833333333333,49.404761904761905
01521,01,521,1287,475,6,469,301,168,36.90753690753691,1.263157894736842,98.73684210526315,63.368421052631575,35.368421052631575
01522,01,522,889,423,0,423,207,216,47.58155230596176,0.0,100.0,48.93617021276596,51.06382978723404
01523,01,523,649,369,5,364,214,150,56.85670261941448,1.3550135501355014,98.6449864498645,57.994579945799465,40.65040650406504
01524,01,524,853,409,12,397,218,179,47.94841735052755,2.93398533007335,97.06601466992664,53.30073349633252,43.76528117359413
01525,01,525,859,432,12,420,201,219,50.291036088474975,2.7777777777777777,97.22222222222221,46.52777777777778,50.69444444444444
01526,01,526,1481,703,10,693,342,351,47.4679270762998,1.422475106685633,98.57752489331438,48.64864864864865,49.92887624466572
01600,01,600,1457,619,12,607,288,319,42.48455730954015,1.938610662358643,98.06138933764136,46.52665589660743,51.53473344103393
01601,01,601,792,420,10,410,191,219,53.03030303030303,2.380952380952381,97.61904761904762,45.476190476190474,52.142857142857146
01602,01,602,1040,577,1,576,203,373,55.48076923076923,0.17331022530329288,99.8266897746967,35.181975736568454,64.64471403812824
01603,01,603,907,432,7,425,191,234,47.62954796030871,1.6203703703703702,98.37962962962963,44.21296296296296,54.166666666666664
01604,01,604,849,353,4,349,196,153,41.57832744405183,1.13314447592068,98.86685552407933,55.524079320113316,43.342776203966004
01605,01,605,1090,497,9,488,249,239,45.596330275229356,1.8108651911468814,98.18913480885311,50.10060362173038,48.08853118712273
01606,01,606,835,405,13,392,174,218,48.50299401197605,3.2098765432098766,96.79012345679013,42.96296296296296,53.827160493827165
01607,01,607,861,304,9,295,131,164,35.307781649245065,2.9605263157894735,97.03947368421053,43.09210526315789,53.94736842105263
01608,01,608,1017,431,16,415,189,226,42.379547689282205,3.7122969837587005,96.2877030162413,43.851508120649655,52.43619489559165
01609,01,609,1094,552,6,546,264,282,50.45703839122486,1.0869565217391304,98.91304347826086,47.82608695652174,51.08695652173913
01610,01,610,1122,524,5,519,266,253,46.702317290552585,0.9541984732824428,99.04580152671755,50.76335877862596,48.282442748091604
01611,01,611,1363,664,9,655,356,299,48.71606749816581,1.355421686746988,98.64457831325302,53.6144578313253,45.03012048192771
01612,01,612,975,441,4,437,218,219,45.230769230769226,0.9070294784580499,99.09297052154194,49.43310657596372,49.65986394557823
01613,01,613,1435,687,12,675,343,332,47.87456445993031,1.7467248908296942,98.2532751091703,49.927219796215425,48.32605531295487
01614,01,614,1180,615,12,603,330,273,52.118644067796616,1.951219512195122,98.04878048780488,53.65853658536586,44.390243902439025
01615,01,615,896,389,6,383,212,171,43.41517857142857,1.5424164524421593,98.45758354755783,54.498714652956295,43.958868894601544
01616,01,616,1123,537,7,530,228,302,47.81834372217275,1.303538175046555,98.69646182495345,42.45810055865922,56.23836126629422
01617,01,617,1031,493,18,475,262,213,47.8176527643065,3.6511156186612577,96.34888438133873,53.14401622718052,43.20486815415821
01618,01,618,1402,646,18,628,323,305,46.07703281027104,2.786377708978328,97.21362229102168,50.0,47.21362229102167
01619,01,619,1221,611,20,591,305,286,50.04095004095004,3.273322422258593,96.7266775777414,49.91816693944354,46.808510638297875
01620,01,620,976,445,9,436,256,180,45.59426229508197,2.0224719101123596,97.97752808988764,57.528089887640455,40.44943820224719
01621,01,621,980,419,18,401,252,149,42.755102040816325,4.295942720763723,95.70405727923628,60.14319809069213,35.56085918854415
01622,01,622,662,263,8,255,146,109,39.72809667673716,3.041825095057034,96.95817490494296,55.51330798479087,41.44486692015209
01623,01,623,901,353,6,347,164,183,39.178690344062154,1.69971671388102,98.30028328611898,46.45892351274787,51.84135977337111
01624,01,624,1248,501,23,478,273,205,40.144230769230774,4.590818363273453,95.40918163672654,54.49101796407185,40.91816367265469
01625,01,625,1017,488,12,476,295,181,47.984267453294,2.459016393442623,97.54098360655738,60.45081967213115,37.09016393442623
01700,01,700,804,355,4,351,233,118,44.15422885572139,1.1267605633802817,98.87323943661971,65.63380281690141,33.23943661971831
01701,01,701,1306,611,20,591,267,324,46.784073506891275,3.273322422258593,96.7266775777414,43.69885433715221,53.0278232405892
01702,01,702,1076,481,13,468,281,187,44.70260223048327,2.7027027027027026,97.2972972972973,58.41995841995842,38.87733887733888
01703,01,703,841,406,10,396,234,162,48.275862068965516,2.4630541871921183,97.53694581280789,57.635467980295566,39.90147783251231
01704,01,704,849,381,11,370,192,178,44.87632508833922,2.8871391076115485,97.11286089238845,50.39370078740157,46.71916010498688
01705,01,705,968,484,14,470,221,249,50.0,2.8925619834710745,97.10743801652893,45.66115702479338,51.446280991735534
01706,01,706,1203,578,9,569,283,286,48.046550290939315,1.5570934256055362,98.44290657439446,48.96193771626297,49.48096885813148
01707,01,707,1209,650,16,634,340,294,53.76344086021505,2.4615384615384617,97.53846153846155,52.307692307692314,45.230769230769226
01708,01,708,1141,554,5,549,303,246,48.55390008764242,0.9025270758122743,99.09747292418773,54.69314079422383,44.4043321299639
01709,01,709,1087,533,12,521,272,249,49.03403863845446,2.25140712945591,97.74859287054409,51.031894934333955,46.71669793621013
01710,01,710,1300,587,15,572,346,226,45.15384615384615,2.555366269165247,97.44463373083475,58.94378194207837,38.50085178875639
01711,01,711,1056,529,9,520,298,222,50.09469696969697,1.7013232514177694,98.29867674858222,56.33270321361059,41.965973534971646
01712,01,712,1255,576,10,566,330,236,45.896414342629484,1.7361111111111112,98.26388888888889,57.291666666666664,40.97222222222222
01713,01,713,919,372,5,367,237,130,40.47878128400435,1.3440860215053763,98.65591397849462,63.70967741935484,34.946236559139784
01714,01,714,1091,480,14,466,273,193,43.996333638863426,2.9166666666666665,97.08333333333333,56.875,40.208333333333336
01715,01,715,1182,569,11,558,374,184,48.13874788494078,1.9332161687170473,98.06678383128296,65.72934973637962,32.33743409490334
01716,01,716,913,446,9,437,299,138,48.849945235487404,2.0179372197309418,97.98206278026906,67.04035874439462,30.94170403587444
01717,01,717,1127,534,8,526,356,170,47.38243123336291,1.4981273408239701,98.50187265917603,66.66666666666666,31.835205992509362
01718,01,718,844,366,11,355,223,132,43.3649289099526,3.0054644808743167,96.99453551912568,60.92896174863388,36.0655737704918
01719,01,719,985,456,19,437,307,130,46.29441624365482,4.166666666666666,95.83333333333334,67.32456140350878,28.50877192982456
01720,01,720,1198,595,18,577,349,228,49.666110183639404,3.0252100840336134,96.97478991596638,58.655462184873954,38.31932773109244
01721,01,721,1116,500,16,484,339,145,44.80286738351255,3.2,96.8,67.80000000000001,28.999999999999996
01722,01,722,1023,530,17,513,308,205,51.80840664711632,3.207547169811321,96.79245283018868,58.11320754716981,38.67924528301887
01723,01,723,1044,537,6,531,307,224,51.43678160919541,1.1173184357541899,98.88268156424581,57.16945996275605,41.71322160148976
01724,01,724,895,451,10,441,292,149,50.391061452513966,2.2172949002217295,97.78270509977827,64.7450110864745,33.03769401330377
01725,01,725,1029,473,12,461,322,139,45.96695821185617,2.536997885835095,97.46300211416491,68.07610993657505,29.38689217758985
02101,02,101,1095,504,12,492,260,232,46.02739726027397,2.380952380952381,97.61904761904762,51.587301587301596,46.03174603174603
02102,02,102,1760,918,24,894,406,488,52.159090909090914,2.6143790849673203,97.38562091503267,44.226579520697165,53.15904139433552
02103,02,103,1704,864,33,831,380,451,50.70422535211267,3.8194444444444446,96.18055555555556,43.98148148148148,52.19907407407407
02104,02,104,1533,821,24,797,400,397,53.55512067840835,2.92326431181486,97.07673568818514,48.721071863581,48.355663824604136
02105,02,105,1743,859,22,837,478,359,49.282845668387836,2.5611175785797435,97.43888242142026,55.64610011641443,41.79278230500582
02106,02,106,1851,973,33,940,452,488,52.56618044300379,3.391572456320658,96.60842754367934,46.45426515930113,50.15416238437821
02107,02,107,1500,697,19,678,323,355,46.46666666666667,2.72596843615495,97.27403156384506,46.34146341463415,50.9325681492109
02108,02,108,1814,938,18,920,444,476,51.70893054024256,1.9189765458422177,98.08102345415777,47.33475479744136,50.74626865671642
02109,02,109,1502,812,26,786,333,453,54.061251664447404,3.201970443349754,96.79802955665025,41.00985221674877,55.78817733990148
02110,02,110,1414,735,24,711,308,403,51.98019801980198,3.2653061224489797,96.73469387755102,41.904761904761905,54.82993197278911
02111,02,111,1597,835,26,809,333,476,52.28553537883531,3.1137724550898205,96.88622754491017,39.880239520958085,57.00598802395209
02112,02,112,1748,906,5,901,383,518,51.830663615560645,0.5518763796909493,99.44812362030905,42.27373068432671,57.17439293598234
02113,02,113,1518,805,33,772,290,482,53.03030303030303,4.099378881987578,95.90062111801242,36.024844720496894,59.87577639751552
02114,02,114,1152,631,15,616,230,386,54.77430555555556,2.3771790808240887,97.62282091917591,36.450079239302696,61.17274167987322
02115,02,115,1329,697,4,693,293,400,52.44544770504138,0.5738880918220948,99.4261119081779,42.03730272596843,57.388809182209464
02116,02,116,1678,889,36,853,361,492,52.97973778307509,4.049493813273341,95.95050618672666,40.607424071991,55.34308211473565
02117,02,117,1534,761,19,742,366,376,49.60886571056062,2.4967148488830486,97.50328515111694,48.0946123521682,49.40867279894875
02118,02,118,1453,696,33,663,257,406,47.9008947006194,4.741379310344827,95.25862068965517,36.92528735632184,58.333333333333336
02119,02,119,1579,837,36,801,305,496,53.008233058898035,4.301075268817205,95.6989247311828,36.43966547192354,59.25925925925925
02120,02,120,1798,920,31,889,387,502,51.16796440489433,3.369565217391304,96.6304347826087,42.06521739130435,54.565217391304344
02121,02,121,1618,879,25,854,323,531,54.326328800988875,2.844141069397042,97.15585893060296,36.74630261660978,60.40955631399317
02122,02,122,1426,696,23,673,301,372,48.80785413744741,3.3045977011494254,96.69540229885058,43.247126436781606,53.44827586206896
02201,02,201,1059,565,18,547,190,357,53.352219074598686,3.185840707964602,96.8141592920354,33.6283185840708,63.1858407079646
02202,02,202,1351,613,19,594,333,261,45.373797187268686,3.0995106035889073,96.90048939641109,54.32300163132137,42.57748776508972
02203,02,203,1150,579,14,565,268,297,50.34782608695652,2.4179620034542317,97.58203799654576,46.286701208981,51.29533678756477
02204,02,204,869,476,14,462,202,260,54.77560414269275,2.941176470588235,97.05882352941177,42.436974789915965,54.621848739495796
02205,02,205,1356,738,14,724,270,454,54.424778761061944,1.8970189701897018,98.1029810298103,36.58536585365854,61.517615176151764
02206,02,206,1374,686,30,656,256,400,49.927219796215425,4.373177842565598,95.6268221574344,37.31778425655977,58.309037900874635
02207,02,207,1319,710,22,688,252,436,53.82865807429871,3.0985915492957745,96.90140845070422,35.49295774647888,61.408450704225345
02208,02,208,1084,595,19,576,263,313,54.889298892988926,3.1932773109243695,96.80672268907563,44.20168067226891,52.60504201680673
02209,02,209,1171,595,33,562,256,306,50.81127241673783,5.546218487394958,94.45378151260503,43.02521008403362,51.42857142857142
02210,02,210,1166,573,32,541,199,342,49.14236706689537,5.5846422338568935,94.4153577661431,34.72949389179756,59.68586387434554
02211,02,211,1126,588,20,568,223,345,52.2202486678508,3.4013605442176873,96.5986394557823,37.92517006802721,58.673469387755105
02212,02,212,1207,722,23,699,234,465,59.81772990886496,3.1855955678670362,96.81440443213296,32.40997229916898,64.40443213296399
02213,02,213,1053,567,21,546,254,292,53.84615384615385,3.7037037037037033,96.29629629629629,44.79717813051146,51.49911816578483
02214,02,214,1427,815,24,791,321,470,57.11282410651717,2.9447852760736195,97.05521472392637,39.38650306748466,57.668711656441715
02215,02,215,1702,924,24,900,387,513,54.28907168037603,2.5974025974025974,97.40259740259741,41.883116883116884,55.519480519480524
02216,02,216,1302,680,38,642,274,368,52.22734254992319,5.588235294117648,94.41176470588235,40.294117647058826,54.11764705882353
02217,02,217,1660,938,29,909,349,560,56.506024096385545,3.091684434968017,96.90831556503198,37.20682302771855,59.70149253731343
02218,02,218,1711,901,37,864,364,500,52.65926358854471,4.1065482796892345,95.89345172031076,40.399556048834626,55.49389567147613
02219,02,219,974,517,20,497,195,302,53.08008213552361,3.8684719535783367,96.13152804642166,37.71760154738878,58.41392649903289
02220,02,220,1497,832,23,809,338,471,55.577822311289246,2.7644230769230766,97.23557692307693,40.625,56.61057692307693
02221,02,221,1438,760,30,730,330,400,52.85118219749653,3.9473684210526314,96.05263157894737,43.42105263157895,52.63157894736842
02222,02,222,1350,724,17,707,279,428,53.629629629629626,2.3480662983425415,97.65193370165746,38.53591160220994,59.11602209944752
02223,02,223,1697,868,19,849,462,387,51.14908662345316,2.1889400921658986,97.81105990783409,53.2258064516129,44.585253456221196
02224,02,224,1423,775,20,755,331,424,54.46240337315531,2.5806451612903225,97.41935483870968,42.70967741935484,54.70967741935484
02225,02,225,1445,768,24,744,308,436,53.148788927335644,3.125,96.875,40.10416666666667,56.770833333333336
02226,02,226,1474,887,15,872,404,468,60.1763907734057,1.6910935738444193,98.30890642615559,45.5467869222097,52.76211950394588
02301,02,301,1199,603,10,593,360,233,50.29190992493745,1.658374792703151,98.34162520729684,59.70149253731343,38.640132669983416
02302,02,302,1577,724,37,687,437,250,45.90995561192137,5.110497237569061,94.88950276243095,60.35911602209944,34.530386740331494
02303,02,303,557,251,6,245,155,90,45.062836624775585,2.3904382470119523,97.60956175298804,61.75298804780876,35.85657370517929
02304,02,304,1378,654,21,633,334,299,47.46008708272859,3.211009174311927,96.78899082568807,51.07033639143731,45.718654434250766
02305,02,305,1294,607,10,597,387,210,46.908809891808346,1.6474464579901154,98.35255354200989,63.75617792421746,34.596375617792425
02306,02,306,1380,665,6,659,434,225,48.188405797101446,0.9022556390977444,99.09774436090225,65.26315789473685,33.83458646616541
02307,02,307,1557,739,22,717,420,297,47.46307000642261,2.9769959404600814,97.02300405953991,56.833558863328825,40.189445196211096
02308,02,308,1048,461,12,449,264,185,43.98854961832061,2.6030368763557483,97.39696312364426,57.26681127982647,40.130151843817785
02309,02,309,1302,641,15,626,414,212,49.23195084485407,2.3400936037441498,97.65990639625585,64.58658346333853,33.073322932917314
02310,02,310,1282,663,21,642,344,298,51.716068642745704,3.167420814479638,96.83257918552036,51.88536953242836,44.94720965309201
02311,02,311,1208,643,23,620,242,378,53.22847682119205,3.576982892690513,96.42301710730948,37.636080870917574,58.78693623639192
02312,02,312,1647,863,29,834,347,487,52.39829993928355,3.360370799536501,96.63962920046349,40.20857473928158,56.43105446118193
02313,02,313,1247,556,13,543,378,165,44.58700882117081,2.338129496402878,97.66187050359713,67.98561151079137,29.676258992805753
02314,02,314,1467,588,6,582,387,195,40.081799591002046,1.0204081632653061,98.9795918367347,65.81632653061224,33.16326530612245
02315,02,315,1458,623,15,608,309,299,42.72976680384088,2.4077046548956664,97.59229534510433,49.59871589085072,47.99357945425361
02316,02,316,1220,520,16,504,319,185,42.62295081967213,3.076923076923077,96.92307692307692,61.346153846153854,35.57692307692308
02317,02,317,903,382,13,369,218,151,42.30343300110742,3.4031413612565444,96.59685863874346,57.06806282722513,39.52879581151832
02318,02,318,1190,590,27,563,282,281,49.57983193277311,4.576271186440678,95.42372881355932,47.79661016949153,47.62711864406779
02319,02,319,1251,664,22,642,243,399,53.0775379696243,3.313253012048193,96.6867469879518,36.596385542168676,60.09036144578314
02320,02,320,1559,829,31,798,351,447,53.17511225144324,3.739445114595899,96.2605548854041,42.340168878166466,53.92038600723763
02321,02,321,1460,652,31,621,286,335,44.657534246575345,4.754601226993866,95.24539877300614,43.86503067484663,51.380368098159515
02322,02,322,1362,736,24,712,289,423,54.03817914831131,3.260869565217391,96.73913043478261,39.266304347826086,57.472826086956516
02323,02,323,1351,696,29,667,271,396,51.51739452257586,4.166666666666666,95.83333333333334,38.93678160919541,56.896551724137936
02324,02,324,1258,624,25,599,306,293,49.60254372019078,4.006410256410256,95.99358974358975,49.03846153846153,46.955128205128204
02325,02,325,1023,521,22,499,197,302,50.9286412512219,4.222648752399232,95.77735124760078,37.81190019193858,57.965451055662186
02401,02,401,1181,591,12,579,292,287,50.042337002540215,2.030456852791878,97.96954314720813,49.407783417935704,48.56175972927242
02402,02,402,1118,522,12,510,257,253,46.69051878354204,2.2988505747126435,97.70114942528735,49.23371647509578,48.46743295019157
02403,02,403,1320,681,18,663,343,320,51.590909090909086,2.643171806167401,97.3568281938326,50.36710719530103,46.98972099853157
02404,02,404,1544,739,20,719,356,363,47.862694300518136,2.706359945872801,97.2936400541272,48.17320703653586,49.12043301759134
02405,02,405,1435,745,23,722,360,362,51.91637630662021,3.087248322147651,96.91275167785236,48.322147651006716,48.59060402684563
02406,02,406,831,426,13,413,211,202,51.26353790613718,3.051643192488263,96.94835680751174,49.53051643192488,47.417840375586856
02407,02,407,959,563,11,552,243,309,58.70698644421272,1.9538188277087036,98.04618117229128,43.16163410301954,54.88454706927176
02408,02,408,1362,696,22,674,330,344,51.10132158590308,3.1609195402298855,96.83908045977012,47.41379310344828,49.42528735632184
02409,02,409,1018,528,10,518,252,266,51.8664047151277,1.893939393939394,98.10606060606061,47.72727272727273,50.378787878787875
02410,02,410,1312,752,31,721,332,389,57.3170731707317,4.122340425531915,95.87765957446808,44.148936170212764,51.72872340425532
02411,02,411,1355,777,21,756,319,437,57.343173431734314,2.7027027027027026,97.2972972972973,41.05534105534105,56.24195624195624
02412,02,412,1358,678,26,652,313,339,49.92636229749632,3.8348082595870205,96.16519174041298,46.16519174041298,50.0
02413,02,413,1599,853,17,836,351,485,53.345841150719195,1.992966002344666,98.00703399765534,41.14888628370457,56.85814771395076
02414,02,414,1425,703,21,682,296,386,49.333333333333336,2.987197724039829,97.01280227596017,42.10526315789473,54.90753911806543
02415,02,415,1851,911,13,898,438,460,49.21663965424095,1.4270032930845227,98.57299670691548,48.07903402854007,50.49396267837542
02416,02,416,1483,653,12,641,314,327,44.03236682400539,1.8376722817764166,98.16232771822358,48.085758039816234,50.076569678407346
02417,02,417,1699,815,21,794,378,416,47.9693937610359,2.5766871165644174,97.42331288343559,46.38036809815951,51.04294478527608
02418,02,418,1140,582,17,565,278,287,51.05263157894737,2.9209621993127146,97.07903780068729,47.766323024054984,49.312714776632305
02419,02,419,1653,910,17,893,422,471,55.05142165759226,1.8681318681318682,98.13186813186813,46.37362637362637,51.758241758241766
02420,02,420,1401,786,11,775,361,414,56.102783725910065,1.3994910941475827,98.60050890585241,45.92875318066158,52.67175572519084
02421,02,421,1251,667,22,645,251,394,53.317346123101515,3.2983508245877062,96.7016491754123,37.631184407796106,59.070464767616194
02422,02,422,1456,822,30,792,328,464,56.456043956043956,3.64963503649635,96.35036496350365,39.90267639902677,56.447688564476884
02423,02,423,948,448,8,440,223,217,47.257383966244724,1.7857142857142856,98.21428571428571,49.776785714285715,48.4375
02424,02,424,1221,555,21,534,272,262,45.45454545454545,3.783783783783784,96.21621621621622,49.009009009009006,47.207207207207205
02425,02,425,1652,859,15,844,440,404,51.99757869249395,1.7462165308498252,98.25378346915018,51.222351571594885,47.0314318975553
02426,02,426,872,441,16,425,241,184,50.57339449541285,3.6281179138321997,96.3718820861678,54.6485260770975,41.723356009070294
02501,02,501,1621,862,28,834,376,458,53.17705120296113,3.248259860788863,96.75174013921114,43.619489559164734,53.1322505800464
02502,02,502,1776,972,25,947,444,503,54.729729729729726,2.57201646090535,97.42798353909465,45.67901234567901,51.74897119341564
02503,02,503,966,565,16,549,239,310,58.488612836438925,2.831858407079646,97.16814159292035,42.30088495575221,54.86725663716814
02504,02,504,1512,779,24,755,344,411,51.521164021164026,3.080872913992298,96.9191270860077,44.1591784338896,52.759948652118105
02505,02,505,1656,836,26,810,344,466,50.48309178743962,3.110047846889952,96.88995215311004,41.14832535885167,55.74162679425837
02506,02,506,1838,933,35,898,380,518,50.761697497279656,3.751339764201501,96.2486602357985,40.728831725616296,55.519828510182215
02507,02,507,1568,865,22,843,368,475,55.16581632653062,2.5433526011560694,97.45664739884393,42.54335260115607,54.91329479768786
02508,02,508,1807,993,14,979,446,533,54.95296070835639,1.4098690835850958,98.5901309164149,44.914400805639474,53.67573011077543
02509,02,509,1471,804,25,779,312,467,54.65669612508498,3.109452736318408,96.8905472636816,38.80597014925373,58.08457711442786
02510,02,510,2064,1142,25,1117,482,635,55.32945736434108,2.189141856392294,97.8108581436077,42.20665499124343,55.60420315236427
02511,02,511,1202,598,17,581,255,326,49.750415973377706,2.842809364548495,97.15719063545151,42.642140468227424,54.515050167224075
02512,02,512,1307,661,24,637,285,352,50.57383320581484,3.6308623298033282,96.36913767019666,43.11649016641452,53.25264750378215
02513,02,513,1271,711,26,685,338,347,55.94020456333596,3.6568213783403656,96.34317862165963,47.53867791842475,48.80450070323488
02514,02,514,1430,780,29,751,324,427,54.54545454545454,3.717948717948718,96.28205128205128,41.53846153846154,54.74358974358975
02515,02,515,1547,806,25,781,371,410,52.10084033613446,3.101736972704715,96.89826302729529,46.02977667493796,50.86848635235732
02516,02,516,1259,661,28,633,291,342,52.50198570293884,4.236006051437216,95.76399394856278,44.024205748865356,51.73978819969742
02517,02,517,1236,666,12,654,270,384,53.883495145631066,1.8018018018018018,98.1981981981982,40.54054054054054,57.65765765765766
02518,02,518,962,512,22,490,195,295,53.222453222453225,4.296875,95.703125,38.0859375,57.6171875
02519,02,519,1429,793,30,763,313,450,55.49335199440167,3.783102143757881,96.21689785624213,39.470365699873895,56.746532156368225
02520,02,520,1657,807,30,777,300,477,48.70247435123717,3.717472118959108,96.28252788104089,37.174721189591075,59.10780669144982
02521,02,521,1521,785,29,756,298,458,51.610782380013156,3.694267515923567,96.30573248407643,37.961783439490446,58.34394904458598
02522,02,522,1398,730,12,718,329,389,52.21745350500715,1.643835616438356,98.35616438356163,45.06849315068493,53.28767123287671
02523,02,523,961,481,16,465,203,262,50.052029136316335,3.3264033264033266,96.67359667359668,42.20374220374221,54.469854469854475
02524,02,524,1323,676,19,657,270,387,51.09599395313681,2.8106508875739644,97.18934911242604,39.94082840236686,57.24852071005917
03101,03,101,2133,1121,27,1094,545,549,52.55508673230192,2.408563782337199,97.5914362176628,48.61730597680642,48.974130240856375
03102,03,102,1850,875,13,862,454,408,47.2972972972973,1.4857142857142858,98.5142857142857,51.88571428571429,46.62857142857143
03103,03,103,1447,644,20,624,327,297,44.50587422252937,3.1055900621118013,96.8944099378882,50.77639751552795,46.11801242236025
03104,03,104,1508,672,19,653,371,282,44.56233421750663,2.8273809523809526,97.17261904761905,55.208333333333336,41.964285714285715
03105,03,105,1104,598,10,588,309,279,54.166666666666664,1.6722408026755853,98.32775919732441,51.67224080267558,46.65551839464883
03106,03,106,1408,635,4,631,414,217,45.09943181818182,0.6299212598425197,99.37007874015748,65.19685039370079,34.17322834645669
03107,03,107,916,457,2,455,299,156,49.890829694323145,0.437636761487965,99.56236323851203,65.42669584245077,34.13566739606127
03108,03,108,1419,756,24,732,441,291,53.276955602537,3.1746031746031744,96.82539682539682,58.333333333333336,38.492063492063494
03109,03,109,1529,897,17,880,504,376,58.665794637017655,1.89520624303233,98.10479375696767,56.187290969899664,41.917502787068
03110,03,110,1488,823,17,806,476,330,55.30913978494624,2.0656136087484813,97.93438639125152,57.837181044957475,40.09720534629405
03111,03,111,1285,765,6,759,406,353,59.53307392996109,0.7843137254901961,99.2156862745098,53.071895424836605,46.1437908496732
03112,03,112,1323,734,15,719,376,343,55.479969765684054,2.043596730245232,97.95640326975476,51.22615803814714,46.73024523160763
03113,03,113,1538,985,19,966,465,501,64.04421326397919,1.9289340101522845,98.07106598984771,47.20812182741117,50.86294416243655
03114,03,114,1333,775,5,770,350,420,58.139534883720934,0.6451612903225806,99.35483870967742,45.16129032258064,54.19354838709678
03115,03,115,1533,898,14,884,449,435,58.577951728636656,1.55902004454343,98.44097995545657,50.0,48.44097995545657
03116,03,116,1595,933,13,920,540,380,58.49529780564263,1.3933547695605575,98.60664523043944,57.87781350482315,40.728831725616296
03117,03,117,1504,793,16,777,501,276,52.72606382978723,2.01765447667087,97.98234552332913,63.17780580075662,34.80453972257251
03118,03,118,1536,883,12,871,405,466,57.486979166666664,1.3590033975084939,98.6409966024915,45.86636466591166,52.774631936579844
03119,03,119,1858,1055,7,1048,543,505,56.78148546824543,0.6635071090047393,99.33649289099526,51.469194312796205,47.867298578199055
03120,03,120,1869,1040,15,1025,488,537,55.644729802033176,1.4423076923076923,98.5576923076923,46.92307692307692,51.63461538461539
03121,03,121,1881,1028,13,1015,515,500,54.65178096757044,1.264591439688716,98.73540856031128,50.09727626459144,48.63813229571984
03122,03,122,1610,897,7,890,456,434,55.714285714285715,0.7803790412486065,99.21962095875139,50.836120401337794,48.3835005574136
03123,03,123,1525,946,8,938,556,382,62.032786885245905,0.8456659619450317,99.15433403805497,58.7737843551797,40.38054968287527
03201,03,201,643,454,7,447,284,163,70.60653188180405,1.5418502202643172,98.45814977973568,62.55506607929515,35.90308370044053
03202,03,202,861,543,11,532,299,233,63.06620209059234,2.0257826887661143,97.97421731123389,55.06445672191529,42.9097605893186
03203,03,203,1529,882,6,876,530,346,57.68476128188358,0.6802721088435374,99.31972789115646,60.090702947845806,39.229024943310655
03204,03,204,1578,866,11,855,516,339,54.879594423320654,1.2702078521939952,98.72979214780601,59.58429561200924,39.14549653579677
03205,03,205,1428,755,12,743,407,336,52.871148459383754,1.5894039735099337,98.41059602649007,53.907284768211916,44.503311258278146
03206,03,206,1667,955,20,935,502,433,57.28854229154169,2.094240837696335,97.90575916230367,52.56544502617801,45.340314136125656
03207,03,207,1518,898,13,885,489,396,59.15678524374176,1.447661469933185,98.55233853006682,54.4543429844098,44.097995545657014
03208,03,208,1666,881,7,874,463,411,52.881152460984396,0.7945516458569807,99.20544835414302,52.55391600454029,46.651532349602725
03209,03,209,1696,921,7,914,450,464,54.30424528301887,0.760043431053203,99.2399565689468,48.85993485342019,50.3800217155266
03210,03,210,1751,1035,13,1022,435,587,59.10908052541405,1.2560386473429952,98.74396135265701,42.028985507246375,56.714975845410635
03211,03,211,1537,898,5,893,398,495,58.42550422901757,0.5567928730512249,99.44320712694878,44.32071269487751,55.122494432071264
03212,03,212,1425,795,12,783,364,419,55.78947368421052,1.509433962264151,98.49056603773585,45.78616352201258,52.70440251572327
03213,03,213,1685,915,9,906,346,560,54.3026706231454,0.9836065573770493,99.01639344262296,37.814207650273225,61.20218579234973
03214,03,214,1588,812,6,806,364,442,51.13350125944584,0.7389162561576355,99.26108374384236,44.827586206896555,54.43349753694581
03215,03,215,1503,763,7,756,430,326,50.765136393878905,0.9174311926605505,99.08256880733946,56.356487549148106,42.72608125819135
03216,03,216,1624,818,5,813,433,380,50.36945812807881,0.6112469437652812,99.38875305623472,52.933985330073355,46.454767726161364
03217,03,217,1388,804,16,788,356,432,57.925072046109506,1.9900497512437811,98.00995024875621,44.27860696517413,53.73134328358209
03218,03,218,2007,1068,20,1048,542,506,53.21375186846039,1.8726591760299627,98.12734082397003,50.749063670411985,47.37827715355805
03219,03,219,1571,911,11,900,496,404,57.988542329726286,1.2074643249176729,98.79253567508232,54.4456641053787,44.34687156970362
03220,03,220,1626,888,8,880,290,590,54.61254612546126,0.9009009009009009,99.09909909909909,32.65765765765766,66.44144144144144
03221,03,221,1654,786,6,780,253,527,47.521160822249094,0.7633587786259541,99.23664122137404,32.1882951653944,67.04834605597965
03222,03,222,965,535,13,522,308,214,55.44041450777202,2.4299065420560746,97.57009345794393,57.570093457943926,40.0
03301,03,301,1665,872,8,864,378,486,52.372372372372375,0.9174311926605505,99.08256880733946,43.34862385321101,55.73394495412845
03302,03,302,1677,777,9,768,325,443,46.332737030411444,1.1583011583011582,98.84169884169884,41.82754182754182,57.01415701415702
03303,03,303,1672,854,9,845,385,460,51.07655502392344,1.053864168618267,98.94613583138174,45.08196721311475,53.86416861826698
03304,03,304,1710,921,7,914,331,583,53.85964912280702,0.760043431053203,99.2399565689468,35.93919652551574,63.30076004343105
03305,03,305,1658,868,12,856,351,505,52.35223160434258,1.3824884792626728,98.61751152073732,40.43778801843318,58.17972350230415
03306,03,306,1737,890,8,882,293,589,51.237766263673,0.8988764044943821,99.10112359550561,32.92134831460674,66.17977528089888
03307,03,307,1416,848,11,837,280,557,59.887005649717516,1.2971698113207548,98.70283018867924,33.0188679245283,65.68396226415094
03308,03,308,1328,641,8,633,194,439,48.26807228915663,1.24804992199688,98.75195007800312,30.265210608424336,68.48673946957878
03309,03,309,1442,804,3,801,247,554,55.75589459084605,0.3731343283582089,99.6268656716418,30.721393034825873,68.90547263681593
03310,03,310,1589,886,11,875,262,613,55.75833857772183,1.2415349887133182,98.75846501128667,29.571106094808126,69.18735891647856
03311,03,311,1064,552,6,546,119,427,51.8796992481203,1.0869565217391304,98.91304347826086,21.557971014492754,77.35507246376811
03312,03,312,1556,847,3,844,175,669,54.434447300771204,0.3541912632821724,99.64580873671783,20.66115702479339,78.98465171192444
03313,03,313,1455,833,10,823,205,618,57.250859106529205,1.2004801920768309,98.79951980792316,24.60984393757503,74.18967587034814
03314,03,314,1552,711,7,704,126,578,45.81185567010309,0.9845288326300985,99.01547116736991,17.72151898734177,81.29395218002813
03315,03,315,1526,871,8,863,202,661,57.07732634338139,0.9184845005740528,99.08151549942595,23.19173363949483,75.88978185993112
03316,03,316,1745,1022,10,1012,254,758,58.56733524355301,0.9784735812133072,99.02152641878669,24.853228962818,74.16829745596868
03317,03,317,1697,928,4,924,231,693,54.68473777253977,0.43103448275862066,99.56896551724138,24.892241379310345,74.67672413793103
03318,03,318,1568,786,10,776,233,543,50.12755102040817,1.2722646310432568,98.72773536895674,29.64376590330789,69.08396946564885
03319,03,319,1753,901,14,887,368,519,51.39760410724472,1.553829078801332,98.44617092119867,40.84350721420644,57.60266370699223
03320,03,320,1557,790,14,776,140,636,50.73859987154785,1.7721518987341773,98.22784810126582,17.72151898734177,80.50632911392405
03321,03,321,1588,888,8,880,218,662,55.91939546599496,0.9009009009009009,99.09909909909909,24.54954954954955,74.54954954954955
03401,03,401,1860,988,14,974,429,545,53.118279569892465,1.417004048582996,98.582995951417,43.42105263157895,55.16194331983806
03402,03,402,1754,961,11,950,359,591,54.78905359179019,1.1446409989594173,98.85535900104058,37.356919875130075,61.49843912591051
03403,03,403,1928,996,24,972,403,569,51.65975103734441,2.4096385542168677,97.59036144578313,40.46184738955823,57.1285140562249
03404,03,404,1528,702,24,678,268,410,45.94240837696335,3.418803418803419,96.58119658119658,38.17663817663818,58.4045584045584
03405,03,405,1622,843,30,813,410,403,51.972872996300865,3.558718861209965,96.44128113879003,48.63582443653618,47.805456702253856
03406,03,406,1747,892,18,874,426,448,51.05895821408129,2.0179372197309418,97.98206278026906,47.75784753363229,50.224215246636774
03407,03,407,1672,865,12,853,458,395,51.73444976076556,1.3872832369942196,98.61271676300578,52.947976878612714,45.664739884393065
03408,03,408,1845,879,28,851,425,426,47.642276422764226,3.1854379977246867,96.81456200227532,48.35039817974972,48.4641638225256
03409,03,409,1330,636,9,627,267,360,47.81954887218045,1.4150943396226416,98.58490566037736,41.9811320754717,56.60377358490566
03410,03,410,1351,721,24,697,350,347,53.36787564766839,3.3287101248266295,96.67128987517337,48.54368932038835,48.12760055478502
03411,03,411,1694,941,8,933,239,694,55.548996458087366,0.8501594048884166,99.14984059511158,25.398512221041447,73.75132837407014
03412,03,412,1563,836,6,830,180,650,53.48688419705694,0.7177033492822966,99.28229665071771,21.5311004784689,77.75119617224881
03413,03,413,1522,793,9,784,238,546,52.102496714848876,1.1349306431273645,98.86506935687264,30.012610340479196,68.85245901639344
03414,03,414,2148,1132,18,1114,416,698,52.7001862197393,1.5901060070671376,98.40989399293287,36.74911660777385,61.660777385159015
03415,03,415,1242,712,12,700,325,375,57.326892109500804,1.6853932584269662,98.31460674157303,45.646067415730336,52.6685393258427
03416,03,416,1749,908,12,896,364,532,51.91538021726701,1.3215859030837005,98.6784140969163,40.08810572687225,58.590308370044056
03417,03,417,1741,844,20,824,398,426,48.47788627225732,2.3696682464454977,97.6303317535545,47.1563981042654,50.4739336492891
03418,03,418,1010,389,6,383,189,194,38.51485148514852,1.5424164524421593,98.45758354755783,48.58611825192802,49.87146529562982
03501,03,501,1691,928,13,915,339,576,54.87876995860438,1.4008620689655173,98.59913793103449,36.5301724137931,62.06896551724138
03502,03,502,1326,703,15,688,225,463,53.01659125188537,2.1337126600284493,97.86628733997155,32.005689900426745,65.8605974395448
03503,03,503,1609,896,15,881,281,600,55.68676196395277,1.6741071428571428,98.32589285714286,31.361607142857146,66.96428571428571
03504,03,504,1380,775,10,765,262,503,56.15942028985508,1.2903225806451613,98.70967741935483,33.806451612903224,64.90322580645162
03505,03,505,1287,657,15,642,275,367,51.048951048951054,2.28310502283105,97.71689497716895,41.856925418569254,55.8599695585997
03506,03,506,1482,757,16,741,332,409,51.07962213225371,2.1136063408190227,97.88639365918098,43.85733157199472,54.02906208718626
03507,03,507,1588,801,12,789,337,452,50.44080604534005,1.4981273408239701,98.50187265917603,42.072409488139826,56.42946317103621
03508,03,508,1463,760,11,749,311,438,51.94805194805194,1.4473684210526316,98.55263157894737,40.921052631578945,57.631578947368425
03509,03,509,1779,914,17,897,327,570,51.377178189994375,1.8599562363238513,98.14004376367615,35.776805251641136,62.36323851203501
03510,03,510,1474,788,7,781,276,505,53.45997286295794,0.8883248730964468,99.11167512690355,35.025380710659896,64.08629441624365
03511,03,511,1628,918,9,909,245,664,56.388206388206385,0.9803921568627451,99.01960784313727,26.68845315904139,72.33115468409585
03512,03,512,1580,763,14,749,439,310,48.29113924050633,1.834862385321101,98.1651376146789,57.536041939711666,40.62909567496724
03513,03,513,1703,898,11,887,279,608,52.730475631238996,1.2249443207126949,98.7750556792873,31.06904231625835,67.70601336302894
03514,03,514,1569,853,7,846,354,492,54.36583811344805,0.8206330597889802,99.17936694021103,41.50058616647128,57.678780773739746
03515,03,515,1294,755,5,750,180,570,58.34621329211747,0.6622516556291391,99.33774834437085,23.841059602649008,75.49668874172185
03516,03,516,1802,939,11,928,218,710,52.10876803551609,1.1714589989350372,98.82854100106496,23.21618743343983,75.61235356762514
03517,03,517,1229,729,4,725,138,587,59.31651749389748,0.5486968449931412,99.45130315500685,18.930041152263374,80.52126200274348
03518,03,518,1427,730,9,721,232,489,51.156271899089,1.2328767123287672,98.76712328767124,31.780821917808222,66.98630136986301
03519,03,519,1314,654,8,646,261,385,49.77168949771689,1.2232415902140672,98.77675840978594,39.908256880733944,58.86850152905198
03520,03,520,1544,835,12,823,334,489,54.08031088082902,1.437125748502994,98.562874251497,40.0,58.56287425149701
03600,03,600,1501,780,23,757,281,476,51.965356429047304,2.9487179487179485,97.05128205128204,36.02564102564102,61.02564102564103
03601,03,601,1554,829,16,813,346,467,53.346203346203346,1.9300361881785282,98.06996381182147,41.73703256936068,56.332931242460795
03602,03,602,1544,811,14,797,318,479,52.52590673575129,1.726263871763255,98.27373612823675,39.21085080147966,59.06288532675708
03603,03,603,1197,648,14,634,268,366,54.13533834586466,2.1604938271604937,97.8395061728395,41.358024691358025,56.481481481481474
03604,03,604,1376,774,13,761,288,473,56.25,1.6795865633074936,98.3204134366925,37.2093023255814,61.111111111111114
03605,03,605,1452,841,22,819,316,503,57.92011019283747,2.6159334126040426,97.38406658739595,37.5743162901308,59.80975029726516
03606,03,606,1646,899,22,877,327,550,54.61725394896719,2.4471635150166855,97.55283648498332,36.373748609566185,61.179087875417125
03607,03,607,1614,902,10,892,359,533,55.88599752168525,1.1086474501108647,98.89135254988913,39.80044345898005,59.09090909090909
03608,03,608,1585,888,19,869,372,497,56.02523659305994,2.1396396396396398,97.86036036036036,41.891891891891895,55.968468468468465
03609,03,609,1588,872,15,857,378,479,54.91183879093199,1.7201834862385321,98.27981651376146,43.34862385321101,54.93119266055045
03610,03,610,1613,948,17,931,417,514,58.7724736515809,1.7932489451476792,98.20675105485233,43.9873417721519,54.219409282700425
03611,03,611,1534,752,13,739,336,403,49.02216427640156,1.7287234042553192,98.27127659574468,44.680851063829785,53.590425531914896
03612,03,612,1517,786,11,775,314,461,51.812788398154254,1.3994910941475827,98.60050890585241,39.94910941475827,58.651399491094146
03613,03,613,1444,769,15,754,326,428,53.25484764542936,1.950585175552666,98.04941482444734,42.392717815344604,55.65669700910273
03614,03,614,1732,950,26,924,352,572,54.84988452655889,2.736842105263158,97.26315789473684,37.05263157894737,60.21052631578947
03615,03,615,923,518,11,507,242,265,56.12134344528711,2.1235521235521233,97.87644787644788,46.71814671814672,51.15830115830116
03616,03,616,816,438,7,431,168,263,53.67647058823529,1.5981735159817352,98.40182648401826,38.35616438356164,60.04566210045662
03617,03,617,1626,926,28,898,415,483,56.94956949569495,3.023758099352052,96.97624190064795,44.81641468682505,52.159827213822894
03618,03,618,1699,903,14,889,394,495,53.148911124190704,1.550387596899225,98.44961240310077,43.63233665559247,54.81727574750831
03619,03,619,1427,754,21,733,294,439,52.838121934127535,2.7851458885941645,97.21485411140584,38.9920424403183,58.22281167108754
03620,03,620,1752,950,14,936,439,497,54.22374429223744,1.4736842105263157,98.52631578947368,46.21052631578947,52.31578947368421
03701,03,701,1521,843,15,828,409,419,55.42406311637082,1.7793594306049825,98.22064056939502,48.517200474495844,49.70344009489917
03702,03,702,1456,798,0,798,364,434,54.807692307692314,0.0,100.0,45.614035087719294,54.385964912280706
03703,03,703,1652,859,11,848,428,420,51.99757869249395,1.2805587892898718,98.71944121071013,49.825378346915016,48.894062863795114
03704,03,704,1337,670,10,660,363,297,50.11219147344802,1.4925373134328357,98.50746268656717,54.179104477611936,44.32835820895523
03705,03,705,1639,860,24,836,380,456,52.47101891397193,2.7906976744186047,97.20930232558139,44.18604651162791,53.02325581395348
03706,03,706,1634,745,19,726,361,365,45.59363525091799,2.5503355704697985,97.4496644295302,48.45637583892618,48.99328859060403
03707,03,707,1917,869,27,842,441,401,45.33124673969745,3.1070195627157653,96.89298043728424,50.74798619102416,46.14499424626007
03708,03,708,1608,792,0,792,360,432,49.25373134328358,0.0,100.0,45.45454545454545,54.54545454545454
03709,03,709,1645,898,18,880,429,451,54.589665653495445,2.0044543429844097,97.9955456570156,47.772828507795104,50.222717149220486
03710,03,710,1802,952,30,922,432,490,52.83018867924528,3.1512605042016806,96.84873949579831,45.378151260504204,51.470588235294116
03711,03,711,1548,720,14,706,333,373,46.51162790697674,1.9444444444444444,98.05555555555556,46.25,51.80555555555556
03712,03,712,1534,808,13,795,389,406,52.672750977835726,1.608910891089109,98.39108910891089,48.14356435643564,50.24752475247525
03713,03,713,1486,785,5,780,349,431,52.8263795423957,0.6369426751592357,99.36305732484077,44.45859872611465,54.904458598726116
03714,03,714,1297,653,19,634,257,377,50.34695451040864,2.909647779479326,97.09035222052067,39.356814701378255,57.733537519142416
03715,03,715,1672,851,10,841,356,485,50.897129186602875,1.1750881316098707,98.82491186839013,41.8331374853114,56.99177438307873
03716,03,716,1506,763,11,752,328,424,50.66401062416999,1.4416775884665793,98.55832241153341,42.988204456094365,55.57011795543906
03717,03,717,1345,678,7,671,284,387,50.4089219330855,1.0324483775811208,98.96755162241888,41.88790560471977,57.07964601769911
03718,03,718,1081,624,14,610,279,331,57.724329324699355,2.2435897435897436,97.75641025641025,44.71153846153847,53.044871794871796
03719,03,719,1358,733,7,726,364,362,53.97643593519882,0.9549795361527967,99.0450204638472,49.65893587994543,49.38608458390178
03720,03,720,1440,805,18,787,327,460,55.90277777777778,2.236024844720497,97.7639751552795,40.62111801242236,57.14285714285714
03801,03,801,1945,985,16,969,541,428,50.6426735218509,1.6243654822335025,98.3756345177665,54.923857868020306,43.45177664974619
03802,03,802,1499,824,27,797,367,430,54.96997998665777,3.2766990291262137,96.72330097087378,44.538834951456316,52.18446601941748
03803,03,803,1491,780,27,753,332,421,52.31388329979879,3.4615384615384617,96.53846153846153,42.56410256410256,53.97435897435897
03804,03,804,1472,852,15,837,356,481,57.88043478260869,1.7605633802816902,98.23943661971832,41.78403755868544,56.455399061032864
03805,03,805,1786,951,17,934,413,521,53.2474804031355,1.7875920084121977,98.2124079915878,43.4279705573081,54.78443743427971
03806,03,806,1655,871,27,844,392,452,52.62839879154079,3.0998851894374284,96.90011481056257,45.00574052812859,51.894374282433986
03807,03,807,1520,788,14,774,317,457,51.84210526315789,1.7766497461928936,98.22335025380711,40.22842639593909,57.99492385786802
03808,03,808,1731,811,22,789,472,317,46.85153090699018,2.7127003699136867,97.28729963008631,58.199753390875465,39.08754623921085
03809,03,809,1588,812,20,792,339,453,51.13350125944584,2.4630541871921183,97.53694581280789,41.748768472906406,55.78817733990148
03810,03,810,1453,806,17,789,374,415,55.47143840330351,2.109181141439206,97.89081885856079,46.40198511166253,51.488833746898266
03811,03,811,1471,795,22,773,348,425,54.0448674371176,2.767295597484277,97.23270440251572,43.77358490566038,53.459119496855344
03812,03,812,1675,877,20,857,393,464,52.35820895522389,2.280501710376283,97.71949828962371,44.81185860889396,52.90763968072976
03813,03,813,1797,997,18,979,477,502,55.48135781858653,1.8054162487462388,98.19458375125376,47.84353059177533,50.35105315947843
03814,03,814,1402,753,13,740,330,410,53.70898716119829,1.7264276228419653,98.27357237715803,43.82470119521912,54.448871181938905
03815,03,815,1522,843,25,818,366,452,55.38764783180026,2.965599051008304,97.03440094899169,43.41637010676156,53.618030842230134
03816,03,816,1475,822,19,803,385,418,55.728813559322035,2.3114355231143553,97.68856447688565,46.83698296836983,50.85158150851582
03817,03,817,1295,652,16,636,295,341,50.34749034749034,2.4539877300613497,97.54601226993866,45.24539877300614,52.30061349693251
03818,03,818,1274,631,15,616,304,312,49.529042386185246,2.3771790808240887,97.62282091917591,48.17749603803487,49.44532488114105
03819,03,819,944,510,14,496,213,283,54.02542372881356,2.7450980392156863,97.25490196078431,41.76470588235294,55.490196078431374
03901,03,901,1648,876,15,861,369,492,53.15533980582524,1.7123287671232876,98.28767123287672,42.12328767123288,56.16438356164384
03902,03,902,1567,875,14,861,416,445,55.83918315252075,1.6,98.4,47.542857142857144,50.857142857142854
03903,03,903,1816,1077,25,1052,404,648,59.30616740088106,2.321262766945218,97.67873723305478,37.511606313834726,60.16713091922006
03904,03,904,1698,954,19,935,420,515,56.18374558303887,1.9916142557651992,98.0083857442348,44.0251572327044,53.9832285115304
03905,03,905,1374,716,15,701,359,342,52.11062590975255,2.094972067039106,97.90502793296089,50.13966480446928,47.76536312849162
03906,03,906,1141,600,19,581,270,311,52.58545135845749,3.166666666666667,96.83333333333334,45.0,51.83333333333333
03907,03,907,1176,615,16,599,345,254,52.295918367346935,2.6016260162601625,97.39837398373984,56.09756097560976,41.300813008130085
03908,03,908,1572,721,25,696,397,299,45.86513994910941,3.467406380027739,96.53259361997226,55.0624133148405,41.47018030513176
03909,03,909,1049,580,23,557,264,293,55.29075309818875,3.9655172413793105,96.03448275862068,45.51724137931035,50.51724137931034
03910,03,910,1236,536,19,517,248,269,43.36569579288026,3.544776119402985,96.45522388059702,46.26865671641791,50.18656716417911
03911,03,911,1369,693,17,676,332,344,50.6208911614317,2.4531024531024532,97.54689754689755,47.90764790764791,49.63924963924964
03912,03,912,1351,699,15,684,351,333,51.73945225758697,2.1459227467811157,97.85407725321889,50.21459227467812,47.63948497854077
03913,03,913,1511,799,25,774,354,420,52.87888815354071,3.128911138923655,96.87108886107634,44.30538172715895,52.56570713391739
03914,03,914,975,528,14,514,236,278,54.15384615384615,2.6515151515151514,97.34848484848484,44.696969696969695,52.65151515151515
03915,03,915,1904,966,37,929,433,496,50.73529411764706,3.8302277432712217,96.16977225672878,44.824016563147,51.345755693581786
03916,03,916,1611,912,18,894,351,543,56.61080074487895,1.9736842105263157,98.02631578947368,38.48684210526316,59.539473684210535
03917,03,917,1505,829,15,814,325,489,55.08305647840531,1.8094089264173705,98.19059107358264,39.20386007237636,58.98673100120627
03918,03,918,1446,823,18,805,364,441,56.91562932226832,2.187120291616039,97.81287970838396,44.22843256379101,53.58444714459295
03919,03,919,1639,889,18,871,403,468,54.240390482001224,2.0247469066366706,97.97525309336334,45.3318335208099,52.64341957255343
03920,03,920,1141,553,12,541,297,244,48.466257668711656,2.1699819168173597,97.83001808318264,53.70705244122965,44.12296564195298
03921,03,921,1181,613,18,595,301,294,51.9051651143099,2.936378466557912,97.06362153344209,49.10277324632953,47.96084828711256
03922,03,922,1476,911,17,894,361,533,61.72086720867209,1.8660812294182216,98.13391877058177,39.62678375411636,58.507135016465426
03923,03,923,646,219,13,206,104,102,33.90092879256966,5.93607305936073,94.06392694063926,47.48858447488584,46.57534246575342
03924,03,924,1852,974,29,945,396,549,52.59179265658748,2.97741273100616,97.02258726899385,40.6570841889117,56.365503080082135
04101,04,101,1060,457,3,454,333,121,43.113207547169814,0.6564551422319475,99.34354485776805,72.86652078774617,26.477024070021884
04102,04,102,1090,502,17,485,335,150,46.055045871559635,3.386454183266932,96.61354581673307,66.73306772908366,29.880478087649404
04103,04,103,1107,520,12,508,333,175,46.973803071364046,2.307692307692308,97.6923076923077,64.03846153846153,33.65384615384615
04104,04,104,958,441,7,434,295,139,46.03340292275574,1.5873015873015872,98.4126984126984,66.89342403628117,31.519274376417233
04105,04,105,995,405,10,395,276,119,40.7035175879397,2.4691358024691357,97.53086419753086,68.14814814814815,29.38271604938272
04106,04,106,1406,695,10,685,510,175,49.43100995732574,1.4388489208633095,98.56115107913669,73.38129496402878,25.179856115107913
04107,04,107,1315,618,11,607,409,198,46.99619771863118,1.779935275080906,98.2200647249191,66.18122977346277,32.038834951456316
04108,04,108,811,382,2,380,289,91,47.1023427866831,0.5235602094240838,99.47643979057592,75.6544502617801,23.82198952879581
04109,04,109,891,386,6,380,277,103,43.32210998877666,1.5544041450777202,98.44559585492227,71.76165803108809,26.683937823834196
04110,04,110,1181,582,12,570,415,155,49.28027095681626,2.0618556701030926,97.9381443298969,71.30584192439862,26.632302405498283
04111,04,111,1032,488,1,487,378,109,47.286821705426355,0.20491803278688525,99.79508196721312,77.45901639344262,22.33606557377049
04112,04,112,1256,640,15,625,444,181,50.955414012738856,2.34375,97.65625,69.375,28.281250000000004
04113,04,113,1359,722,14,708,482,226,53.12729948491538,1.9390581717451523,98.06094182825484,66.7590027700831,31.301939058171747
04114,04,114,1247,557,6,551,390,161,44.667201283079386,1.0771992818671454,98.92280071813285,70.01795332136446,28.904847396768403
04115,04,115,1402,738,2,736,468,268,52.63908701854494,0.27100271002710025,99.7289972899729,63.41463414634146,36.31436314363143
04116,04,116,1260,635,15,620,417,203,50.39682539682539,2.3622047244094486,97.63779527559055,65.66929133858268,31.968503937007874
04117,04,117,1624,823,17,806,565,241,50.677339901477836,2.0656136087484813,97.93438639125152,68.65127582017011,29.283110571081412
04118,04,118,1493,681,10,671,471,200,45.612860013395846,1.4684287812041115,98.53157121879589,69.16299559471366,29.368575624082233
04201,04,201,949,447,5,442,282,160,47.10221285563752,1.1185682326621924,98.88143176733782,63.08724832214765,35.79418344519016
04202,04,202,1137,530,8,522,347,175,46.61389621811786,1.509433962264151,98.49056603773585,65.47169811320754,33.0188679245283
04203,04,203,1588,800,12,788,526,262,50.377833753148614,1.5,98.5,65.75,32.75
04204,04,204,1517,749,20,729,602,127,49.373764007910346,2.67022696929239,97.32977303070761,80.37383177570094,16.955941255006675
04205,04,205,1373,699,10,689,520,169,50.910415149308086,1.4306151645207439,98.56938483547926,74.39198855507868,24.177396280400572
04206,04,206,1196,598,8,590,435,155,50.0,1.3377926421404682,98.66220735785953,72.74247491638796,25.91973244147157
04207,04,207,1157,563,9,554,373,181,48.66032843560934,1.5985790408525755,98.40142095914743,66.25222024866785,32.149200710479576
04208,04,208,1712,774,21,753,524,229,45.21028037383177,2.7131782945736433,97.28682170542635,67.70025839793283,29.58656330749354
04209,04,209,1056,524,8,516,347,169,49.621212121212125,1.5267175572519083,98.47328244274809,66.22137404580153,32.25190839694657
04210,04,210,1215,603,11,592,406,186,49.629629629629626,1.8242122719734661,98.17578772802653,67.33001658374793,30.845771144278604
04211,04,211,1445,737,2,735,507,228,51.00346020761246,0.27137042062415195,99.72862957937585,68.79240162822252,30.936227951153324
04212,04,212,1134,513,3,510,353,157,45.23809523809524,0.5847953216374269,99.41520467836257,68.81091617933723,30.60428849902534
04213,04,213,1628,795,9,786,557,229,48.83292383292383,1.1320754716981132,98.86792452830188,70.062893081761,28.80503144654088
04214,04,214,1180,566,18,548,353,195,47.96610169491525,3.180212014134275,96.81978798586573,62.36749116607774,34.45229681978799
04215,04,215,1646,836,19,817,562,255,50.78979343863913,2.272727272727273,97.72727272727273,67.22488038277513,30.502392344497608
04216,04,216,1064,526,4,522,373,149,49.43609022556391,0.7604562737642585,99.23954372623575,70.91254752851711,28.32699619771863
04217,04,217,1441,723,15,708,494,214,50.1734906315059,2.0746887966804977,97.9253112033195,68.32641770401106,29.59889349930844
04218,04,218,1432,733,5,728,536,192,51.187150837988824,0.6821282401091405,99.31787175989086,73.12414733969986,26.193724420190996
04219,04,219,1195,552,10,542,398,144,46.19246861924686,1.8115942028985508,98.18840579710145,72.10144927536231,26.08695652173913
04220,04,220,1222,616,14,602,396,206,50.40916530278232,2.272727272727273,97.72727272727273,64.28571428571429,33.44155844155844
04221,04,221,1227,539,6,533,393,140,43.92828035859821,1.1131725417439702,98.88682745825604,72.91280148423006,25.97402597402597
04222,04,222,817,449,5,444,309,135,54.95716034271726,1.1135857461024499,98.88641425389754,68.8195991091314,30.066815144766146
04223,04,223,1550,764,5,759,540,219,49.29032258064516,0.6544502617801047,99.3455497382199,70.68062827225131,28.664921465968586
04224,04,224,1097,603,17,586,357,229,54.96809480401094,2.8192371475953566,97.18076285240464,59.20398009950249,37.97678275290215
04301,04,301,1270,596,22,574,366,208,46.92913385826772,3.691275167785235,96.30872483221476,61.40939597315436,34.899328859060404
04302,04,302,1108,573,6,567,389,178,51.714801444043324,1.0471204188481675,98.95287958115183,67.88830715532286,31.064572425828967
04303,04,303,1328,712,14,698,469,229,53.6144578313253,1.9662921348314606,98.03370786516854,65.87078651685393,32.162921348314605
04304,04,304,1318,687,3,684,461,223,52.12443095599393,0.43668122270742354,99.56331877729258,67.10334788937409,32.45997088791849
04305,04,305,1519,764,11,753,488,265,50.29624753127058,1.4397905759162304,98.56020942408377,63.87434554973822,34.68586387434555
04306,04,306,1079,614,8,606,352,254,56.90454124189064,1.3029315960912053,98.69706840390879,57.32899022801303,41.36807817589577
04307,04,307,1394,765,26,739,426,313,54.87804878048781,3.3986928104575163,96.60130718954248,55.68627450980392,40.91503267973856
04308,04,308,1530,781,10,771,514,257,51.045751633986924,1.2804097311139564,98.71959026888605,65.81306017925736,32.90653008962868
04309,04,309,1563,777,6,771,544,227,49.71209213051823,0.7722007722007722,99.22779922779922,70.01287001287001,29.214929214929214
04310,04,310,1054,551,14,537,353,184,52.27703984819735,2.540834845735027,97.45916515426497,64.06533575317604,33.39382940108893
04311,04,311,1414,808,15,793,483,310,57.14285714285714,1.8564356435643563,98.14356435643565,59.777227722772274,38.366336633663366
04312,04,312,1225,605,7,598,402,196,49.38775510204081,1.1570247933884297,98.84297520661157,66.44628099173553,32.396694214876035
04313,04,313,1496,686,18,668,409,259,45.855614973262036,2.623906705539359,97.37609329446065,59.62099125364432,37.755102040816325
04314,04,314,1419,739,12,727,429,298,52.078928823114865,1.6238159675236805,98.37618403247632,58.05142083897158,40.32476319350474
04315,04,315,1451,800,8,792,479,313,55.13439007580979,1.0,99.0,59.875,39.125
04316,04,316,1230,623,4,619,412,207,50.65040650406504,0.6420545746388443,99.35794542536117,66.13162118780096,33.22632423756019
04317,04,317,1010,501,4,497,329,168,49.603960396039604,0.7984031936127743,99.20159680638723,65.6686626746507,33.532934131736525
04318,04,318,1132,612,10,602,348,254,54.06360424028268,1.6339869281045754,98.36601307189542,56.86274509803921,41.50326797385621
04319,04,319,908,481,12,469,282,187,52.97356828193832,2.494802494802495,97.5051975051975,58.62785862785863,38.87733887733888
04320,04,320,1569,745,11,734,496,238,47.482472912683235,1.476510067114094,98.52348993288591,66.57718120805369,31.946308724832218
04321,04,321,1292,586,9,577,400,177,45.356037151702786,1.5358361774744027,98.46416382252559,68.25938566552901,30.204778156996586
04322,04,322,1187,599,8,591,360,231,50.463352990732936,1.335559265442404,98.6644407345576,60.10016694490818,38.56427378964942
04323,04,323,1541,784,35,749,519,230,50.8760545100584,4.464285714285714,95.53571428571429,66.19897959183673,29.336734693877553
04324,04,324,1000,505,13,492,356,136,50.5,2.5742574257425743,97.42574257425743,70.49504950495049,26.930693069306933
04401,04,401,1464,680,14,666,452,214,46.44808743169399,2.0588235294117645,97.94117647058823,66.47058823529412,31.470588235294116
04402,04,402,1107,517,16,501,374,127,46.70280036133695,3.0947775628626695,96.90522243713733,72.3404255319149,24.564796905222437
04403,04,403,1577,597,8,589,429,160,37.85668991756499,1.340033500837521,98.65996649916248,71.85929648241206,26.800670016750416
04404,04,404,1052,601,2,599,413,186,57.129277566539926,0.33277870216306155,99.66722129783693,68.71880199667221,30.948419301164726
04405,04,405,1101,564,15,549,371,178,51.22615803814714,2.6595744680851063,97.3404255319149,65.78014184397163,31.560283687943265
04406,04,406,1081,509,3,506,387,119,47.08603145235893,0.5893909626719057,99.41060903732809,76.03143418467585,23.37917485265226
04407,04,407,1481,737,15,722,490,232,49.76367319378798,2.03527815468114,97.96472184531886,66.48575305291723,31.47896879240163
04408,04,408,1362,637,15,622,440,182,46.76945668135096,2.3547880690737837,97.64521193092621,69.07378335949764,28.57142857142857
04409,04,409,1268,631,18,613,405,208,49.76340694006309,2.8526148969889067,97.1473851030111,64.18383518225039,32.9635499207607
04410,04,410,1294,615,18,597,463,134,47.52704791344668,2.9268292682926833,97.07317073170731,75.28455284552845,21.788617886178862
04411,04,411,1407,757,12,745,477,268,53.80241648898365,1.5852047556142668,98.41479524438573,63.01188903566711,35.402906208718626
04412,04,412,1413,731,17,714,512,202,51.733899504600146,2.3255813953488373,97.67441860465115,70.04103967168263,27.63337893296854
04413,04,413,1182,569,9,560,379,181,48.13874788494078,1.5817223198594026,98.41827768014059,66.60808435852373,31.810193321616868
04414,04,414,1395,678,6,672,467,205,48.60215053763441,0.8849557522123894,99.11504424778761,68.87905604719764,30.23598820058997
04415,04,415,1540,705,10,695,494,201,45.77922077922078,1.4184397163120568,98.58156028368793,70.0709219858156,28.510638297872344
04416,04,416,1446,662,12,650,457,193,45.78146611341632,1.812688821752266,98.18731117824774,69.03323262839879,29.154078549848943
04417,04,417,1113,557,8,549,386,163,50.044923629829285,1.436265709156194,98.56373429084381,69.29982046678636,29.263913824057454
04418,04,418,1363,646,13,633,461,172,47.39545121056493,2.0123839009287927,97.9876160990712,71.36222910216719,26.625386996904027
04419,04,419,1270,626,9,617,440,177,49.29133858267716,1.4376996805111821,98.56230031948881,70.28753993610223,28.27476038338658
04420,04,420,1186,553,15,538,401,137,46.62731871838111,2.7124773960216997,97.2875226039783,72.51356238698011,24.77396021699819
04421,04,421,1096,465,4,461,333,128,42.42700729927007,0.8602150537634409,99.13978494623656,71.61290322580646,27.526881720430108
04422,04,422,918,418,3,415,307,108,45.53376906318083,0.7177033492822966,99.28229665071771,73.44497607655502,25.837320574162682
04423,04,423,1182,509,18,491,396,95,43.06260575296108,3.536345776031434,96.46365422396856,77.79960707269156,18.664047151277014
04424,04,424,1213,634,10,624,489,135,52.26710634789777,1.5772870662460567,98.42271293375394,77.12933753943217,21.293375394321767
04425,04,425,1511,734,14,720,523,197,48.5771012574454,1.9073569482288828,98.09264305177112,71.2534059945504,26.83923705722071
04501,04,501,947,463,5,458,338,120,48.89123548046462,1.079913606911447,98.92008639308855,73.00215982721382,25.917926565874733
04502,04,502,1145,505,10,495,398,97,44.10480349344978,1.9801980198019802,98.01980198019803,78.81188118811882,19.207920792079207
04503,04,503,919,426,11,415,321,94,46.354733405875955,2.5821596244131455,97.41784037558685,75.35211267605634,22.065727699530516
04504,04,504,1310,512,5,507,394,113,39.083969465648856,0.9765625,99.0234375,76.953125,22.0703125
04505,04,505,1134,600,12,588,435,153,52.910052910052904,2.0,98.0,72.5,25.5
04506,04,506,1453,744,6,738,541,197,51.20440467997247,0.8064516129032258,99.19354838709677,72.71505376344086,26.478494623655912
04507,04,507,993,480,6,474,344,130,48.338368580060425,1.25,98.75,71.66666666666667,27.083333333333332
04508,04,508,1184,632,10,622,440,182,53.37837837837838,1.5822784810126582,98.41772151898735,69.62025316455697,28.79746835443038
04509,04,509,1378,727,19,708,474,234,52.75761973875181,2.613480055020633,97.38651994497937,65.19944979367263,32.18707015130674
04510,04,510,1475,786,22,764,538,226,53.288135593220346,2.7989821882951653,97.20101781170484,68.44783715012723,28.75318066157761
04511,04,511,1218,561,10,551,427,124,46.05911330049261,1.7825311942959003,98.2174688057041,76.11408199643493,22.103386809269164
04512,04,512,1083,539,18,521,394,127,49.769159741458914,3.339517625231911,96.66048237476808,73.09833024118738,23.562152133580703
04513,04,513,1444,644,12,632,438,194,44.59833795013851,1.8633540372670807,98.13664596273291,68.01242236024845,30.124223602484474
04514,04,514,1150,504,7,497,351,146,43.826086956521735,1.3888888888888888,98.61111111111111,69.64285714285714,28.968253968253972
04515,04,515,1183,552,8,544,381,163,46.66103127641589,1.4492753623188406,98.55072463768117,69.02173913043478,29.528985507246375
04516,04,516,956,485,8,477,328,149,50.73221757322176,1.6494845360824744,98.35051546391752,67.62886597938144,30.721649484536083
04517,04,517,1579,806,20,786,585,201,51.04496516782774,2.481389578163772,97.51861042183623,72.58064516129032,24.937965260545905
04518,04,518,1384,669,31,638,461,177,48.33815028901734,4.633781763826607,95.3662182361734,68.90881913303438,26.45739910313901
04519,04,519,1280,676,20,656,459,197,52.81249999999999,2.9585798816568047,97.0414201183432,67.89940828402366,29.142011834319526
04520,04,520,1350,716,19,697,505,192,53.03703703703704,2.653631284916201,97.3463687150838,70.53072625698324,26.81564245810056
04521,04,521,1005,465,9,456,346,110,46.26865671641791,1.935483870967742,98.06451612903226,74.40860215053763,23.655913978494624
04522,04,522,1276,551,5,546,442,104,43.18181818181818,0.9074410163339384,99.09255898366605,80.21778584392014,18.87477313974592
04523,04,523,1073,525,5,520,396,124,48.928238583411,0.9523809523809524,99.04761904761905,75.42857142857143,23.61904761904762
04524,04,524,1360,578,7,571,456,115,42.5,1.2110726643598615,98.78892733564014,78.89273356401384,19.896193771626297
04525,04,525,1128,491,12,479,366,113,43.52836879432624,2.4439918533604885,97.5560081466395,74.54175152749491,23.014256619144604
04601,04,601,1052,510,13,497,340,157,48.47908745247148,2.549019607843137,97.45098039215686,66.66666666666666,30.784313725490197
04602,04,602,1065,517,6,511,360,151,48.544600938967136,1.160541586073501,98.8394584139265,69.63249516441006,29.206963249516445
04603,04,603,1140,461,3,458,307,151,40.43859649122807,0.6507592190889371,99.34924078091106,66.5943600867679,32.75488069414317
04604,04,604,1085,473,10,463,315,148,43.594470046082954,2.1141649048625792,97.88583509513742,66.59619450317125,31.289640591966172
04605,04,605,1046,515,5,510,339,171,49.235181644359464,0.9708737864077669,99.02912621359224,65.8252427184466,33.20388349514563
04606,04,606,1281,667,29,638,434,204,52.068696330991415,4.3478260869565215,95.65217391304348,65.06746626686657,30.584707646176913
04607,04,607,1163,535,15,520,348,172,46.001719690455715,2.803738317757009,97.19626168224299,65.04672897196262,32.149532710280376
04608,04,608,1241,555,6,549,387,162,44.72199838839646,1.0810810810810811,98.91891891891892,69.72972972972973,29.18918918918919
04609,04,609,1173,571,8,563,387,176,48.67860187553282,1.4010507880910683,98.59894921190893,67.77583187390543,30.823117338003502
04610,04,610,1124,549,18,531,341,190,48.843416370106766,3.278688524590164,96.72131147540983,62.11293260473588,34.60837887067395
04611,04,611,1004,556,18,538,351,187,55.37848605577689,3.237410071942446,96.76258992805755,63.12949640287769,33.63309352517986
04612,04,612,1383,723,21,702,469,233,52.27765726681128,2.904564315352697,97.0954356846473,64.8686030428769,32.2268326417704
04613,04,613,1311,614,13,601,370,231,46.83447749809306,2.1172638436482085,97.8827361563518,60.26058631921825,37.62214983713355
04614,04,614,1135,603,13,590,372,218,53.12775330396475,2.155887230514096,97.8441127694859,61.69154228855721,36.152570480928695
04615,04,615,1131,603,5,598,410,188,53.315649867374006,0.8291873963515755,99.17081260364843,67.99336650082918,31.17744610281924
04616,04,616,1025,489,9,480,275,205,47.70731707317073,1.8404907975460123,98.15950920245399,56.23721881390593,41.922290388548056
04617,04,617,1320,679,6,673,444,229,51.43939393939394,0.8836524300441826,99.11634756995582,65.39027982326951,33.726067746686304
04618,04,618,1179,603,13,590,368,222,51.14503816793893,2.155887230514096,97.8441127694859,61.02819237147595,36.81592039800995
04619,04,619,1137,563,6,557,333,224,49.51627088830255,1.0657193605683837,98.93428063943162,59.14742451154529,39.786856127886324
04620,04,620,1519,653,16,637,413,224,42.98880842659645,2.4502297090352223,97.54977029096477,63.24655436447168,34.30321592649311
04621,04,621,1536,827,12,815,497,318,53.841145833333336,1.4510278113663846,98.54897218863361,60.09673518742442,38.45223700120919
04622,04,622,1545,773,16,757,476,281,50.03236245954693,2.069857697283312,97.93014230271669,61.57826649417852,36.35187580853817
04623,04,623,1088,571,14,557,344,213,52.48161764705882,2.4518388791593697,97.54816112084063,60.24518388791593,37.3029772329247
04624,04,624,1228,722,8,714,407,307,58.79478827361564,1.10803324099723,98.89196675900277,56.371191135734065,42.5207756232687
04625,04,625,1225,665,11,654,384,270,54.285714285714285,1.6541353383458646,98.34586466165413,57.74436090225564,40.6015037593985
04626,04,626,1388,749,15,734,480,254,53.96253602305475,2.0026702269692924,97.9973297730307,64.08544726301736,33.91188251001335
04701,04,701,1258,595,4,591,387,204,47.2972972972973,0.6722689075630253,99.32773109243698,65.04201680672269,34.285714285714285
04702,04,702,1139,540,7,533,387,146,47.410008779631255,1.2962962962962963,98.70370370370371,71.66666666666667,27.037037037037038
04703,04,703,1174,566,16,550,350,200,48.21124361158432,2.8268551236749118,97.1731448763251,61.83745583038869,35.3356890459364
04704,04,704,1420,703,9,694,489,205,49.50704225352113,1.2802275960170697,98.71977240398293,69.55903271692745,29.160739687055475
04705,04,705,1401,700,16,684,432,252,49.964311206281224,2.2857142857142856,97.71428571428571,61.71428571428571,36.0
04706,04,706,1596,915,13,902,535,367,57.330827067669176,1.4207650273224044,98.5792349726776,58.46994535519126,40.10928961748634
04707,04,707,1419,768,25,743,448,295,54.12262156448203,3.2552083333333335,96.74479166666666,58.333333333333336,38.41145833333333
04708,04,708,1348,735,22,713,481,232,54.525222551928785,2.9931972789115644,97.00680272108843,65.4421768707483,31.564625850340132
04709,04,709,1449,691,18,673,470,203,47.688060731539,2.6049204052098407,97.39507959479016,68.01736613603472,29.377713458755427
04710,04,710,1555,854,21,833,505,328,54.91961414790997,2.459016393442623,97.54098360655738,59.133489461358316,38.40749414519906
04711,04,711,1438,666,12,654,406,248,46.31432545201669,1.8018018018018018,98.1981981981982,60.96096096096096,37.23723723723724
04712,04,712,1432,740,12,728,449,279,51.675977653631286,1.6216216216216217,98.37837837837839,60.67567567567568,37.7027027027027
04713,04,713,1301,669,6,663,413,250,51.42198308993082,0.8968609865470852,99.10313901345292,61.733931240657704,37.369207772795214
04714,04,714,1388,741,10,731,476,255,53.38616714697406,1.349527665317139,98.65047233468286,64.23751686909581,34.41295546558704
04715,04,715,1652,802,6,796,532,264,48.54721549636804,0.7481296758104738,99.25187032418953,66.33416458852868,32.917705735660846
04716,04,716,1459,737,16,721,454,267,50.51405071967101,2.1709633649932156,97.82903663500679,61.601085481682496,36.22795115332429
04717,04,717,1505,822,14,808,428,380,54.61794019933555,1.70316301703163,98.29683698296837,52.06812652068127,46.228710462287104
04718,04,718,1424,716,14,702,499,203,50.28089887640449,1.9553072625698324,98.04469273743017,69.6927374301676,28.35195530726257
04719,04,719,1016,494,6,488,345,143,48.62204724409449,1.214574898785425,98.78542510121457,69.83805668016194,28.947368421052634
04720,04,720,1248,547,5,542,380,162,43.830128205128204,0.9140767824497258,99.08592321755027,69.46983546617916,29.61608775137112
04721,04,721,1247,708,13,695,452,243,56.776263031275064,1.8361581920903955,98.1638418079096,63.84180790960452,34.32203389830508
04722,04,722,919,452,13,439,307,132,49.183895538628946,2.8761061946902653,97.12389380530973,67.92035398230088,29.20353982300885
04723,04,723,1205,633,10,623,435,188,52.53112033195021,1.579778830963665,98.42022116903634,68.72037914691943,29.6998420221169
04724,04,724,1527,754,14,740,477,263,49.377865094957436,1.8567639257294428,98.14323607427056,63.26259946949602,34.88063660477454
04801,04,801,1352,617,10,607,386,221,45.63609467455622,1.6207455429497568,98.37925445705025,62.560777957860616,35.81847649918963
04802,04,802,1182,549,5,544,385,159,46.44670050761421,0.9107468123861567,99.08925318761385,70.12750455373407,28.96174863387978
04803,04,803,1169,601,21,580,415,165,51.41146278870829,3.494176372712146,96.50582362728785,69.05158069883528,27.454242928452576
04804,04,804,1607,790,13,777,509,268,49.159925326695706,1.6455696202531647,98.35443037974684,64.43037974683544,33.92405063291139
04805,04,805,1337,658,10,648,460,188,49.21465968586388,1.5197568389057752,98.48024316109422,69.90881458966565,28.57142857142857
04806,04,806,1312,560,7,553,351,202,42.68292682926829,1.25,98.75,62.67857142857143,36.07142857142857
05101,05,101,855,311,4,307,159,148,36.37426900584796,1.2861736334405145,98.71382636655949,51.12540192926045,47.58842443729904
05102,05,102,921,452,4,448,275,173,49.0770901194354,0.8849557522123894,99.11504424778761,60.84070796460177,38.27433628318584
05103,05,103,1085,608,19,589,218,371,56.036866359447004,3.125,96.875,35.85526315789473,61.01973684210527
05104,05,104,934,474,6,468,271,197,50.74946466809421,1.2658227848101267,98.73417721518987,57.17299578059072,41.561181434599156
05105,05,105,1067,611,4,607,191,416,57.263355201499536,0.6546644844517185,99.34533551554829,31.260229132569556,68.08510638297872
05106,05,106,1133,528,7,521,159,362,46.601941747572816,1.3257575757575757,98.67424242424242,30.113636363636363,68.56060606060606
05107,05,107,898,463,4,459,258,201,51.55902004454342,0.8639308855291578,99.13606911447084,55.72354211663067,43.412526997840175
05108,05,108,1148,509,5,504,287,217,44.33797909407666,0.9823182711198428,99.01768172888016,56.385068762278976,42.63261296660118
05109,05,109,746,294,13,281,90,191,39.41018766756032,4.421768707482993,95.578231292517,30.612244897959183,64.96598639455783
05110,05,110,922,466,2,464,217,247,50.542299349240785,0.4291845493562232,99.57081545064378,46.56652360515021,53.00429184549357
05111,05,111,1240,632,12,620,338,282,50.967741935483865,1.89873417721519,98.10126582278481,53.48101265822785,44.620253164556964
05112,05,112,1055,529,4,525,248,277,50.142180094786724,0.7561436672967864,99.24385633270322,46.880907372400756,52.36294896030246
05113,05,113,1051,559,7,552,186,366,53.18744053282588,1.2522361359570662,98.74776386404294,33.273703041144906,65.47406082289802
05114,05,114,913,468,7,461,207,254,51.259583789704266,1.4957264957264957,98.50427350427351,44.230769230769226,54.27350427350427
05115,05,115,1064,584,11,573,289,284,54.88721804511278,1.8835616438356164,98.11643835616438,49.486301369863014,48.63013698630137
05116,05,116,822,421,0,421,197,224,51.21654501216545,0.0,100.0,46.79334916864608,53.20665083135392
05117,05,117,979,496,2,494,286,208,50.663942798774265,0.4032258064516129,99.59677419354838,57.66129032258065,41.935483870967744
05118,05,118,1233,575,12,563,322,241,46.63422546634226,2.086956521739131,97.91304347826087,56.00000000000001,41.91304347826087
05119,05,119,1285,586,9,577,360,217,45.60311284046693,1.5358361774744027,98.46416382252559,61.43344709897611,37.03071672354949
05120,05,120,1199,664,13,651,368,283,55.37948290241869,1.957831325301205,98.04216867469879,55.42168674698795,42.62048192771085
05121,05,121,1087,623,5,618,359,259,57.31370745170194,0.8025682182985553,99.19743178170144,57.62439807383628,41.57303370786517
05122,05,122,993,428,1,427,250,177,43.101711983887206,0.23364485981308408,99.76635514018692,58.41121495327103,41.35514018691589
05123,05,123,860,430,2,428,212,216,50.0,0.46511627906976744,99.53488372093024,49.30232558139535,50.23255813953489
05124,05,124,1364,702,7,695,349,346,51.46627565982405,0.9971509971509971,99.002849002849,49.71509971509971,49.287749287749286
05125,05,125,1001,487,4,483,278,205,48.651348651348655,0.8213552361396305,99.17864476386036,57.08418891170432,42.09445585215606
05126,05,126,1180,515,5,510,302,208,43.64406779661017,0.9708737864077669,99.02912621359224,58.64077669902913,40.3883495145631
05127,05,127,957,496,10,486,298,188,51.828631138975965,2.0161290322580645,97.98387096774194,60.08064516129033,37.903225806451616
05128,05,128,905,318,12,306,166,140,35.13812154696133,3.7735849056603774,96.22641509433963,52.20125786163522,44.0251572327044
05129,05,129,1017,537,12,525,293,232,52.8023598820059,2.2346368715083798,97.76536312849163,54.56238361266295,43.20297951582867
05130,05,130,1064,533,7,526,284,242,50.09398496240601,1.3133208255159476,98.68667917448406,53.283302063789876,45.40337711069418
05131,05,131,1239,607,13,594,298,296,48.991121872477805,2.14168039538715,97.85831960461286,49.093904448105434,48.76441515650741
05132,05,132,1324,550,10,540,268,272,41.54078549848943,1.8181818181818181,98.18181818181819,48.72727272727273,49.45454545454545
05201,05,201,1327,692,4,688,382,306,52.14770158251696,0.5780346820809248,99.42196531791907,55.202312138728324,44.21965317919075
05202,05,202,1482,779,11,768,404,364,52.56410256410257,1.4120667522464698,98.58793324775354,51.861360718870344,46.72657252888318
05203,05,203,1245,584,7,577,360,217,46.907630522088354,1.1986301369863013,98.8013698630137,61.64383561643836,37.15753424657534
05204,05,204,958,445,5,440,298,142,46.45093945720251,1.1235955056179776,98.87640449438202,66.96629213483146,31.910112359550563
05205,05,205,1021,474,6,468,284,184,46.42507345739471,1.2658227848101267,98.73417721518987,59.91561181434599,38.81856540084388
05206,05,206,1371,648,4,644,396,248,47.26477024070022,0.6172839506172839,99.38271604938271,61.111111111111114,38.2716049382716
05207,05,207,1075,413,4,409,245,164,38.41860465116279,0.9685230024213075,99.0314769975787,59.32203389830508,39.70944309927361
05208,05,208,1134,546,13,533,290,243,48.148148148148145,2.380952380952381,97.61904761904762,53.11355311355312,44.505494505494504
05209,05,209,1052,482,2,480,215,265,45.81749049429658,0.4149377593360996,99.5850622406639,44.60580912863071,54.9792531120332
05210,05,210,1220,544,7,537,308,229,44.59016393442623,1.2867647058823528,98.71323529411765,56.61764705882353,42.095588235294116
05211,05,211,1543,837,13,824,434,390,54.2449773169151,1.5531660692951015,98.4468339307049,51.85185185185185,46.59498207885305
05212,05,212,909,478,9,469,298,171,52.58525852585259,1.882845188284519,98.11715481171548,62.34309623430963,35.77405857740586
05213,05,213,1033,603,0,603,218,385,58.37366892545982,0.0,100.0,36.152570480928695,63.847429519071305
05214,05,214,808,343,11,332,195,137,42.45049504950495,3.206997084548105,96.7930029154519,56.85131195335277,39.94169096209912
05215,05,215,1601,673,12,661,389,272,42.03622735790131,1.7830609212481425,98.21693907875185,57.80089153046062,40.41604754829123
05216,05,216,1588,752,14,738,407,331,47.3551637279597,1.8617021276595744,98.13829787234043,54.12234042553191,44.015957446808514
05217,05,217,881,458,10,448,291,157,51.98637911464245,2.1834061135371177,97.81659388646288,63.53711790393013,34.27947598253275
05218,05,218,1011,555,9,546,285,261,54.89614243323442,1.6216216216216217,98.37837837837839,51.35135135135135,47.02702702702703
05219,05,219,1250,659,3,656,355,301,52.72,0.4552352048558422,99.54476479514416,53.86949924127465,45.6752655538695
05220,05,220,1061,473,10,463,311,152,44.58058435438266,2.1141649048625792,97.88583509513742,65.75052854122622,32.1353065539112
05221,05,221,849,464,14,450,275,175,54.65253239104829,3.0172413793103448,96.98275862068965,59.26724137931034,37.71551724137931
05222,05,222,865,436,3,433,248,185,50.40462427745665,0.6880733944954129,99.31192660550458,56.88073394495413,42.43119266055046
05223,05,223,1125,566,6,560,342,218,50.3111111111111,1.0600706713780919,98.93992932862191,60.42402826855123,38.515901060070675
05224,05,224,958,415,5,410,247,163,43.31941544885177,1.2048192771084338,98.79518072289156,59.518072289156635,39.277108433734945
05225,05,225,999,491,8,483,233,250,49.14914914914915,1.6293279022403258,98.37067209775967,47.45417515274949,50.91649694501018
05226,05,226,906,530,4,526,393,133,58.498896247240616,0.7547169811320755,99.24528301886792,74.15094339622641,25.09433962264151
05227,05,227,1298,502,4,498,276,222,38.674884437596305,0.796812749003984,99.20318725099602,54.980079681274894,44.223107569721115
05301,05,301,1015,498,10,488,300,188,49.064039408866996,2.0080321285140563,97.99196787148594,60.24096385542169,37.75100401606426
05302,05,302,929,451,11,440,332,108,48.546824542518834,2.4390243902439024,97.5609756097561,73.61419068736141,23.946784922394677
05303,05,303,970,435,4,431,281,150,44.84536082474227,0.9195402298850575,99.08045977011494,64.59770114942529,34.48275862068966
05304,05,304,1556,822,11,811,175,636,52.82776349614395,1.338199513381995,98.661800486618,21.289537712895378,77.37226277372264
05305,05,305,1044,614,4,610,367,243,58.81226053639846,0.6514657980456027,99.3485342019544,59.77198697068404,39.57654723127036
05306,05,306,901,406,2,404,277,127,45.061043285238625,0.49261083743842365,99.50738916256158,68.22660098522168,31.2807881773399
05307,05,307,1345,631,12,619,352,267,46.91449814126394,1.9017432646592711,98.09825673534073,55.78446909667195,42.313787638668785
05308,05,308,1228,614,11,603,321,282,50.0,1.7915309446254073,98.2084690553746,52.28013029315961,45.928338762214985
05309,05,309,1364,654,2,652,421,231,47.94721407624634,0.3058103975535168,99.69418960244649,64.37308868501529,35.321100917431195
05310,05,310,1270,638,12,626,438,188,50.23622047244094,1.8808777429467085,98.11912225705329,68.65203761755487,29.46708463949843
05311,05,311,1201,621,5,616,417,199,51.70691090757702,0.8051529790660225,99.19484702093398,67.14975845410628,32.045088566827694
05312,05,312,970,480,9,471,323,148,49.48453608247423,1.875,98.125,67.29166666666667,30.833333333333336
05313,05,313,1390,662,6,656,434,222,47.62589928057554,0.906344410876133,99.09365558912387,65.55891238670695,33.53474320241692
05314,05,314,1225,633,5,628,412,216,51.6734693877551,0.7898894154818324,99.21011058451816,65.086887835703,34.12322274881517
05315,05,315,1128,636,6,630,302,328,56.38297872340425,0.9433962264150944,99.05660377358491,47.48427672955975,51.57232704402516
05316,05,316,1365,673,9,664,452,212,49.30402930402931,1.337295690936107,98.6627043090639,67.16196136701336,31.50074294205052
05317,05,317,1121,567,6,561,342,219,50.579839429081176,1.0582010582010581,98.94179894179894,60.317460317460316,38.62433862433862
05318,05,318,1225,648,14,634,453,181,52.89795918367347,2.1604938271604937,97.8395061728395,69.9074074074074,27.9320987654321
05319,05,319,670,351,14,337,252,85,52.38805970149254,3.9886039886039883,96.01139601139602,71.7948717948718,24.216524216524217
05320,05,320,1016,505,3,502,329,173,49.70472440944882,0.594059405940594,99.4059405940594,65.14851485148515,34.25742574257426
05321,05,321,1169,561,11,550,371,179,47.98973481608212,1.9607843137254901,98.0392156862745,66.1319073083779,31.907308377896616
05322,05,322,1161,588,15,573,392,181,50.64599483204134,2.5510204081632653,97.44897959183673,66.66666666666666,30.782312925170068
05323,05,323,909,416,3,413,256,157,45.76457645764577,0.7211538461538461,99.27884615384616,61.53846153846154,37.74038461538461
05324,05,324,887,479,3,476,326,150,54.002254791431795,0.6263048016701461,99.37369519832986,68.05845511482255,31.315240083507305
05325,05,325,1290,669,11,658,403,255,51.86046511627907,1.6442451420029895,98.35575485799701,60.239162929745895,38.11659192825112
05326,05,326,1096,470,11,459,313,146,42.88321167883212,2.3404255319148937,97.65957446808511,66.59574468085107,31.06382978723404
05327,05,327,1049,591,6,585,379,206,56.3393708293613,1.015228426395939,98.98477157360406,64.12859560067682,34.85617597292725
05328,05,328,1243,632,9,623,456,167,50.84473049074819,1.4240506329113924,98.57594936708861,72.15189873417721,26.424050632911396
05329,05,329,1020,472,6,466,342,124,46.27450980392157,1.2711864406779663,98.72881355932203,72.45762711864407,26.27118644067797
05401,05,401,1026,560,4,556,171,385,54.58089668615984,0.7142857142857143,99.28571428571429,30.53571428571429,68.75
05402,05,402,725,383,0,383,125,258,52.82758620689655,0.0,100.0,32.637075718015666,67.36292428198433
05403,05,403,958,540,5,535,142,393,56.36743215031316,0.9259259259259258,99.07407407407408,26.296296296296294,72.77777777777777
05404,05,404,1027,627,6,621,330,291,61.051606621226874,0.9569377990430622,99.04306220095694,52.63157894736842,46.411483253588514
05405,05,405,1083,600,5,595,242,353,55.4016620498615,0.8333333333333334,99.16666666666667,40.33333333333333,58.833333333333336
05406,05,406,1106,520,3,517,322,195,47.01627486437613,0.576923076923077,99.42307692307692,61.92307692307693,37.5
05407,05,407,968,508,3,505,265,240,52.47933884297521,0.5905511811023622,99.40944881889764,52.16535433070866,47.24409448818898
05408,05,408,952,421,14,407,279,128,44.22268907563025,3.32541567695962,96.67458432304038,66.270783847981,30.403800475059384
05409,05,409,1133,639,8,631,384,247,56.39894086496028,1.2519561815336464,98.74804381846636,60.093896713615024,38.654147104851326
05410,05,410,1442,682,7,675,342,333,47.295423023578365,1.0263929618768328,98.97360703812316,50.146627565982406,48.82697947214076
05411,05,411,1055,590,8,582,403,179,55.92417061611374,1.3559322033898304,98.64406779661017,68.30508474576271,30.338983050847457
05412,05,412,1399,717,10,707,479,228,51.25089349535382,1.394700139470014,98.60529986052998,66.80613668061368,31.799163179916317
05413,05,413,1528,765,20,745,422,323,50.06544502617801,2.6143790849673203,97.38562091503267,55.16339869281046,42.22222222222222
05414,05,414,860,443,5,438,312,126,51.51162790697674,1.1286681715575622,98.87133182844244,70.42889390519187,28.442437923250562
05415,05,415,1411,628,9,619,441,178,44.5074415308292,1.4331210191082804,98.56687898089172,70.22292993630573,28.343949044585987
05416,05,416,1247,596,4,592,137,455,47.79470729751403,0.6711409395973155,99.32885906040269,22.986577181208055,76.34228187919463
05417,05,417,1372,766,7,759,410,349,55.83090379008746,0.9138381201044387,99.08616187989556,53.52480417754569,45.561357702349866
05418,05,418,805,324,7,317,182,135,40.24844720496895,2.1604938271604937,97.8395061728395,56.17283950617284,41.66666666666667
05419,05,419,1096,618,8,610,161,449,56.38686131386861,1.2944983818770228,98.70550161812298,26.051779935275082,72.65372168284789
05420,05,420,1122,559,4,555,111,444,49.82174688057041,0.7155635062611807,99.28443649373881,19.856887298747765,79.42754919499106
05421,05,421,1300,601,10,591,427,164,46.23076923076923,1.6638935108153077,98.33610648918469,71.04825291181365,27.287853577371045
05422,05,422,1035,471,8,463,343,120,45.507246376811594,1.6985138004246285,98.30148619957538,72.82377919320594,25.477707006369428
05423,05,423,897,467,3,464,197,267,52.06243032329989,0.6423982869379015,99.3576017130621,42.184154175588866,57.17344753747323
05424,05,424,1387,685,16,669,311,358,49.387166546503245,2.335766423357664,97.66423357664233,45.4014598540146,52.26277372262774
05425,05,425,1420,799,8,791,416,375,56.267605633802816,1.0012515644555695,98.99874843554443,52.065081351689614,46.93366708385482
05426,05,426,1117,703,5,698,427,271,62.936436884512084,0.7112375533428165,99.28876244665719,60.73968705547653,38.54907539118065
05427,05,427,888,421,7,414,283,131,47.409909909909906,1.66270783847981,98.33729216152018,67.2209026128266,31.116389548693586
05428,05,428,1117,641,10,631,245,386,57.385854968666074,1.5600624024960998,98.4399375975039,38.22152886115445,60.218408736349446
05429,05,429,945,528,6,522,234,288,55.87301587301587,1.1363636363636365,98.86363636363636,44.31818181818182,54.54545454545454
05501,05,501,1130,545,17,528,359,169,48.23008849557522,3.1192660550458715,96.88073394495413,65.87155963302752,31.009174311926607
05502,05,502,1216,653,13,640,431,209,53.70065789473685,1.9908116385911179,98.00918836140889,66.00306278713629,32.00612557427259
05503,05,503,837,454,11,443,266,177,54.24133811230586,2.4229074889867843,97.57709251101322,58.590308370044056,38.986784140969164
05504,05,504,958,526,10,516,329,187,54.90605427974948,1.9011406844106464,98.09885931558935,62.547528517110266,35.551330798479086
05505,05,505,1127,452,16,436,275,161,40.10647737355812,3.5398230088495577,96.46017699115043,60.84070796460177,35.61946902654867
05506,05,506,1137,642,14,628,378,250,56.464379947229546,2.1806853582554515,97.81931464174455,58.87850467289719,38.940809968847354
05507,05,507,1007,576,8,568,368,200,57.19960278053625,1.3888888888888888,98.61111111111111,63.888888888888886,34.72222222222222
05508,05,508,941,508,10,498,328,170,53.985122210414445,1.968503937007874,98.03149606299213,64.56692913385827,33.46456692913386
05509,05,509,1142,596,10,586,402,184,52.1891418563923,1.6778523489932886,98.3221476510067,67.4496644295302,30.87248322147651
05510,05,510,985,585,4,581,408,173,59.390862944162436,0.6837606837606838,99.31623931623932,69.74358974358974,29.572649572649574
05511,05,511,948,505,10,495,332,163,53.270042194092824,1.9801980198019802,98.01980198019803,65.74257425742574,32.27722772277228
05512,05,512,923,494,13,481,314,167,53.52112676056338,2.631578947368421,97.36842105263158,63.56275303643725,33.80566801619433
05513,05,513,1421,924,9,915,620,295,65.02463054187191,0.974025974025974,99.02597402597402,67.09956709956711,31.926406926406926
05514,05,514,1140,479,13,466,346,120,42.01754385964912,2.7139874739039667,97.28601252609603,72.23382045929019,25.052192066805844
05515,05,515,1116,549,15,534,352,182,49.193548387096776,2.73224043715847,97.26775956284153,64.11657559198542,33.1511839708561
05516,05,516,1204,643,7,636,454,182,53.40531561461794,1.088646967340591,98.9113530326594,70.60653188180405,28.304821150855364
05517,05,517,1071,554,14,540,393,147,51.72735760971056,2.527075812274368,97.47292418772562,70.93862815884476,26.534296028880867
05518,05,518,927,508,6,502,345,157,54.80043149946062,1.1811023622047243,98.81889763779527,67.91338582677166,30.905511811023622
05519,05,519,1065,506,5,501,330,171,47.51173708920188,0.9881422924901186,99.01185770750988,65.21739130434783,33.794466403162055
05520,05,520,1252,580,17,563,412,151,46.325878594249204,2.9310344827586206,97.06896551724138,71.03448275862068,26.03448275862069
05521,05,521,1274,558,9,549,394,155,43.79905808477237,1.6129032258064515,98.38709677419355,70.60931899641577,27.77777777777778
05522,05,522,1023,537,7,530,333,197,52.49266862170088,1.303538175046555,98.69646182495345,62.01117318435754,36.6852886405959
05523,05,523,1508,921,11,910,632,278,61.07427055702917,1.1943539630836049,98.8056460369164,68.62106406080348,30.184581976112923
05524,05,524,1030,579,5,574,355,219,56.21359223300971,0.8635578583765112,99.13644214162349,61.3126079447323,37.82383419689119
05525,05,525,825,429,14,415,250,165,52.0,3.263403263403263,96.73659673659674,58.27505827505828,38.46153846153847
05526,05,526,1212,645,11,634,429,205,53.21782178217822,1.7054263565891472,98.29457364341086,66.51162790697674,31.782945736434108
05527,05,527,1513,555,27,528,375,153,36.68208856576338,4.864864864864865,95.13513513513514,67.56756756756756,27.56756756756757
05528,05,528,908,491,6,485,336,149,54.074889867841414,1.2219959266802443,98.77800407331976,68.43177189409369,30.346232179226067
05529,05,529,900,469,4,465,323,142,52.11111111111111,0.8528784648187633,99.14712153518124,68.86993603411514,30.2771855010661
05530,05,530,1057,561,12,549,372,177,53.074739829706715,2.13903743315508,97.86096256684492,66.31016042780749,31.550802139037433
06101,06,101,1857,867,13,854,536,318,46.68820678513732,1.4994232987312572,98.50057670126874,61.82237600922722,36.67820069204152
06102,06,102,1752,851,18,833,502,331,48.57305936073059,2.1151586368977675,97.88484136310224,58.989424206815514,38.89541715628672
06103,06,103,1800,934,18,916,582,334,51.888888888888886,1.9271948608137044,98.07280513918629,62.31263383297645,35.76017130620985
06104,06,104,1991,1045,26,1019,573,446,52.48618784530387,2.488038277511962,97.51196172248804,54.83253588516747,42.67942583732057
06105,06,105,1589,813,15,798,550,248,51.16425424795469,1.8450184501845017,98.1549815498155,67.65067650676507,30.50430504305043
06106,06,106,1675,771,10,761,449,312,46.02985074626866,1.297016861219196,98.70298313878081,58.2360570687419,40.46692607003891
06107,06,107,1848,992,21,971,616,355,53.67965367965368,2.1169354838709675,97.88306451612904,62.096774193548384,35.78629032258064
06108,06,108,1960,906,7,899,542,357,46.224489795918366,0.772626931567329,99.22737306843267,59.82339955849889,39.40397350993378
06109,06,109,1943,940,19,921,531,390,48.37879567678847,2.021276595744681,97.97872340425532,56.48936170212766,41.48936170212766
06110,06,110,1808,873,26,847,545,302,48.2853982300885,2.978235967926689,97.0217640320733,62.42840778923253,34.59335624284078
06111,06,111,1888,939,23,916,598,318,49.73516949152542,2.4494142705005326,97.55058572949947,63.684771033013845,33.86581469648562
06112,06,112,1619,858,21,837,508,329,52.99567634342186,2.4475524475524475,97.55244755244755,59.20745920745921,38.344988344988344
06113,06,113,1825,798,11,787,516,271,43.726027397260275,1.3784461152882206,98.62155388471177,64.66165413533834,33.959899749373434
06114,06,114,1835,867,19,848,545,303,47.247956403269754,2.1914648212226067,97.80853517877739,62.86043829296425,34.94809688581315
06115,06,115,1536,766,18,748,458,290,49.86979166666667,2.3498694516971277,97.65013054830287,59.7911227154047,37.85900783289817
06116,06,116,1969,964,13,951,551,400,48.9588623666836,1.3485477178423237,98.65145228215768,57.15767634854772,41.49377593360996
06117,06,117,1723,803,13,790,526,264,46.60475914103308,1.61892901618929,98.38107098381072,65.50435865504357,32.87671232876712
06118,06,118,1765,840,21,819,512,307,47.59206798866856,2.5,97.5,60.952380952380956,36.547619047619044
06201,06,201,1906,1027,32,995,581,414,53.88247639034628,3.11587147030185,96.88412852969816,56.572541382667964,40.31158714703019
06202,06,202,1712,876,19,857,541,316,51.16822429906542,2.1689497716894977,97.8310502283105,61.757990867579906,36.07305936073059
06203,06,203,1919,928,25,903,577,326,48.35852006253257,2.693965517241379,97.30603448275862,62.17672413793104,35.12931034482759
06204,06,204,1663,890,18,872,524,348,53.51773902585688,2.0224719101123596,97.97752808988764,58.876404494382015,39.10112359550561
06205,06,205,1704,755,18,737,459,278,44.3075117370892,2.384105960264901,97.6158940397351,60.79470198675496,36.82119205298014
06206,06,206,1612,698,13,685,451,234,43.30024813895781,1.8624641833810889,98.13753581661892,64.61318051575931,33.5243553008596
06207,06,207,1535,738,12,726,424,302,48.078175895765476,1.6260162601626018,98.3739837398374,57.45257452574526,40.921409214092144
06208,06,208,1557,808,11,797,562,235,51.8946692357097,1.3613861386138615,98.63861386138613,69.55445544554455,29.084158415841582
06209,06,209,1867,821,14,807,528,279,43.974290305302624,1.705237515225335,98.29476248477467,64.31181485992693,33.982947624847746
06210,06,210,1716,764,18,746,459,287,44.52214452214452,2.356020942408377,97.64397905759162,60.07853403141361,37.56544502617801
06211,06,211,1687,731,13,718,464,254,43.33135743924126,1.7783857729138166,98.22161422708618,63.47469220246238,34.74692202462381
06212,06,212,1881,837,18,819,546,273,44.49760765550239,2.1505376344086025,97.84946236559139,65.23297491039428,32.61648745519714
06213,06,213,2074,1031,27,1004,633,371,49.71070395371263,2.6188166828322017,97.3811833171678,61.396702230843836,35.98448108632395
06214,06,214,1940,1008,20,988,606,382,51.958762886597945,1.984126984126984,98.01587301587301,60.11904761904761,37.89682539682539
06215,06,215,1718,904,17,887,586,301,52.61932479627474,1.8805309734513276,98.11946902654867,64.82300884955751,33.29646017699115
06216,06,216,1639,819,17,802,508,294,49.96949359365467,2.0757020757020754,97.92429792429792,62.02686202686203,35.8974358974359
06217,06,217,1944,1077,16,1061,674,387,55.401234567901234,1.4856081708449396,98.51439182915506,62.58124419684308,35.93314763231198
06218,06,218,1634,658,10,648,447,201,40.26927784577723,1.5197568389057752,98.48024316109422,67.93313069908815,30.547112462006076
06301,06,301,1886,939,17,922,548,374,49.787910922587486,1.810436634717785,98.18956336528221,58.359957401490945,39.829605963791266
06302,06,302,1748,828,18,810,481,329,47.368421052631575,2.1739130434782608,97.82608695652173,58.091787439613526,39.73429951690821
06303,06,303,1829,968,15,953,609,344,52.92509568069984,1.5495867768595042,98.4504132231405,62.913223140495866,35.53719008264463
06304,06,304,1841,957,17,940,552,388,51.98261814231396,1.7763845350052248,98.22361546499478,57.68025078369906,40.54336468129572
06305,06,305,1616,810,16,794,462,332,50.12376237623762,1.9753086419753085,98.0246913580247,57.03703703703704,40.98765432098765
06306,06,306,1973,889,15,874,555,319,45.05828687278257,1.687289088863892,98.31271091113611,62.429696287964006,35.8830146231721
06307,06,307,1729,762,19,743,482,261,44.07171775592828,2.493438320209974,97.50656167979002,63.25459317585301,34.25196850393701
06308,06,308,1743,864,16,848,557,291,49.5697074010327,1.8518518518518516,98.14814814814815,64.4675925925926,33.68055555555556
06309,06,309,1828,865,22,843,532,311,47.31947483588622,2.5433526011560694,97.45664739884393,61.50289017341041,35.95375722543353
06310,06,310,1768,914,9,905,543,362,51.696832579185525,0.9846827133479212,99.01531728665208,59.40919037199125,39.606126914660834
06311,06,311,1749,887,10,877,582,295,50.71469411092052,1.1273957158962795,98.87260428410372,65.61443066516347,33.25817361894025
06312,06,312,1810,917,19,898,578,320,50.66298342541437,2.0719738276990185,97.92802617230099,63.031624863685934,34.89640130861505
06313,06,313,1788,879,17,862,581,281,49.16107382550335,1.9340159271899888,98.06598407281001,66.09783845278726,31.968145620022753
06314,06,314,2729,1424,18,1406,966,440,52.18028581898131,1.2640449438202246,98.73595505617978,67.83707865168539,30.89887640449438
06315,06,315,1658,795,16,779,539,240,47.94933655006031,2.0125786163522013,97.9874213836478,67.79874213836477,30.18867924528302
06316,06,316,1935,972,23,949,647,302,50.23255813953489,2.366255144032922,97.63374485596708,66.56378600823045,31.069958847736622
06317,06,317,1936,858,17,841,600,241,44.31818181818182,1.9813519813519813,98.01864801864801,69.93006993006993,28.088578088578085
06318,06,318,2032,898,34,864,609,255,44.19291338582677,3.78619153674833,96.21380846325167,67.81737193763921,28.396436525612472
06401,06,401,1895,994,23,971,649,322,52.45382585751979,2.3138832997987926,97.68611670020121,65.29175050301811,32.3943661971831
06402,06,402,1661,801,20,781,538,243,48.22396146899458,2.4968789013732833,97.50312109862672,67.16604244694132,30.337078651685395
06403,06,403,1628,729,16,713,468,245,44.778869778869776,2.194787379972565,97.80521262002743,64.19753086419753,33.6076817558299
06404,06,404,1982,1029,16,1013,664,349,51.91725529767911,1.5549076773566568,98.44509232264335,64.52866861030127,33.91642371234208
06405,06,405,1780,940,17,923,599,324,52.80898876404494,1.8085106382978722,98.19148936170212,63.72340425531915,34.46808510638298
06406,06,406,1938,941,34,907,598,309,48.55521155830753,3.6131774707757707,96.38682252922422,63.54941551540914,32.83740701381509
06407,06,407,1946,926,20,906,614,292,47.58478931140802,2.159827213822894,97.8401727861771,66.30669546436285,31.533477321814257
06408,06,408,1814,864,19,845,546,299,47.62954796030871,2.199074074074074,97.80092592592592,63.19444444444444,34.60648148148148
06409,06,409,1776,834,16,818,593,225,46.95945945945946,1.9184652278177456,98.08153477218225,71.1031175059952,26.978417266187048
06410,06,410,1638,864,23,841,583,258,52.74725274725275,2.662037037037037,97.33796296296296,67.47685185185185,29.86111111111111
06411,06,411,1695,877,11,866,612,254,51.740412979351035,1.2542759407069555,98.74572405929305,69.78335233751424,28.96237172177879
06412,06,412,1473,805,16,789,562,227,54.650373387644265,1.9875776397515528,98.01242236024845,69.8136645962733,28.19875776397516
06413,06,413,1749,787,21,766,528,238,44.99714122355632,2.6683608640406606,97.33163913595934,67.09021601016518,30.241423125794153
06414,06,414,1596,720,26,694,507,187,45.11278195488722,3.6111111111111107,96.38888888888889,70.41666666666667,25.972222222222225
06415,06,415,1578,727,14,713,493,220,46.07097591888466,1.925722145804677,98.07427785419533,67.81292984869326,30.261348005502064
06416,06,416,1773,777,9,768,517,251,43.824027072758035,1.1583011583011582,98.84169884169884,66.53796653796654,32.3037323037323
06417,06,417,1676,859,18,841,584,257,51.252983293556085,2.0954598370197903,97.90454016298021,67.98603026775321,29.918509895227007
06501,06,501,1779,788,18,770,501,269,44.29454749859472,2.284263959390863,97.71573604060913,63.57868020304569,34.13705583756345
06502,06,502,1639,860,25,835,581,254,52.47101891397193,2.9069767441860463,97.09302325581395,67.55813953488372,29.53488372093023
06503,06,503,1385,663,9,654,418,236,47.87003610108303,1.3574660633484164,98.64253393665159,63.04675716440422,35.59577677224736
06504,06,504,1489,755,23,732,499,233,50.70517125587642,3.0463576158940397,96.95364238410596,66.09271523178808,30.86092715231788
06505,06,505,1838,953,25,928,580,348,51.849836779107726,2.6232948583420774,97.37670514165792,60.8604407135362,36.51626442812172
06506,06,506,1676,725,12,713,501,212,43.25775656324583,1.6551724137931034,98.34482758620689,69.10344827586206,29.24137931034483
06507,06,507,1686,863,17,846,602,244,51.18623962040332,1.9698725376593278,98.03012746234067,69.7566628041715,28.27346465816918
06508,06,508,1839,867,23,844,617,227,47.14518760195758,2.6528258362168398,97.34717416378315,71.16493656286043,26.18223760092272
06509,06,509,1733,849,20,829,632,197,48.99019042123485,2.3557126030624262,97.64428739693759,74.44051825677266,23.2037691401649
06510,06,510,1946,1071,24,1047,733,314,55.03597122302158,2.2408963585434174,97.75910364145658,68.4407096171802,29.31839402427638
06511,06,511,1561,726,11,715,468,247,46.508648302370275,1.5151515151515151,98.48484848484848,64.46280991735537,34.02203856749311
06512,06,512,1518,715,17,698,463,235,47.10144927536232,2.3776223776223775,97.62237762237763,64.75524475524476,32.86713286713287
06513,06,513,1998,1018,8,1010,746,264,50.95095095095095,0.7858546168958742,99.21414538310412,73.28094302554028,25.93320235756385
06514,06,514,1834,966,17,949,625,324,52.67175572519084,1.7598343685300208,98.24016563146998,64.69979296066253,33.54037267080746
06515,06,515,1580,816,12,804,512,292,51.64556962025316,1.4705882352941175,98.52941176470588,62.745098039215684,35.78431372549019
06516,06,516,1778,769,19,750,535,215,43.25084364454443,2.4707412223667102,97.52925877763329,69.57087126137841,27.95838751625488
06517,06,517,1694,661,10,651,472,179,39.02007083825266,1.5128593040847202,98.48714069591527,71.40695915279879,27.08018154311649
06518,06,518,1686,768,20,748,543,205,45.55160142348754,2.604166666666667,97.39583333333334,70.703125,26.692708333333332
06601,06,601,1335,635,8,627,373,254,47.565543071161045,1.2598425196850394,98.74015748031496,58.740157480314956,40.0
06602,06,602,1530,800,9,791,521,270,52.28758169934641,1.125,98.875,65.125,33.75
06603,06,603,1506,741,16,725,457,268,49.20318725099602,2.1592442645074224,97.84075573549258,61.67341430499326,36.16734143049933
06604,06,604,1822,901,13,888,465,423,49.451152579582875,1.4428412874583796,98.55715871254162,51.6093229744728,46.94783573806881
06605,06,605,1664,922,8,914,608,306,55.40865384615385,0.8676789587852495,99.13232104121475,65.94360086767897,33.18872017353579
06606,06,606,1231,538,3,535,411,124,43.70430544272949,0.5576208178438662,99.44237918215613,76.39405204460967,23.04832713754647
06607,06,607,1475,669,4,665,451,214,45.355932203389834,0.5979073243647235,99.40209267563527,67.41405082212258,31.988041853512705
06608,06,608,2022,1037,19,1018,714,304,51.28585558852621,1.832208293153327,98.16779170684667,68.85245901639344,29.315332690453232
06609,06,609,1755,889,18,871,522,349,50.655270655270655,2.0247469066366706,97.97525309336334,58.71766029246345,39.257592800899886
06610,06,610,1155,539,7,532,392,140,46.666666666666664,1.2987012987012987,98.7012987012987,72.72727272727273,25.97402597402597
06611,06,611,1530,761,15,746,478,268,49.73856209150327,1.971090670170828,98.02890932982918,62.81208935611038,35.21681997371879
06612,06,612,1840,906,16,890,577,313,49.23913043478261,1.7660044150110374,98.23399558498896,63.686534216335545,34.54746136865342
06613,06,613,1751,832,14,818,453,365,47.51570531125072,1.6826923076923077,98.3173076923077,54.44711538461539,43.87019230769231
06614,06,614,1916,902,22,880,553,327,47.07724425887265,2.4390243902439024,97.5609756097561,61.30820399113082,36.25277161862528
06615,06,615,1746,783,16,767,523,244,44.84536082474227,2.0434227330779056,97.9565772669221,66.79438058748404,31.162196679438058
06616,06,616,1962,1052,23,1029,687,342,53.61875637104995,2.1863117870722433,97.81368821292776,65.30418250950571,32.50950570342205
06617,06,617,1775,978,22,956,677,279,55.098591549295776,2.2494887525562373,97.75051124744377,69.22290388548056,28.52760736196319
06618,06,618,1749,818,16,802,509,293,46.76958261863922,1.9559902200488997,98.0440097799511,62.224938875305625,35.81907090464548
06619,06,619,1459,754,39,715,449,266,51.67923235092529,5.172413793103448,94.82758620689656,59.54907161803713,35.278514588859416
06701,06,701,1638,863,14,849,577,272,52.68620268620269,1.6222479721900347,98.37775202780996,66.85979142526072,31.517960602549245
06702,06,702,1992,993,12,981,671,310,49.84939759036144,1.2084592145015105,98.79154078549848,67.5730110775428,31.21852970795569
06703,06,703,1422,666,4,662,449,213,46.835443037974684,0.6006006006006006,99.3993993993994,67.41741741741741,31.98198198198198
06704,06,704,1447,684,16,668,473,195,47.27021423635107,2.3391812865497075,97.6608187134503,69.15204678362574,28.50877192982456
06705,06,705,1442,592,4,588,393,195,41.05409153952843,0.6756756756756757,99.32432432432432,66.38513513513513,32.939189189189186
06706,06,706,1819,931,15,916,617,299,51.18196811434854,1.611170784103115,98.38882921589689,66.27282491944146,32.11600429645542
06707,06,707,1753,793,6,787,540,247,45.236737022247574,0.7566204287515763,99.24337957124843,68.09583858764186,31.147540983606557
06708,06,708,1331,661,18,643,415,228,49.66190833959429,2.723146747352496,97.2768532526475,62.78366111951589,34.493192133131615
06709,06,709,1752,843,17,826,578,248,48.11643835616438,2.0166073546856467,97.98339264531435,68.56465005931199,29.418742586002374
06710,06,710,1728,820,23,797,568,229,47.4537037037037,2.804878048780488,97.1951219512195,69.26829268292683,27.926829268292686
06711,06,711,1714,861,16,845,538,307,50.23337222870479,1.8583042973286876,98.14169570267131,62.48548199767712,35.656213704994194
06712,06,712,1611,911,13,898,547,351,56.54872749844817,1.4270032930845227,98.57299670691548,60.043907793633366,38.52908891328211
06713,06,713,1586,773,12,761,520,241,48.738965952080704,1.5523932729624839,98.44760672703752,67.27037516170763,31.177231565329883
06714,06,714,1306,602,8,594,382,212,46.094946401225116,1.3289036544850499,98.67109634551495,63.45514950166113,35.21594684385382
06715,06,715,1480,708,10,698,464,234,47.83783783783784,1.4124293785310735,98.58757062146893,65.5367231638418,33.05084745762712
06716,06,716,1360,620,5,615,416,199,45.588235294117645,0.8064516129032258,99.19354838709677,67.0967741935484,32.09677419354839
06717,06,717,1166,613,15,598,397,201,52.5728987993139,2.4469820554649266,97.55301794453507,64.76345840130506,32.78955954323002
06718,06,718,1842,948,23,925,645,280,51.465798045602604,2.4261603375527425,97.57383966244726,68.0379746835443,29.535864978902953
06719,06,719,1686,832,23,809,502,307,49.34756820877818,2.7644230769230766,97.23557692307693,60.33653846153846,36.89903846153847
07101,07,101,1816,728,19,709,546,163,40.08810572687225,2.60989010989011,97.39010989010988,75.0,22.39010989010989
07102,07,102,1988,868,13,855,583,272,43.66197183098591,1.497695852534562,98.50230414746544,67.16589861751152,31.336405529953915
07103,07,103,1891,912,23,889,568,321,48.228450555261766,2.5219298245614032,97.47807017543859,62.28070175438597,35.19736842105263
07104,07,104,1849,887,31,856,489,367,47.97187669010276,3.494926719278467,96.50507328072153,55.12965050732808,41.37542277339346
07105,07,105,1914,852,14,838,554,284,44.5141065830721,1.643192488262911,98.35680751173709,65.02347417840375,33.33333333333333
07106,07,106,1713,820,16,804,485,319,47.869235259778165,1.951219512195122,98.04878048780488,59.14634146341463,38.90243902439025
07107,07,107,1697,818,19,799,418,381,48.202710665880964,2.3227383863080684,97.67726161369194,51.1002444987775,46.577017114914426
07108,07,108,1816,859,12,847,507,340,47.301762114537446,1.3969732246798603,98.60302677532013,59.022118742724096,39.58090803259604
07109,07,109,1893,876,18,858,500,358,46.275752773375594,2.054794520547945,97.94520547945206,57.077625570776256,40.8675799086758
07110,07,110,2051,1048,19,1029,657,372,51.097025841053146,1.8129770992366412,98.18702290076335,62.69083969465649,35.49618320610687
07111,07,111,1771,931,31,900,525,375,52.569169960474305,3.329752953813104,96.6702470461869,56.390977443609025,40.27926960257787
07112,07,112,2061,1057,30,1027,513,514,51.28578360019408,2.838221381267739,97.16177861873227,48.533585619678334,48.62819299905393
07113,07,113,1955,1009,17,992,532,460,51.61125319693095,1.6848364717542121,98.31516352824579,52.72547076313181,45.58969276511397
07114,07,114,1792,896,23,873,460,413,50.0,2.5669642857142856,97.43303571428571,51.33928571428571,46.09375
07115,07,115,1738,826,24,802,370,432,47.5258918296893,2.9055690072639226,97.09443099273608,44.794188861985475,52.300242130750604
07116,07,116,1976,881,13,868,546,322,44.58502024291498,1.4755959137343928,98.5244040862656,61.9750283768445,36.54937570942111
07117,07,117,1935,931,28,903,539,364,48.11369509043928,3.007518796992481,96.99248120300751,57.89473684210527,39.097744360902254
07118,07,118,1942,951,27,924,450,474,48.97013388259526,2.8391167192429023,97.16088328075709,47.3186119873817,49.8422712933754
07201,07,201,1899,983,18,965,539,426,51.764086361242754,1.8311291963377416,98.16887080366226,54.83214649033571,43.33672431332655
07202,07,202,1950,953,26,927,544,383,48.87179487179487,2.728226652675761,97.27177334732424,57.08289611752361,40.18887722980063
07203,07,203,2016,1087,23,1064,537,527,53.91865079365079,2.1159153633854646,97.88408463661453,49.40202391904324,48.482060717571294
07204,07,204,2004,879,19,860,437,423,43.862275449101794,2.1615472127417523,97.83845278725825,49.71558589306029,48.122866894197955
07205,07,205,1782,919,17,902,448,454,51.57126823793491,1.8498367791077257,98.15016322089227,48.74863982589772,49.40152339499456
07206,07,206,2217,1041,18,1023,524,499,46.9553450608931,1.729106628242075,98.27089337175792,50.33621517771374,47.93467819404419
07207,07,207,2263,1114,25,1089,506,583,49.22669023420239,2.244165170556553,97.75583482944344,45.421903052064636,52.333931777378815
07208,07,208,1934,892,10,882,513,369,46.12202688728025,1.1210762331838564,98.87892376681614,57.51121076233184,41.3677130044843
07209,07,209,1751,819,12,807,499,308,46.77327241576242,1.465201465201465,98.53479853479854,60.927960927960925,37.60683760683761
07210,07,210,2052,1089,30,1059,531,528,53.07017543859649,2.7548209366391188,97.2451790633609,48.760330578512395,48.484848484848484
07211,07,211,1999,948,37,911,475,436,47.42371185592796,3.9029535864978904,96.09704641350211,50.105485232067515,45.9915611814346
07212,07,212,1423,779,18,761,296,465,54.74349964862966,2.3106546854942236,97.68934531450579,37.997432605905004,59.69191270860077
07213,07,213,1675,818,20,798,338,460,48.83582089552239,2.444987775061125,97.55501222493888,41.32029339853301,56.234718826405874
07214,07,214,1775,834,19,815,371,444,46.985915492957744,2.278177458033573,97.72182254196643,44.48441247002398,53.23741007194245
07215,07,215,2040,932,30,902,510,392,45.68627450980392,3.2188841201716736,96.78111587982833,54.72103004291845,42.06008583690987
07216,07,216,2048,953,16,937,608,329,46.533203125,1.6789087093389297,98.32109129066107,63.798530954879325,34.52256033578174
07217,07,217,1577,717,21,696,452,244,45.466074825618264,2.928870292887029,97.07112970711297,63.04044630404463,34.03068340306834
07301,07,301,1998,943,13,930,493,437,47.1971971971972,1.378579003181336,98.62142099681867,52.27995758218452,46.34146341463415
07302,07,302,1824,1041,16,1025,532,493,57.07236842105263,1.536983669548511,98.4630163304515,51.10470701248799,47.358309317963496
07303,07,303,1688,851,16,835,425,410,50.41469194312796,1.8801410105757932,98.1198589894242,49.94124559341951,48.1786133960047
07304,07,304,1464,720,10,710,385,325,49.18032786885246,1.3888888888888888,98.61111111111111,53.47222222222222,45.13888888888889
07305,07,305,1857,900,13,887,431,456,48.46526655896607,1.4444444444444444,98.55555555555556,47.888888888888886,50.66666666666667
07306,07,306,1761,941,13,928,487,441,53.43554798409994,1.381509032943677,98.61849096705633,51.75345377258236,46.86503719447396
07307,07,307,1945,907,12,895,448,447,46.63239074550128,1.3230429988974641,98.67695700110254,49.39360529217199,49.28335170893054
07308,07,308,1726,865,18,847,405,442,50.11587485515643,2.0809248554913293,97.91907514450867,46.82080924855491,51.09826589595375
07309,07,309,1680,957,25,932,484,448,56.96428571428571,2.612330198537095,97.3876698014629,50.57471264367817,46.812957157784744
07310,07,310,1868,890,16,874,448,426,47.644539614561026,1.7977528089887642,98.20224719101124,50.337078651685395,47.86516853932584
07311,07,311,1686,910,26,884,450,434,53.97390272835113,2.857142857142857,97.14285714285714,49.45054945054945,47.69230769230769
07312,07,312,1441,788,20,768,389,379,54.684247050659266,2.5380710659898478,97.46192893401016,49.36548223350254,48.09644670050762
07313,07,313,1833,935,12,923,503,420,51.00927441352974,1.2834224598930482,98.71657754010695,53.79679144385027,44.919786096256686
07314,07,314,1698,922,21,901,500,401,54.29917550058892,2.27765726681128,97.72234273318871,54.229934924078094,43.49240780911063
07315,07,315,1936,991,18,973,489,484,51.188016528925615,1.8163471241170535,98.18365287588294,49.344096871846624,48.839556004036325
07316,07,316,1956,940,19,921,571,350,48.057259713701434,2.021276595744681,97.97872340425532,60.744680851063826,37.234042553191486
07317,07,317,1846,882,23,859,517,342,47.77898158179848,2.6077097505668934,97.39229024943312,58.61678004535147,38.775510204081634
07318,07,318,1798,890,17,873,546,327,49.49944382647386,1.9101123595505618,98.08988764044943,61.348314606741575,36.741573033707866
07319,07,319,2087,864,14,850,571,279,41.39913751796838,1.6203703703703702,98.37962962962963,66.08796296296296,32.29166666666667
07401,07,401,1764,911,20,891,480,411,51.64399092970522,2.1953896816684964,97.80461031833151,52.689352360043905,45.1152579582876
07402,07,402,1874,912,23,889,389,500,48.66595517609392,2.5219298245614032,97.47807017543859,42.65350877192983,54.824561403508774
07403,07,403,1995,1071,33,1038,665,373,53.68421052631579,3.081232492997199,96.9187675070028,62.091503267973856,34.82726423902894
07404,07,404,1764,922,16,906,400,506,52.26757369614512,1.735357917570499,98.2646420824295,43.38394793926248,54.880694143167034
07405,07,405,1924,827,14,813,513,300,42.983367983367984,1.6928657799274487,98.30713422007256,62.031438935912945,36.27569528415962
07406,07,406,1979,994,10,984,631,353,50.22738756947953,1.0060362173038229,98.99396378269618,63.480885311871226,35.51307847082495
07407,07,407,1804,837,20,817,560,257,46.39689578713969,2.3894862604540026,97.61051373954601,66.90561529271206,30.70489844683393
07408,07,408,1918,962,24,938,508,430,50.156412930135566,2.494802494802495,97.5051975051975,52.80665280665281,44.6985446985447
07409,07,409,1922,837,18,819,490,329,43.54838709677419,2.1505376344086025,97.84946236559139,58.54241338112306,39.30704898446834
07410,07,410,2189,969,15,954,613,341,44.26678848789402,1.5479876160990713,98.45201238390094,63.261093911248715,35.190918472652214
07411,07,411,2056,913,25,888,551,337,44.40661478599222,2.7382256297918945,97.26177437020812,60.35049288061336,36.91128148959474
07412,07,412,1864,958,20,938,544,394,51.39484978540773,2.0876826722338206,97.91231732776617,56.78496868475992,41.127348643006265
07413,07,413,2000,990,14,976,563,413,49.5,1.4141414141414141,98.58585858585859,56.868686868686865,41.717171717171716
07414,07,414,2123,840,13,827,554,273,39.5666509656147,1.5476190476190477,98.45238095238096,65.95238095238095,32.5
07415,07,415,1887,932,23,909,538,371,49.39056703762586,2.467811158798283,97.53218884120172,57.72532188841202,39.8068669527897
07416,07,416,2310,1051,27,1024,640,384,45.497835497835496,2.5689819219790673,97.43101807802094,60.89438629876308,36.53663177925785
07417,07,417,1691,894,24,870,510,360,52.86812536960378,2.684563758389262,97.31543624161074,57.04697986577181,40.26845637583892
07501,07,501,2320,1084,22,1062,738,324,46.724137931034484,2.029520295202952,97.97047970479706,68.08118081180811,29.88929889298893
07502,07,502,1937,895,23,872,626,246,46.205472379969024,2.569832402234637,97.43016759776536,69.9441340782123,27.48603351955307
07503,07,503,1857,936,15,921,627,294,50.40387722132472,1.6025641025641024,98.3974358974359,66.98717948717949,31.41025641025641
07504,07,504,2195,973,37,936,601,335,44.32801822323462,3.802672147995889,96.19732785200411,61.76772867420349,34.42959917780062
07505,07,505,1971,998,15,983,668,315,50.634195839675286,1.503006012024048,98.49699398797596,66.93386773547094,31.563126252505008
07506,07,506,2096,1061,23,1038,702,336,50.62022900763359,2.167766258246937,97.83223374175306,66.16399622997172,31.66823751178134
07507,07,507,2131,860,23,837,591,246,40.356640075082126,2.6744186046511627,97.32558139534883,68.72093023255815,28.604651162790695
07508,07,508,1908,943,13,930,632,298,49.42348008385744,1.378579003181336,98.62142099681867,67.02014846235419,31.601272534464474
07509,07,509,1987,952,12,940,675,265,47.91142425767489,1.2605042016806722,98.73949579831933,70.90336134453781,27.836134453781515
07510,07,510,1746,754,13,741,537,204,43.184421534937,1.7241379310344827,98.27586206896551,71.22015915119363,27.055702917771885
07511,07,511,1830,867,20,847,594,253,47.377049180327866,2.306805074971165,97.69319492502883,68.5121107266436,29.18108419838524
07512,07,512,1657,820,21,799,587,212,49.48702474351237,2.5609756097560976,97.4390243902439,71.58536585365853,25.853658536585368
07513,07,513,1928,798,21,777,553,224,41.39004149377593,2.631578947368421,97.36842105263158,69.2982456140351,28.07017543859649
07514,07,514,2155,1012,32,980,660,320,46.96055684454756,3.1620553359683794,96.83794466403161,65.21739130434783,31.620553359683797
07515,07,515,1952,893,9,884,646,238,45.74795081967213,1.007838745800672,98.99216125419933,72.3404255319149,26.651735722284435
07516,07,516,2116,1106,26,1080,755,325,52.268431001890356,2.3508137432188065,97.64918625678119,68.26401446654612,29.38517179023508
07517,07,517,2013,1010,14,996,676,320,50.173869846001,1.3861386138613863,98.61386138613861,66.93069306930694,31.683168316831683
07601,07,601,1928,922,31,891,588,303,47.82157676348548,3.3622559652928414,96.63774403470717,63.77440347071583,32.86334056399132
07602,07,602,2228,1199,39,1160,799,361,53.81508078994614,3.252710592160134,96.74728940783986,66.63886572143453,30.108423686405338
07603,07,603,2110,1078,17,1061,711,350,51.09004739336493,1.5769944341372915,98.42300556586271,65.95547309833024,32.467532467532465
07604,07,604,2127,951,13,938,655,283,44.71086036671368,1.3669821240799158,98.63301787592007,68.87486855941115,29.758149316508938
07605,07,605,2020,951,19,932,680,252,47.07920792079208,1.9978969505783386,98.00210304942166,71.5036803364879,26.498422712933756
07606,07,606,1738,997,17,980,624,356,57.36478711162255,1.7051153460381143,98.29488465396189,62.58776328986961,35.70712136409227
07607,07,607,2031,1075,27,1048,740,308,52.92959133431807,2.511627906976744,97.48837209302326,68.83720930232559,28.651162790697676
07608,07,608,1140,577,13,564,438,126,50.6140350877193,2.2530329289428077,97.74696707105718,75.90987868284229,21.837088388214905
07609,07,609,2582,1140,26,1114,808,306,44.15182029434547,2.280701754385965,97.71929824561404,70.87719298245614,26.842105263157894
07610,07,610,1329,449,13,436,336,100,33.78480060195636,2.89532293986637,97.10467706013362,74.83296213808464,22.271714922049
07611,07,611,2033,1025,16,1009,734,275,50.41810132808657,1.5609756097560976,98.4390243902439,71.60975609756098,26.82926829268293
07612,07,612,1555,711,17,694,523,171,45.72347266881029,2.390998593530239,97.60900140646976,73.55836849507736,24.050632911392405
07613,07,613,2129,941,26,915,678,237,44.199154532644435,2.763018065887354,97.23698193411265,72.0510095642933,25.185972369819343
07614,07,614,2176,1034,8,1026,752,274,47.518382352941174,0.7736943907156674,99.22630560928434,72.72727272727273,26.4990328820116
07615,07,615,1778,865,18,847,597,250,48.65016872890889,2.0809248554913293,97.91907514450867,69.01734104046243,28.901734104046245
07616,07,616,2280,1055,19,1036,727,309,46.271929824561404,1.8009478672985781,98.19905213270142,68.90995260663507,29.28909952606635
07617,07,617,1931,1033,10,1023,711,312,53.495598135681,0.9680542110358179,99.03194578896418,68.82865440464666,30.20329138431752
07701,07,701,1973,1052,16,1036,747,289,53.31981753674607,1.520912547528517,98.47908745247148,71.00760456273764,27.47148288973384
07702,07,702,2010,1049,24,1025,746,279,52.189054726368155,2.2878932316491896,97.71210676835082,71.11534795042897,26.596758817921828
07703,07,703,2120,1161,34,1127,858,269,54.76415094339623,2.9285099052540913,97.07149009474591,73.90180878552972,23.16968130921619
07704,07,704,2318,1105,27,1078,777,301,47.67040552200172,2.4434389140271495,97.55656108597285,70.31674208144797,27.239819004524886
07705,07,705,1883,951,13,938,697,241,50.50451407328731,1.3669821240799158,98.63301787592007,73.29127234490011,25.341745531019978
07706,07,706,1790,826,12,814,566,248,46.14525139664805,1.4527845036319613,98.54721549636804,68.52300242130751,30.024213075060537
07707,07,707,1962,977,18,959,693,266,49.79612640163099,1.842374616171955,98.15762538382803,70.93142272262027,27.226202661207775
07708,07,708,2037,1005,34,971,735,236,49.337260677466865,3.383084577114428,96.61691542288557,73.13432835820896,23.482587064676615
07709,07,709,1823,934,17,917,647,270,51.23422929237521,1.8201284796573876,98.17987152034262,69.27194860813705,28.90792291220557
07710,07,710,1784,787,20,767,604,163,44.11434977578475,2.5412960609911055,97.4587039390089,76.74714104193139,20.71156289707751
07711,07,711,1527,698,11,687,519,168,45.71054354944336,1.5759312320916905,98.42406876790831,74.35530085959886,24.068767908309454
07712,07,712,1899,854,17,837,650,187,44.971037388099,1.9906323185011712,98.00936768149883,76.11241217798595,21.89695550351288
07713,07,713,1753,797,24,773,567,206,45.464917284654874,3.0112923462986196,96.98870765370138,71.14178168130489,25.84692597239649
07714,07,714,1686,793,20,773,598,175,47.034400948991696,2.5220680958385877,97.47793190416141,75.40983606557377,22.06809583858764
07715,07,715,1734,913,12,901,664,237,52.65282583621684,1.3143483023001095,98.6856516976999,72.72727272727273,25.958378970427166
07716,07,716,1470,723,10,713,513,200,49.183673469387756,1.3831258644536653,98.61687413554634,70.95435684647303,27.662517289073307
07717,07,717,1641,801,13,788,563,225,48.81170018281536,1.6229712858926344,98.37702871410737,70.28714107365793,28.08988764044944
07718,07,718,1704,854,10,844,642,202,50.117370892018776,1.1709601873536302,98.82903981264637,75.17564402810304,23.653395784543328
08101,08,101,1040,503,22,481,186,295,48.36538461538461,4.3737574552683895,95.62624254473161,36.97813121272366,58.64811133200796
08102,08,102,1128,549,21,528,219,309,48.67021276595745,3.825136612021858,96.17486338797814,39.89071038251366,56.284153005464475
08103,08,103,1347,656,27,629,269,360,48.70081662954714,4.115853658536586,95.88414634146342,41.006097560975604,54.87804878048781
08104,08,104,1260,592,2,590,257,333,46.98412698412698,0.33783783783783783,99.66216216216216,43.41216216216216,56.25
08105,08,105,1188,571,17,554,241,313,48.063973063973066,2.9772329246935203,97.02276707530648,42.20665499124343,54.81611208406305
08106,08,106,1221,609,36,573,213,360,49.877149877149876,5.911330049261084,94.08866995073892,34.97536945812808,59.11330049261084
08107,08,107,1427,646,26,620,251,369,45.2697967764541,4.024767801857585,95.97523219814241,38.85448916408669,57.120743034055735
08108,08,108,1054,568,6,562,196,366,53.889943074003796,1.056338028169014,98.94366197183099,34.50704225352113,64.43661971830986
08109,08,109,1160,616,15,601,242,359,53.103448275862064,2.4350649350649354,97.56493506493507,39.285714285714285,58.27922077922077
08110,08,110,1131,526,17,509,219,290,46.50751547303271,3.2319391634980987,96.7680608365019,41.634980988593156,55.13307984790875
08111,08,111,1008,464,28,436,196,240,46.03174603174603,6.0344827586206895,93.96551724137932,42.241379310344826,51.724137931034484
08112,08,112,1401,577,20,557,256,301,41.18486795146324,3.466204506065858,96.53379549393414,44.367417677642976,52.16637781629117
08113,08,113,1446,715,18,697,294,403,49.446749654218536,2.5174825174825175,97.48251748251748,41.11888111888112,56.36363636363636
08114,08,114,1159,573,16,557,227,330,49.43917169974116,2.7923211169284468,97.20767888307155,39.61605584642234,57.59162303664922
08115,08,115,1134,583,13,570,232,338,51.410934744268076,2.2298456260720414,97.77015437392797,39.79416809605489,57.97598627787307
08116,08,116,842,349,9,340,224,116,41.448931116389545,2.5787965616045847,97.42120343839542,64.18338108882521,33.2378223495702
08117,08,117,1228,518,27,491,251,240,42.18241042345277,5.212355212355212,94.78764478764478,48.455598455598455,46.33204633204633
08118,08,118,1481,713,19,694,274,420,48.14314652261985,2.664796633941094,97.3352033660589,38.42917251051893,58.90603085553997
08119,08,119,1241,652,21,631,263,368,52.53827558420628,3.2208588957055215,96.77914110429448,40.33742331288344,56.44171779141104
08120,08,120,1198,601,21,580,299,281,50.1669449081803,3.494176372712146,96.50582362728785,49.750415973377706,46.75540765391015
08121,08,121,1184,529,11,518,289,229,44.67905405405405,2.0793950850661624,97.92060491493385,54.63137996219282,43.28922495274102
08122,08,122,1432,592,19,573,264,309,41.340782122905026,3.209459459459459,96.79054054054053,44.5945945945946,52.195945945945944
08123,08,123,1478,729,22,707,302,405,49.3234100135318,3.017832647462277,96.98216735253772,41.426611796982165,55.55555555555556
08201,08,201,1486,724,17,707,287,420,48.721399730821,2.3480662983425415,97.65193370165746,39.64088397790056,58.011049723756905
08202,08,202,1336,639,25,614,309,305,47.82934131736527,3.912363067292645,96.08763693270735,48.35680751173709,47.73082942097027
08203,08,203,1405,720,31,689,275,414,51.245551601423486,4.305555555555555,95.69444444444444,38.19444444444444,57.49999999999999
08204,08,204,1245,574,23,551,241,310,46.10441767068273,4.006968641114982,95.99303135888502,41.98606271777003,54.00696864111498
08205,08,205,1355,586,11,575,249,326,43.247232472324725,1.877133105802048,98.12286689419795,42.491467576791806,55.631399317406135
08206,08,206,1340,588,23,565,257,308,43.88059701492537,3.9115646258503403,96.08843537414967,43.707482993197274,52.38095238095239
08207,08,207,1435,678,24,654,264,390,47.247386759581886,3.5398230088495577,96.46017699115043,38.93805309734513,57.52212389380531
08208,08,208,1227,567,28,539,228,311,46.21026894865526,4.938271604938271,95.06172839506173,40.21164021164021,54.85008818342152
08209,08,209,1447,778,10,768,335,433,53.76641326883207,1.2853470437017995,98.7146529562982,43.05912596401028,55.65552699228792
08210,08,210,1325,653,18,635,283,352,49.283018867924525,2.756508422664625,97.24349157733538,43.33843797856049,53.905053598774884
08211,08,211,1201,605,21,584,252,332,50.37468776019983,3.4710743801652892,96.52892561983471,41.65289256198347,54.87603305785124
08212,08,212,1329,670,31,639,260,379,50.41384499623778,4.626865671641791,95.3731343283582,38.80597014925373,56.56716417910448
08213,08,213,1127,490,26,464,273,191,43.47826086956522,5.3061224489795915,94.6938775510204,55.714285714285715,38.9795918367347
08214,08,214,1111,469,13,456,286,170,42.21422142214221,2.771855010660981,97.22814498933901,60.98081023454158,36.247334754797436
08215,08,215,1194,558,20,538,243,295,46.733668341708544,3.584229390681003,96.415770609319,43.54838709677419,52.867383512544805
08216,08,216,1305,521,25,496,222,274,39.92337164750958,4.798464491362764,95.20153550863724,42.61036468330134,52.5911708253359
08217,08,217,1178,466,7,459,195,264,39.55857385398981,1.502145922746781,98.49785407725322,41.84549356223176,56.65236051502146
08218,08,218,1317,586,25,561,247,314,44.49506454062263,4.266211604095563,95.73378839590444,42.15017064846416,53.58361774744027
08219,08,219,1213,593,22,571,320,251,48.88705688375927,3.709949409780776,96.29005059021922,53.96290050590219,42.32715008431703
08220,08,220,1217,609,23,586,242,344,50.04108463434675,3.776683087027915,96.2233169129721,39.737274220032845,56.48604269293924
08221,08,221,1172,599,13,586,243,343,51.10921501706485,2.1702838063439067,97.8297161936561,40.56761268781302,57.26210350584308
08222,08,222,1549,754,25,729,322,407,48.6765655261459,3.3156498673740056,96.684350132626,42.70557029177719,53.97877984084881
08301,08,301,1316,617,15,602,244,358,46.88449848024316,2.4311183144246353,97.56888168557536,39.546191247974065,58.0226904376013
08302,08,302,1099,480,24,456,192,264,43.67606915377616,5.0,95.0,40.0,55.00000000000001
08303,08,303,1384,686,22,664,306,358,49.566473988439306,3.206997084548105,96.7930029154519,44.606413994169095,52.1865889212828
08304,08,304,1463,688,25,663,275,388,47.02665755297335,3.6337209302325584,96.36627906976744,39.97093023255814,56.395348837209305
08305,08,305,1187,632,23,609,250,359,53.243470935130574,3.6392405063291138,96.36075949367088,39.55696202531646,56.80379746835443
08306,08,306,1487,693,21,672,273,399,46.60390047074647,3.0303030303030303,96.96969696969697,39.39393939393939,57.57575757575758
08307,08,307,1034,485,19,466,239,227,46.905222437137326,3.917525773195876,96.08247422680412,49.27835051546392,46.8041237113402
08308,08,308,1463,687,24,663,302,361,46.958304853041696,3.4934497816593884,96.50655021834062,43.95924308588064,52.54730713245998
08309,08,309,1101,522,17,505,206,299,47.41144414168937,3.256704980842912,96.74329501915709,39.46360153256705,57.279693486590034
08310,08,310,1487,739,28,711,295,416,49.697377269670476,3.7889039242219216,96.21109607577807,39.918809201623816,56.292286874154264
08311,08,311,1293,601,14,587,247,340,46.48105181747873,2.329450915141431,97.67054908485858,41.098169717138106,56.57237936772047
08312,08,312,1586,664,27,637,252,385,41.86633039092055,4.066265060240964,95.93373493975903,37.95180722891566,57.98192771084337
08313,08,313,1028,421,18,403,184,219,40.95330739299611,4.275534441805226,95.72446555819477,43.705463182897866,52.01900237529691
08314,08,314,1046,511,20,491,259,232,48.85277246653919,3.9138943248532287,96.08610567514677,50.68493150684932,45.40117416829745
08315,08,315,1268,445,12,433,230,203,35.094637223974765,2.696629213483146,97.30337078651685,51.68539325842697,45.61797752808989
08316,08,316,1078,406,16,390,198,192,37.66233766233766,3.9408866995073892,96.05911330049261,48.76847290640394,47.29064039408867
08317,08,317,1098,493,22,471,265,206,44.899817850637525,4.462474645030426,95.53752535496957,53.7525354969574,41.784989858012175
08318,08,318,1101,315,11,304,151,153,28.610354223433244,3.492063492063492,96.5079365079365,47.93650793650794,48.57142857142857
08319,08,319,1009,402,5,397,271,126,39.841427155599604,1.2437810945273633,98.75621890547264,67.41293532338308,31.343283582089555
08320,08,320,1105,429,11,418,290,128,38.82352941176471,2.564102564102564,97.43589743589743,67.5990675990676,29.836829836829835
08321,08,321,1133,458,20,438,312,126,40.42365401588703,4.366812227074235,95.63318777292577,68.12227074235808,27.510917030567683
08322,08,322,1190,531,20,511,350,161,44.6218487394958,3.766478342749529,96.23352165725048,65.91337099811676,30.32015065913371
08323,08,323,1369,678,8,670,417,253,49.525200876552226,1.1799410029498525,98.82005899705014,61.504424778761056,37.315634218289084
08324,08,324,1379,539,9,530,373,157,39.08629441624365,1.6697588126159555,98.33024118738405,69.20222634508349,29.12801484230056
08401,08,401,1485,649,13,636,324,312,43.7037037037037,2.0030816640986133,97.99691833590138,49.922958397534664,48.07395993836672
08402,08,402,1393,580,10,570,338,232,41.6367552045944,1.7241379310344827,98.27586206896551,58.27586206896552,40.0
08403,08,403,1343,573,10,563,361,202,42.6656738644825,1.7452006980802792,98.25479930191972,63.00174520069808,35.25305410122164
08404,08,404,1362,542,13,529,396,133,39.794419970631424,2.3985239852398523,97.60147601476015,73.06273062730627,24.538745387453876
08405,08,405,1396,556,13,543,389,154,39.82808022922636,2.338129496402878,97.66187050359713,69.96402877697841,27.697841726618705
08406,08,406,1466,784,7,777,497,280,53.47885402455662,0.8928571428571428,99.10714285714286,63.39285714285714,35.714285714285715
08407,08,407,1435,631,17,614,413,201,43.97212543554007,2.694136291600634,97.30586370839937,65.45166402535658,31.85419968304279
08408,08,408,1158,480,20,460,290,170,41.45077720207254,4.166666666666666,95.83333333333334,60.416666666666664,35.41666666666667
08409,08,409,1436,706,22,684,469,215,49.16434540389972,3.1161473087818696,96.88385269121812,66.43059490084985,30.45325779036827
08410,08,410,1071,439,16,423,294,129,40.98972922502334,3.644646924829157,96.35535307517085,66.97038724373576,29.38496583143508
08411,08,411,1379,634,17,617,380,237,45.975344452501815,2.6813880126182967,97.3186119873817,59.93690851735016,37.381703470031546
08412,08,412,1426,743,14,729,387,342,52.103786816269285,1.8842530282637955,98.1157469717362,52.086137281292054,46.02960969044415
08413,08,413,1603,685,8,677,430,247,42.73237679351217,1.167883211678832,98.83211678832117,62.77372262773723,36.05839416058394
08414,08,414,1325,514,15,499,382,117,38.79245283018868,2.9182879377431905,97.08171206225681,74.31906614785993,22.762645914396888
08415,08,415,1043,456,14,442,320,122,43.72003835091083,3.070175438596491,96.9298245614035,70.17543859649122,26.75438596491228
08416,08,416,999,518,16,502,305,197,51.85185185185185,3.088803088803089,96.91119691119691,58.88030888030889,38.030888030888036
08417,08,417,1113,488,11,477,343,134,43.84546271338724,2.2540983606557377,97.74590163934425,70.28688524590164,27.459016393442624
08418,08,418,1437,645,4,641,423,218,44.88517745302714,0.6201550387596899,99.37984496124031,65.58139534883722,33.798449612403104
08419,08,419,1056,481,11,470,349,121,45.54924242424242,2.2869022869022873,97.71309771309772,72.55717255717255,25.155925155925157
08420,08,420,1463,739,7,732,480,252,50.512645249487356,0.9472259810554804,99.05277401894452,64.95263870094723,34.10013531799729
08421,08,421,1028,555,10,545,375,170,53.988326848249024,1.8018018018018018,98.1981981981982,67.56756756756756,30.630630630630627
08422,08,422,1226,603,10,593,414,179,49.184339314845026,1.658374792703151,98.34162520729684,68.65671641791045,29.684908789386398
08423,08,423,1188,567,17,550,391,159,47.72727272727273,2.9982363315696645,97.00176366843033,68.95943562610229,28.04232804232804
08501,08,501,1152,461,12,449,295,154,40.01736111111111,2.6030368763557483,97.39696312364426,63.99132321041214,33.40563991323211
08502,08,502,1409,765,8,757,495,262,54.29382540809085,1.045751633986928,98.95424836601308,64.70588235294117,34.248366013071895
08503,08,503,1214,553,7,546,362,184,45.551894563426686,1.2658227848101267,98.73417721518987,65.46112115732369,33.273056057866185
08504,08,504,1442,743,19,724,544,180,51.5256588072122,2.557200538358008,97.442799461642,73.21668909825033,24.226110363391655
08505,08,505,1373,701,21,680,492,188,51.056081573197375,2.9957203994293864,97.00427960057061,70.18544935805991,26.8188302425107
08506,08,506,1368,707,18,689,532,157,51.68128654970761,2.545968882602546,97.45403111739745,75.24752475247524,22.206506364922205
08507,08,507,1073,562,8,554,392,162,52.37651444547996,1.4234875444839856,98.57651245551602,69.7508896797153,28.825622775800714
08508,08,508,1271,523,11,512,348,164,41.14870180959874,2.1032504780114722,97.89674952198853,66.53919694072657,31.35755258126195
08509,08,509,1112,517,2,515,387,128,46.492805755395686,0.3868471953578337,99.61315280464217,74.85493230174082,24.758220502901356
08510,08,510,1586,890,22,868,596,272,56.11601513240857,2.4719101123595504,97.52808988764045,66.96629213483146,30.56179775280899
08511,08,511,1468,695,19,676,503,173,47.3433242506812,2.7338129496402876,97.2661870503597,72.37410071942446,24.89208633093525
08512,08,512,1079,564,8,556,388,168,52.27062094531975,1.4184397163120568,98.58156028368793,68.79432624113475,29.78723404255319
08513,08,513,960,507,7,500,330,170,52.81249999999999,1.3806706114398422,98.61932938856016,65.08875739644971,33.53057199211045
08514,08,514,1028,515,12,503,354,149,50.09727626459144,2.3300970873786406,97.66990291262137,68.73786407766991,28.932038834951456
08515,08,515,1160,596,4,592,444,148,51.37931034482759,0.6711409395973155,99.32885906040269,74.49664429530202,24.832214765100673
08516,08,516,1136,594,18,576,412,164,52.2887323943662,3.0303030303030303,96.96969696969697,69.36026936026936,27.609427609427613
08517,08,517,1350,697,17,680,474,206,51.629629629629626,2.4390243902439024,97.5609756097561,68.00573888091822,29.555236728837876
08518,08,518,1232,576,17,559,422,137,46.75324675324675,2.951388888888889,97.04861111111111,73.26388888888889,23.78472222222222
08519,08,519,1033,504,14,490,357,133,48.78993223620523,2.7777777777777777,97.22222222222221,70.83333333333334,26.38888888888889
08520,08,520,1386,554,14,540,379,161,39.97113997113997,2.527075812274368,97.47292418772562,68.41155234657039,29.061371841155236
08521,08,521,1219,611,15,596,416,180,50.12305168170632,2.454991816693944,97.54500818330605,68.08510638297872,29.45990180032733
08522,08,522,1433,679,19,660,469,191,47.3831123517097,2.798232695139912,97.20176730486008,69.0721649484536,28.12960235640648
08601,08,601,1598,732,16,716,528,188,45.8072590738423,2.185792349726776,97.81420765027322,72.1311475409836,25.683060109289617
08602,08,602,1709,637,8,629,442,187,37.273259215915736,1.2558869701726845,98.74411302982732,69.38775510204081,29.356357927786497
08603,08,603,1113,464,5,459,322,137,41.689128481581314,1.0775862068965518,98.92241379310344,69.39655172413794,29.52586206896552
08604,08,604,1280,584,15,569,412,157,45.625,2.5684931506849313,97.43150684931507,70.54794520547945,26.88356164383562
08605,08,605,1301,562,5,557,398,159,43.197540353574176,0.8896797153024912,99.11032028469751,70.8185053380783,28.291814946619215
08606,08,606,1178,545,14,531,385,146,46.26485568760611,2.5688073394495414,97.43119266055047,70.64220183486239,26.788990825688074
08607,08,607,1257,481,12,469,328,141,38.26571201272872,2.494802494802495,97.5051975051975,68.1912681912682,29.313929313929314
08608,08,608,1763,749,32,717,507,210,42.48440158820193,4.2723631508678235,95.72763684913218,67.69025367156209,28.037383177570092
08609,08,609,1558,641,11,630,460,170,41.14249037227214,1.71606864274571,98.28393135725429,71.7628705148206,26.521060842433698
08610,08,610,1027,475,10,465,334,131,46.25121713729309,2.1052631578947367,97.89473684210527,70.3157894736842,27.57894736842105
08611,08,611,1565,594,15,579,446,133,37.95527156549521,2.525252525252525,97.47474747474747,75.08417508417509,22.39057239057239
08612,08,612,1243,516,31,485,341,144,41.5124698310539,6.007751937984496,93.9922480620155,66.08527131782945,27.906976744186046
08613,08,613,1441,706,20,686,493,193,48.99375433726579,2.8328611898017,97.16713881019831,69.83002832861189,27.3371104815864
08614,08,614,1016,395,5,390,297,93,38.87795275590551,1.2658227848101267,98.73417721518987,75.18987341772151,23.544303797468356
08615,08,615,1652,677,17,660,458,202,40.98062953995157,2.511078286558346,97.48892171344166,67.65140324963073,29.83751846381093
08616,08,616,1191,461,8,453,305,148,38.70696893366918,1.735357917570499,98.2646420824295,66.16052060737528,32.10412147505423
08617,08,617,1318,654,8,646,466,180,49.6206373292868,1.2232415902140672,98.77675840978594,71.25382262996942,27.522935779816514
08618,08,618,1215,536,19,517,389,128,44.11522633744856,3.544776119402985,96.45522388059702,72.57462686567165,23.88059701492537
08619,08,619,1401,625,21,604,458,146,44.610992148465385,3.36,96.64,73.28,23.36
08620,08,620,1566,635,9,626,447,179,40.54916985951469,1.4173228346456692,98.58267716535433,70.39370078740157,28.188976377952756
08621,08,621,864,405,6,399,296,103,46.875,1.4814814814814816,98.51851851851852,73.08641975308642,25.432098765432098
08622,08,622,1325,576,10,566,423,143,43.471698113207545,1.7361111111111112,98.26388888888889,73.4375,24.82638888888889
08701,08,701,1486,734,8,726,514,212,49.39434724091521,1.08991825613079,98.9100817438692,70.02724795640327,28.882833787465938
08702,08,702,1412,744,4,740,514,226,52.69121813031161,0.5376344086021506,99.46236559139786,69.08602150537635,30.376344086021508
08703,08,703,1177,558,13,545,397,148,47.408666100254884,2.3297491039426523,97.67025089605734,71.14695340501792,26.523297491039425
08704,08,704,1535,801,11,790,563,227,52.18241042345277,1.373283395755306,98.62671660424469,70.28714107365793,28.33957553058677
08705,08,705,1268,710,16,694,484,210,55.99369085173501,2.2535211267605635,97.74647887323944,68.16901408450704,29.577464788732392
08706,08,706,1549,912,33,879,597,282,58.87669464170433,3.618421052631579,96.38157894736842,65.46052631578947,30.92105263157895
08707,08,707,1419,688,19,669,474,195,48.484848484848484,2.761627906976744,97.23837209302324,68.8953488372093,28.343023255813954
08708,08,708,1397,713,12,701,504,197,51.03793843951324,1.6830294530154277,98.31697054698458,70.68723702664796,27.629733520336607
08709,08,709,1474,737,14,723,513,210,50.0,1.8995929443690638,98.10040705563094,69.60651289009499,28.493894165535956
08710,08,710,1460,805,23,782,576,206,55.13698630136986,2.857142857142857,97.14285714285714,71.55279503105591,25.59006211180124
08711,08,711,1505,824,16,808,574,234,54.750830564784046,1.9417475728155338,98.05825242718447,69.66019417475728,28.398058252427184
08712,08,712,1518,796,15,781,561,220,52.43741765480896,1.8844221105527637,98.11557788944724,70.47738693467338,27.63819095477387
08713,08,713,1470,805,14,791,562,229,54.761904761904766,1.7391304347826086,98.26086956521739,69.8136645962733,28.4472049689441
08714,08,714,1408,659,14,645,459,186,46.80397727272727,2.12443095599393,97.87556904400607,69.65098634294385,28.224582701062218
08715,08,715,1492,817,23,794,522,272,54.75871313672922,2.8151774785801713,97.18482252141983,63.8922888616891,33.29253365973072
08716,08,716,1640,844,17,827,602,225,51.463414634146346,2.014218009478673,97.98578199052133,71.32701421800948,26.658767772511847
08717,08,717,1542,881,18,863,618,245,57.13359273670557,2.0431328036322363,97.95686719636775,70.14755959137344,27.809307604994327
08718,08,718,1673,869,17,852,612,240,51.942618051404665,1.9562715765247412,98.04372842347526,70.42577675489068,27.617951668584578
08719,08,719,1527,733,15,718,500,218,48.002619515389654,2.046384720327422,97.95361527967258,68.21282401091405,29.740791268758528
09101,09,101,1469,818,30,788,315,473,55.684138869979584,3.6674816625916873,96.33251833740832,38.50855745721272,57.8239608801956
09102,09,102,1849,884,29,855,397,458,47.80962682531098,3.2805429864253397,96.71945701357465,44.90950226244344,51.80995475113123
09103,09,103,1988,1092,31,1061,416,645,54.929577464788736,2.838827838827839,97.16117216117216,38.095238095238095,59.065934065934066
09104,09,104,1353,791,37,754,340,414,58.462675535846266,4.677623261694058,95.32237673830595,42.983565107458915,52.338811630847026
09105,09,105,1296,632,15,617,272,345,48.76543209876543,2.3734177215189876,97.62658227848101,43.037974683544306,54.58860759493671
09106,09,106,1993,939,27,912,348,564,47.11490215755143,2.8753993610223643,97.12460063897763,37.06070287539936,60.063897763578275
09107,09,107,2084,1048,24,1024,518,506,50.287907869481764,2.2900763358778624,97.70992366412213,49.42748091603054,48.282442748091604
09108,09,108,2059,980,22,958,450,508,47.59592034968431,2.2448979591836733,97.75510204081633,45.91836734693878,51.83673469387755
09109,09,109,1914,952,27,925,429,496,49.738766980146295,2.8361344537815127,97.16386554621849,45.063025210084035,52.10084033613446
09110,09,110,2093,903,16,887,470,417,43.1438127090301,1.7718715393133997,98.2281284606866,52.04872646733112,46.179401993355484
09111,09,111,1925,952,19,933,499,434,49.45454545454545,1.9957983193277309,98.00420168067227,52.41596638655462,45.588235294117645
09112,09,112,1640,945,28,917,448,469,57.62195121951219,2.9629629629629632,97.03703703703704,47.40740740740741,49.629629629629626
09113,09,113,1593,846,28,818,413,405,53.10734463276836,3.309692671394799,96.6903073286052,48.817966903073284,47.87234042553192
09114,09,114,2221,992,23,969,434,535,44.66456551103107,2.318548387096774,97.68145161290323,43.75,53.931451612903224
09115,09,115,1672,852,17,835,472,363,50.95693779904307,1.9953051643192488,98.00469483568075,55.39906103286385,42.6056338028169
09116,09,116,2208,1059,30,1029,533,496,47.96195652173913,2.8328611898017,97.16713881019831,50.330500472143534,46.83663833805477
09117,09,117,1952,942,16,926,514,412,48.25819672131148,1.6985138004246285,98.30148619957538,54.56475583864119,43.73673036093418
09118,09,118,1272,650,15,635,372,263,51.100628930817614,2.307692307692308,97.6923076923077,57.230769230769226,40.46153846153846
09119,09,119,1223,675,9,666,369,297,55.192150449713814,1.3333333333333335,98.66666666666667,54.666666666666664,44.0
09201,09,201,2118,1119,21,1098,579,519,52.8328611898017,1.876675603217158,98.12332439678283,51.742627345844504,46.38069705093834
09202,09,202,2038,1120,25,1095,589,506,54.9558390578999,2.232142857142857,97.76785714285714,52.589285714285715,45.17857142857143
09203,09,203,1945,1071,23,1048,598,450,55.06426735218509,2.1475256769374416,97.85247432306255,55.83566760037348,42.016806722689076
09204,09,204,2177,1161,27,1134,667,467,53.33027101515847,2.3255813953488373,97.67441860465115,57.450473729543496,40.22394487510766
09205,09,205,1512,793,18,775,469,306,52.44708994708994,2.269861286254729,97.73013871374528,59.14249684741488,38.587641866330394
09206,09,206,1712,872,18,854,507,347,50.93457943925234,2.064220183486239,97.93577981651376,58.142201834862384,39.793577981651374
09207,09,207,1489,739,32,707,423,284,49.63062458025521,4.330175913396482,95.66982408660351,57.23951285520974,38.43031123139377
09208,09,208,1395,749,12,737,418,319,53.691756272401435,1.602136181575434,98.39786381842457,55.80774365821095,42.590120160213615
09209,09,209,1350,711,15,696,391,305,52.666666666666664,2.109704641350211,97.8902953586498,54.9929676511955,42.897327707454295
09210,09,210,1771,893,9,884,515,369,50.42348955392434,1.007838745800672,98.99216125419933,57.67077267637178,41.32138857782755
09211,09,211,2277,1089,16,1073,585,488,47.82608695652174,1.4692378328741964,98.5307621671258,53.71900826446281,44.81175390266299
09212,09,212,2130,1051,26,1025,525,500,49.34272300469484,2.47383444338725,97.52616555661275,49.952426260704094,47.57373929590866
09213,09,213,2286,1169,42,1127,662,465,51.13735783027121,3.592814371257485,96.40718562874252,56.629597946963216,39.777587681779295
09214,09,214,2268,1025,30,995,572,423,45.19400352733686,2.9268292682926833,97.07317073170731,55.804878048780495,41.26829268292683
09215,09,215,1325,687,16,671,388,283,51.84905660377358,2.3289665211062593,97.67103347889375,56.477438136826784,41.193595342066956
09216,09,216,1494,852,25,827,432,395,57.028112449799195,2.9342723004694835,97.06572769953051,50.70422535211267,46.36150234741784
09217,09,217,2046,1039,19,1020,540,480,50.78201368523949,1.8286814244465832,98.17131857555341,51.9730510105871,46.19826756496631
09218,09,218,1198,640,4,636,354,282,53.42237061769616,0.625,99.375,55.3125,44.0625
09219,09,219,1271,706,29,677,412,265,55.54681353265145,4.107648725212465,95.89235127478753,58.35694050991501,37.53541076487252
09220,09,220,1758,915,14,901,484,417,52.04778156996587,1.530054644808743,98.46994535519126,52.89617486338798,45.57377049180328
09221,09,221,2067,946,22,924,549,375,45.76681180454765,2.3255813953488373,97.67441860465115,58.033826638477805,39.64059196617336
09301,09,301,1747,977,30,947,545,402,55.92444190040069,3.0706243602865912,96.92937563971341,55.78300921187308,41.14636642784033
09302,09,302,1894,1007,34,973,529,444,53.16789862724393,3.3763654419066533,96.62363455809336,52.53227408142999,44.091360476663354
09303,09,303,2807,1399,28,1371,777,594,49.839686498040614,2.0014295925661187,97.99857040743389,55.53967119370979,42.45889921372409
09304,09,304,1754,1001,20,981,567,414,57.06955530216648,1.998001998001998,98.001998001998,56.64335664335665,41.35864135864136
09305,09,305,1941,879,19,860,444,416,45.28593508500773,2.1615472127417523,97.83845278725825,50.51194539249146,47.32650739476678
09306,09,306,1907,1030,22,1008,589,419,54.011536444677496,2.1359223300970873,97.86407766990291,57.18446601941748,40.679611650485434
09307,09,307,1621,832,9,823,483,340,51.326341764343,1.0817307692307692,98.91826923076923,58.05288461538461,40.86538461538461
09308,09,308,2047,1138,27,1111,660,451,55.593551538837325,2.3725834797891037,97.6274165202109,57.99648506151143,39.63093145869948
09309,09,309,1351,726,8,718,431,287,53.7379718726869,1.1019283746556474,98.89807162534436,59.366391184573,39.531680440771346
09310,09,310,1586,938,23,915,570,345,59.14249684741488,2.4520255863539444,97.54797441364606,60.76759061833689,36.78038379530917
09311,09,311,1888,1103,25,1078,624,454,58.42161016949152,2.2665457842248413,97.73345421577517,56.57298277425205,41.160471441523114
09312,09,312,1477,905,12,893,539,354,61.27285037237644,1.3259668508287292,98.67403314917127,59.55801104972376,39.11602209944751
09313,09,313,1988,1130,12,1118,706,412,56.841046277665995,1.0619469026548671,98.93805309734513,62.477876106194685,36.46017699115045
09314,09,314,1881,932,32,900,593,307,49.548112706007444,3.4334763948497855,96.56652360515021,63.62660944206009,32.93991416309013
09315,09,315,1402,784,16,768,463,305,55.92011412268189,2.0408163265306123,97.95918367346938,59.056122448979586,38.9030612244898
09316,09,316,1681,945,11,934,563,371,56.216537775133844,1.164021164021164,98.83597883597884,59.57671957671957,39.25925925925926
09317,09,317,1112,620,6,614,349,265,55.75539568345324,0.967741935483871,99.03225806451613,56.29032258064516,42.74193548387097
09318,09,318,1839,814,21,793,509,284,44.26318651441001,2.5798525798525795,97.42014742014742,62.53071253071253,34.88943488943489
09319,09,319,847,442,11,431,258,173,52.18417945690673,2.48868778280543,97.51131221719457,58.371040723981906,39.14027149321267
09320,09,320,1950,989,15,974,589,385,50.717948717948715,1.5166835187057632,98.48331648129424,59.555106167846304,38.92821031344793
09401,09,401,1995,1105,5,1100,812,288,55.388471177944865,0.4524886877828055,99.5475113122172,73.48416289592761,26.063348416289596
09402,09,402,1704,939,5,934,766,168,55.1056338028169,0.5324813631522897,99.4675186368477,81.57614483493077,17.89137380191693
09403,09,403,2173,1108,12,1096,730,366,50.989415554532904,1.083032490974729,98.91696750902527,65.88447653429603,33.03249097472924
09404,09,404,1574,935,18,917,735,182,59.40279542566709,1.9251336898395723,98.07486631016043,78.6096256684492,19.46524064171123
09405,09,405,1865,1013,15,998,865,133,54.31635388739946,1.4807502467917077,98.5192497532083,85.38993089832182,13.129318854886476
09406,09,406,1896,984,24,960,567,393,51.89873417721519,2.4390243902439024,97.5609756097561,57.62195121951219,39.9390243902439
09407,09,407,1487,806,22,784,432,352,54.20309347679893,2.729528535980149,97.27047146401985,53.59801488833747,43.67245657568238
09408,09,408,1322,688,13,675,382,293,52.04236006051437,1.88953488372093,98.11046511627907,55.52325581395349,42.587209302325576
09409,09,409,1694,739,11,728,423,305,43.6245572609209,1.4884979702300407,98.51150202976996,57.23951285520974,41.27198917456021
09410,09,410,1536,728,18,710,481,229,47.39583333333333,2.4725274725274726,97.52747252747253,66.07142857142857,31.456043956043956
09411,09,411,1326,741,17,724,428,296,55.88235294117647,2.2941970310391366,97.70580296896087,57.75978407557355,39.94601889338731
09412,09,412,2251,1266,4,1262,789,473,56.24167036872502,0.315955766192733,99.68404423380727,62.32227488151659,37.36176935229068
09413,09,413,1308,739,5,734,502,232,56.49847094801223,0.6765899864682002,99.3234100135318,67.9296346414073,31.393775372124495
09414,09,414,1483,860,15,845,720,125,57.99055967633176,1.744186046511628,98.25581395348837,83.72093023255815,14.534883720930234
09415,09,415,793,466,3,463,429,34,58.764186633039095,0.6437768240343348,99.35622317596567,92.06008583690986,7.296137339055794
09416,09,416,827,517,2,515,414,101,62.515114873035074,0.3868471953578337,99.61315280464217,80.07736943907156,19.535783365570598
09417,09,417,389,213,3,210,161,49,54.75578406169666,1.4084507042253522,98.59154929577466,75.5868544600939,23.004694835680752
09418,09,418,2455,1308,23,1285,685,600,53.27902240325866,1.7584097859327217,98.24159021406727,52.37003058103975,45.87155963302752
09419,09,419,1537,850,21,829,486,343,55.30253741054001,2.4705882352941173,97.52941176470588,57.1764705882353,40.35294117647059
09420,09,420,1153,570,10,560,352,208,49.43625325238508,1.7543859649122806,98.24561403508771,61.75438596491228,36.49122807017544
09421,09,421,1856,1006,17,989,551,438,54.202586206896555,1.6898608349900597,98.31013916500993,54.771371769383705,43.538767395626245
09422,09,422,1774,892,20,872,514,358,50.28184892897407,2.242152466367713,97.75784753363229,57.62331838565022,40.134529147982065
09501,09,501,1521,797,16,781,456,325,52.39973701512163,2.0075282308657463,97.99247176913426,57.21455457967378,40.777917189460474
09502,09,502,2113,1084,17,1067,652,415,51.30146710837672,1.5682656826568264,98.43173431734317,60.147601476014756,38.284132841328415
09503,09,503,1228,666,7,659,384,275,54.23452768729642,1.0510510510510511,98.94894894894894,57.65765765765766,41.291291291291294
09504,09,504,1837,1007,20,987,539,448,54.817637452368,1.9860973187686197,98.01390268123139,53.525322740814296,44.488579940417075
09505,09,505,1201,716,16,700,406,294,59.61698584512906,2.2346368715083798,97.76536312849163,56.70391061452514,41.06145251396648
09506,09,506,1291,665,17,648,422,226,51.51045701006971,2.556390977443609,97.44360902255639,63.45864661654136,33.98496240601504
09507,09,507,885,470,16,454,287,167,53.10734463276836,3.404255319148936,96.59574468085106,61.06382978723405,35.53191489361702
09508,09,508,1408,677,16,661,443,218,48.08238636363637,2.363367799113737,97.63663220088627,65.4357459379616,32.20088626292467
09509,09,509,1572,822,26,796,518,278,52.29007633587786,3.1630170316301705,96.83698296836984,63.017031630170315,33.81995133819951
09510,09,510,1334,639,10,629,403,226,47.90104947526237,1.5649452269170578,98.43505477308294,63.06729264475743,35.36776212832551
09511,09,511,1601,918,11,907,581,326,57.33916302311055,1.1982570806100217,98.80174291938998,63.289760348583876,35.5119825708061
09512,09,512,2165,1095,20,1075,694,381,50.57736720554272,1.82648401826484,98.17351598173516,63.37899543378995,34.794520547945204
09513,09,513,2096,1045,27,1018,642,376,49.85687022900763,2.583732057416268,97.41626794258373,61.4354066985646,35.98086124401914
09514,09,514,2122,1125,20,1105,667,438,53.01602262016966,1.7777777777777777,98.22222222222223,59.28888888888889,38.93333333333333
09515,09,515,1998,1123,17,1106,703,403,56.20620620620621,1.5138023152270703,98.48619768477292,62.600178094390024,35.8860195903829
09516,09,516,1979,1112,18,1094,921,173,56.1899949469429,1.618705035971223,98.38129496402878,82.82374100719424,15.557553956834532
09517,09,517,1996,1240,13,1227,1031,196,62.124248496993985,1.0483870967741937,98.95161290322581,83.14516129032258,15.806451612903224
09518,09,518,1567,877,2,875,750,125,55.966815571155074,0.22805017103762829,99.77194982896236,85.5188141391106,14.253135689851767
09601,09,601,1992,1044,38,1006,615,391,52.40963855421686,3.6398467432950192,96.36015325670499,58.90804597701149,37.452107279693486
09602,09,602,1495,852,25,827,514,313,56.98996655518395,2.9342723004694835,97.06572769953051,60.328638497652584,36.73708920187793
09603,09,603,1497,871,23,848,519,329,58.183032732130926,2.640642939150402,97.35935706084959,59.58668197474167,37.772675086107924
09604,09,604,2026,1201,30,1171,762,409,59.27936821322803,2.497918401332223,97.50208159866777,63.447127393838464,34.05495420482931
09605,09,605,2160,1175,22,1153,727,426,54.39814814814815,1.872340425531915,98.12765957446808,61.87234042553192,36.255319148936174
09606,09,606,1952,1119,19,1100,683,417,57.32581967213115,1.6979445933869526,98.30205540661304,61.036639857015196,37.26541554959786
09607,09,607,1615,876,18,858,552,306,54.241486068111456,2.054794520547945,97.94520547945206,63.013698630136986,34.93150684931507
09608,09,608,2289,1122,35,1087,680,407,49.0170380078637,3.119429590017825,96.88057040998217,60.60606060606061,36.27450980392157
09609,09,609,1618,894,7,887,501,386,55.25339925834364,0.7829977628635347,99.21700223713647,56.04026845637584,43.17673378076063
09610,09,610,1365,839,20,819,450,369,61.46520146520147,2.3837902264600714,97.61620977353994,53.63528009535161,43.98092967818832
09611,09,611,1711,970,26,944,529,415,56.69199298655757,2.6804123711340204,97.31958762886597,54.5360824742268,42.78350515463917
09612,09,612,2144,1267,53,1214,644,570,59.095149253731336,4.183109707971586,95.81689029202842,50.82872928176796,44.988161010260455
09613,09,613,1303,641,22,619,335,284,49.19416730621642,3.43213728549142,96.56786271450858,52.26209048361935,44.30577223088923
09614,09,614,2651,1444,33,1411,805,606,54.470011316484346,2.285318559556787,97.71468144044321,55.747922437673125,41.96675900277008
09615,09,615,1219,622,6,616,443,173,51.025430680885975,0.964630225080386,99.03536977491962,71.22186495176848,27.813504823151124
09616,09,616,1558,843,10,833,568,265,54.107830551989736,1.1862396204033214,98.81376037959669,67.37841043890866,31.435349940688017
09617,09,617,1893,1110,17,1093,861,232,58.63708399366085,1.5315315315315314,98.46846846846847,77.56756756756756,20.9009009009009
09618,09,618,1491,829,11,818,599,219,55.60026827632461,1.3268998793727382,98.67310012062727,72.25572979493366,26.417370325693607
09619,09,619,1379,834,10,824,670,154,60.47860768672951,1.1990407673860912,98.8009592326139,80.3357314148681,18.465227817745802
10101,10,101,1808,805,14,791,461,330,44.52433628318584,1.7391304347826086,98.26086956521739,57.267080745341616,40.993788819875775
10102,10,102,1067,549,16,533,283,250,51.452671040299904,2.914389799635701,97.0856102003643,51.54826958105647,45.537340619307834
10103,10,103,1235,506,13,493,288,205,40.97165991902834,2.5691699604743086,97.4308300395257,56.916996047430835,40.51383399209486
10104,10,104,1384,698,16,682,369,313,50.433526011560694,2.292263610315186,97.70773638968481,52.865329512893986,44.84240687679083
10105,10,105,1316,627,15,612,335,277,47.64437689969605,2.3923444976076556,97.60765550239235,53.42902711323764,44.1786283891547
10106,10,106,1309,632,14,618,388,230,48.281130634071815,2.2151898734177213,97.78481012658227,61.39240506329114,36.392405063291136
10107,10,107,1656,808,18,790,470,320,48.792270531400966,2.2277227722772275,97.77227722772277,58.168316831683164,39.603960396039604
10108,10,108,1664,701,20,681,412,269,42.12740384615385,2.8530670470756063,97.14693295292439,58.77318116975749,38.3737517831669
10109,10,109,1674,698,14,684,423,261,41.69653524492234,2.005730659025788,97.99426934097421,60.60171919770774,37.392550143266476
10110,10,110,1750,822,16,806,481,325,46.97142857142857,1.9464720194647203,98.05352798053528,58.51581508515815,39.53771289537713
10111,10,111,1979,943,25,918,537,381,47.65032844871147,2.651113467656416,97.34888653234358,56.9459172852598,40.402969247083774
10112,10,112,1633,795,18,777,484,293,48.683404776485,2.2641509433962264,97.73584905660377,60.880503144654085,36.855345911949684
10113,10,113,1737,772,22,750,450,300,44.44444444444444,2.849740932642487,97.15025906735751,58.2901554404145,38.860103626943
10114,10,114,1934,876,25,851,439,412,45.2947259565667,2.853881278538813,97.14611872146118,50.114155251141554,47.03196347031963
10115,10,115,2106,1152,19,1133,568,565,54.700854700854705,1.6493055555555556,98.35069444444444,49.30555555555556,49.04513888888889
10116,10,116,1686,717,19,698,424,274,42.52669039145908,2.6499302649930265,97.35006973500697,59.13528591352859,38.214783821478385
10117,10,117,1826,937,22,915,554,361,51.314348302300104,2.3479188900747063,97.65208110992529,59.12486659551761,38.52721451440768
10118,10,118,1466,676,12,664,405,259,46.1118690313779,1.7751479289940828,98.22485207100591,59.9112426035503,38.31360946745562
10119,10,119,1565,755,16,739,408,331,48.242811501597444,2.119205298013245,97.88079470198674,54.03973509933775,43.841059602649004
10120,10,120,1378,607,18,589,357,232,44.04934687953556,2.9654036243822075,97.03459637561778,58.81383855024712,38.220757825370676
10201,10,201,1839,921,15,906,498,408,50.08156606851549,1.6286644951140066,98.37133550488599,54.071661237785015,44.299674267100976
10202,10,202,1880,848,4,844,472,372,45.1063829787234,0.4716981132075472,99.52830188679245,55.660377358490564,43.86792452830189
10203,10,203,2004,945,29,916,507,409,47.1556886227545,3.068783068783069,96.93121693121694,53.65079365079365,43.28042328042328
10204,10,204,2117,1049,42,1007,509,498,49.55125177137459,4.003813155386082,95.99618684461392,48.52240228789323,47.47378455672069
10205,10,205,1952,867,18,849,493,356,44.415983606557376,2.0761245674740483,97.92387543252595,56.86274509803921,41.061130334486734
10206,10,206,1669,720,12,708,408,300,43.13960455362493,1.6666666666666667,98.33333333333333,56.666666666666664,41.66666666666667
10207,10,207,1703,881,8,873,469,404,51.73223722842043,0.9080590238365494,99.09194097616346,53.23496027241771,45.85698070374574
10208,10,208,1781,885,16,869,481,388,49.691184727681076,1.807909604519774,98.19209039548022,54.35028248587571,43.84180790960452
10209,10,209,1690,817,10,807,447,360,48.34319526627219,1.2239902080783354,98.77600979192167,54.71236230110159,44.063647490820074
10210,10,210,1927,901,22,879,471,408,46.756616502335234,2.4417314095449503,97.55826859045506,52.275249722530525,45.28301886792453
10211,10,211,1418,679,22,657,371,286,47.88434414668547,3.2400589101620034,96.759941089838,54.63917525773196,42.12076583210604
10212,10,212,1520,770,16,754,346,408,50.6578947368421,2.0779220779220777,97.92207792207792,44.935064935064936,52.98701298701298
10213,10,213,1849,878,10,868,517,351,47.48512709572742,1.1389521640091116,98.86104783599089,58.88382687927107,39.97722095671982
10214,10,214,1702,930,21,909,434,475,54.64159811985899,2.258064516129032,97.74193548387096,46.666666666666664,51.075268817204304
10215,10,215,1635,870,25,845,456,389,53.21100917431193,2.8735632183908044,97.12643678160919,52.41379310344828,44.712643678160916
10216,10,216,1932,1037,24,1013,505,508,53.674948240165634,2.3143683702989395,97.68563162970106,48.69816779170685,48.98746383799421
10217,10,217,1597,730,8,722,438,284,45.71070757670632,1.095890410958904,98.9041095890411,60.0,38.9041095890411
10218,10,218,1431,751,22,729,376,353,52.48078266946191,2.929427430093209,97.07057256990679,50.06657789613848,47.003994673768304
10219,10,219,1283,564,15,549,319,230,43.95946999220577,2.6595744680851063,97.3404255319149,56.560283687943254,40.78014184397163
10220,10,220,1489,779,28,751,406,345,52.316991269308254,3.594351732991014,96.40564826700898,52.118100128369704,44.28754813863928
10301,10,301,1924,1094,30,1064,563,501,56.860706860706856,2.742230347349177,97.25776965265082,51.46252285191956,45.79524680073126
10302,10,302,1656,720,17,703,433,270,43.47826086956522,2.361111111111111,97.63888888888889,60.138888888888886,37.5
10303,10,303,1291,571,19,552,361,191,44.229279628195194,3.327495621716287,96.6725043782837,63.22241681260946,33.45008756567426
10304,10,304,1427,574,6,568,351,217,40.22424667133847,1.0452961672473868,98.95470383275261,61.14982578397212,37.80487804878049
10305,10,305,1706,776,3,773,509,264,45.48651817116061,0.3865979381443299,99.61340206185567,65.59278350515464,34.02061855670103
10306,10,306,2105,1003,28,975,588,387,47.648456057007124,2.7916251246261217,97.20837487537388,58.62412761714856,38.584247258225325
10307,10,307,1968,924,24,900,571,329,46.95121951219512,2.5974025974025974,97.40259740259741,61.79653679653679,35.60606060606061
10308,10,308,1435,710,18,692,404,288,49.47735191637631,2.535211267605634,97.46478873239437,56.901408450704224,40.563380281690144
10309,10,309,2063,933,11,922,562,360,45.225399903053805,1.1789924973204717,98.82100750267952,60.235798499464096,38.58520900321543
10310,10,310,1472,759,17,742,452,290,51.5625,2.2397891963109355,97.76021080368906,59.55204216073782,38.20816864295125
10311,10,311,1413,648,13,635,493,142,45.85987261146497,2.006172839506173,97.99382716049382,76.08024691358025,21.91358024691358
10312,10,312,1044,454,13,441,290,151,43.486590038314176,2.8634361233480177,97.13656387665198,63.87665198237885,33.259911894273124
10313,10,313,1483,540,13,527,363,164,36.412677006068776,2.4074074074074074,97.5925925925926,67.22222222222223,30.37037037037037
10314,10,314,1513,730,20,710,407,303,48.248512888301384,2.73972602739726,97.26027397260275,55.75342465753425,41.50684931506849
10315,10,315,1921,746,14,732,479,253,38.833940655908386,1.876675603217158,98.12332439678283,64.20911528150134,33.9142091152815
10316,10,316,1674,765,9,756,430,326,45.69892473118279,1.1764705882352942,98.82352941176471,56.209150326797385,42.61437908496732
10317,10,317,1821,867,19,848,511,337,47.61120263591433,2.1914648212226067,97.80853517877739,58.93886966551326,38.86966551326413
10318,10,318,1750,827,12,815,506,309,47.25714285714286,1.4510278113663846,98.54897218863361,61.18500604594922,37.363966142684404
10319,10,319,1966,974,16,958,576,382,49.542217700915565,1.642710472279261,98.35728952772074,59.13757700205339,39.21971252566735
10320,10,320,1724,902,19,883,549,334,52.320185614849194,2.106430155210643,97.89356984478935,60.86474501108648,37.028824833702885
10401,10,401,2006,975,29,946,520,426,48.60418743768694,2.9743589743589745,97.02564102564104,53.333333333333336,43.69230769230769
10402,10,402,1938,1013,26,987,554,433,52.270381836945305,2.566633761105627,97.43336623889437,54.689042448173744,42.744323790720635
10403,10,403,1694,817,14,803,428,375,48.22904368358914,1.7135862913096693,98.28641370869033,52.38678090575275,45.89963280293758
10404,10,404,2125,936,25,911,474,437,44.04705882352941,2.6709401709401708,97.32905982905983,50.641025641025635,46.68803418803419
10405,10,405,1996,1047,30,1017,577,440,52.45490981963928,2.865329512893983,97.134670487106,55.10983763132761,42.02483285577841
10406,10,406,2050,1028,38,990,506,484,50.146341463414636,3.6964980544747084,96.3035019455253,49.221789883268485,47.081712062256805
10407,10,407,1921,1040,30,1010,443,567,54.13846954711088,2.8846153846153846,97.11538461538461,42.59615384615385,54.51923076923077
10408,10,408,1704,903,18,885,405,480,52.99295774647887,1.9933554817275747,98.00664451827242,44.85049833887043,53.156146179402
10409,10,409,1762,829,11,818,422,396,47.04880817253122,1.3268998793727382,98.67310012062727,50.90470446320868,47.76839565741858
10410,10,410,1376,602,24,578,327,251,43.75,3.9867109634551494,96.01328903654485,54.31893687707641,41.69435215946844
10411,10,411,1396,818,17,801,367,434,58.59598853868195,2.078239608801956,97.92176039119805,44.86552567237164,53.0562347188264
10412,10,412,1607,750,25,725,401,324,46.670815183571875,3.3333333333333335,96.66666666666667,53.46666666666666,43.2
10413,10,413,1840,955,19,936,443,493,51.902173913043484,1.9895287958115182,98.01047120418848,46.38743455497382,51.62303664921466
10414,10,414,1881,1006,16,990,453,537,53.48219032429559,1.5904572564612325,98.40954274353876,45.029821073558644,53.37972166998012
10415,10,415,2182,1128,22,1106,545,561,51.69569202566453,1.950354609929078,98.04964539007092,48.315602836879435,49.734042553191486
10416,10,416,1734,888,10,878,403,475,51.21107266435986,1.1261261261261262,98.87387387387388,45.38288288288289,53.490990990990994
10417,10,417,1912,1128,19,1109,553,556,58.995815899581594,1.6843971631205674,98.31560283687944,49.02482269503546,49.29078014184397
10418,10,418,1242,772,18,754,368,386,62.15780998389694,2.33160621761658,97.66839378238342,47.66839378238342,50.0
10419,10,419,1585,912,16,896,436,460,57.53943217665615,1.7543859649122806,98.24561403508771,47.80701754385965,50.43859649122807
10501,10,501,1979,1105,33,1072,543,529,55.836280949974736,2.986425339366516,97.01357466063348,49.140271493212666,47.873303167420815
10502,10,502,2075,1115,20,1095,580,515,53.73493975903615,1.7937219730941705,98.20627802690582,52.01793721973094,46.18834080717489
10503,10,503,2077,1249,20,1229,588,641,60.13480982185845,1.6012810248198557,98.39871897518015,47.07766212970376,51.32105684547638
10504,10,504,2152,1230,21,1209,615,594,57.15613382899628,1.707317073170732,98.29268292682927,50.0,48.292682926829265
10505,10,505,1975,1059,19,1040,573,467,53.620253164556964,1.794145420207743,98.20585457979226,54.107648725212464,44.09820585457979
10506,10,506,1874,1084,12,1072,571,501,57.84418356456777,1.107011070110701,98.8929889298893,52.67527675276753,46.217712177121776
10507,10,507,1768,1072,30,1042,504,538,60.633484162895925,2.798507462686567,97.20149253731343,47.01492537313433,50.18656716417911
10508,10,508,1671,941,11,930,450,480,56.31358467983244,1.1689691817215728,98.83103081827844,47.82146652497343,51.009564293305
10509,10,509,1647,907,14,893,422,471,55.069823922282936,1.5435501653803747,98.45644983461963,46.52701212789416,51.929437706725466
10510,10,510,2051,1173,18,1155,551,604,57.191613846903955,1.5345268542199488,98.46547314578005,46.97357203751066,51.4919011082694
10511,10,511,2068,1108,30,1078,492,586,53.578336557059956,2.707581227436823,97.29241877256317,44.4043321299639,52.888086642599276
10512,10,512,1746,1007,27,980,472,508,57.67468499427262,2.6812313803376364,97.31876861966236,46.871896722939425,50.446871896722946
10513,10,513,1677,957,15,942,420,522,57.066189624329155,1.5673981191222568,98.43260188087774,43.8871473354232,54.54545454545454
10514,10,514,2112,1232,19,1213,553,660,58.333333333333336,1.5422077922077921,98.45779220779221,44.88636363636363,53.57142857142857
10515,10,515,2007,1102,11,1091,490,601,54.907822620827105,0.9981851179673321,99.00181488203266,44.46460980036298,54.53720508166969
10516,10,516,2104,1293,15,1278,572,706,61.45437262357415,1.160092807424594,98.83990719257541,44.238205723124516,54.601701469450894
10517,10,517,2083,1111,23,1088,464,624,53.33653384541527,2.07020702070207,97.92979297929793,41.764176417641764,56.165616561656165
10601,10,601,1679,811,16,795,505,290,48.30256104824301,1.972872996300863,98.02712700369914,62.26880394574599,35.75832305795315
10602,10,602,1959,914,16,898,569,329,46.65645737621235,1.75054704595186,98.24945295404814,62.25382932166303,35.99562363238512
10603,10,603,1937,953,17,936,585,351,49.199793495095506,1.7838405036726128,98.21615949632738,61.385099685204615,36.83105981112277
10604,10,604,1547,839,12,827,463,364,54.23400129282482,1.430274135876043,98.56972586412395,55.18474374255066,43.3849821215733
10605,10,605,1185,578,21,557,316,241,48.77637130801688,3.633217993079585,96.36678200692042,54.67128027681662,41.69550173010381
10606,10,606,2001,1033,19,1014,554,460,51.624187906046984,1.8393030009680542,98.16069699903196,53.63020329138431,44.53049370764763
10607,10,607,2065,1007,24,983,590,393,48.76513317191284,2.3833167825223436,97.61668321747766,58.58987090367428,39.026812313803376
10608,10,608,1666,773,20,753,451,302,46.398559423769505,2.58732212160414,97.41267787839585,58.34411384217335,39.06856403622251
10609,10,609,1609,840,20,820,456,364,52.20633934120572,2.380952380952381,97.61904761904762,54.285714285714285,43.333333333333336
10610,10,610,1914,1031,23,1008,540,468,53.866248693834905,2.2308438409311346,97.76915615906887,52.376333656644036,45.39282250242483
10611,10,611,1865,911,16,895,486,409,48.847184986595174,1.756311745334797,98.2436882546652,53.34796926454446,44.89571899012075
10612,10,612,1851,1048,17,1031,535,496,56.61804430037818,1.6221374045801527,98.37786259541986,51.04961832061069,47.32824427480916
10613,10,613,1875,985,21,964,495,469,52.53333333333333,2.131979695431472,97.86802030456853,50.25380710659898,47.61421319796954
10614,10,614,2009,1116,18,1098,515,583,55.55002488800398,1.6129032258064515,98.38709677419355,46.14695340501792,52.24014336917563
10615,10,615,1898,939,14,925,581,344,49.47312961011591,1.4909478168264112,98.50905218317358,61.87433439829606,36.63471778487753
10616,10,616,1918,909,28,881,534,347,47.393117831074036,3.08030803080308,96.91969196919692,58.745874587458744,38.173817381738175
10617,10,617,1864,797,18,779,479,300,42.757510729613735,2.258469259723965,97.74153074027603,60.10037641154329,37.641154328732746
10618,10,618,1855,790,23,767,472,295,42.58760107816711,2.911392405063291,97.0886075949367,59.74683544303797,37.34177215189873
11101,11,101,1079,571,10,561,198,363,52.91936978683967,1.7513134851138354,98.24868651488616,34.676007005253936,63.57267950963222
11102,11,102,1034,618,7,611,108,503,59.767891682785304,1.132686084142395,98.86731391585761,17.475728155339805,81.3915857605178
11103,11,103,1059,637,4,633,183,450,60.15108593012276,0.6279434850863422,99.37205651491365,28.728414442700156,70.6436420722135
11104,11,104,1167,615,13,602,244,358,52.69922879177378,2.113821138211382,97.88617886178862,39.67479674796748,58.211382113821145
11105,11,105,983,571,6,565,122,443,58.08748728382503,1.0507880910683012,98.9492119089317,21.36602451838879,77.5831873905429
11106,11,106,1093,571,10,561,290,271,52.24153705397987,1.7513134851138354,98.24868651488616,50.78809106830122,47.46059544658494
11107,11,107,894,388,11,377,182,195,43.40044742729307,2.8350515463917527,97.16494845360825,46.90721649484536,50.25773195876289
11108,11,108,1055,472,10,462,227,235,44.739336492891,2.11864406779661,97.88135593220339,48.09322033898305,49.78813559322034
11109,11,109,1067,548,1,547,287,260,51.35895032802249,0.18248175182481752,99.81751824817519,52.37226277372263,47.44525547445255
11110,11,110,1137,499,1,498,230,268,43.88742304309587,0.2004008016032064,99.79959919839679,46.09218436873748,53.707414829659314
11111,11,111,999,533,4,529,210,319,53.35335335335335,0.7504690431519699,99.24953095684803,39.39962476547842,59.849906191369605
11112,11,112,1236,564,7,557,314,243,45.63106796116505,1.2411347517730498,98.75886524822694,55.673758865248224,43.08510638297872
11113,11,113,893,411,4,407,205,202,46.02463605823068,0.9732360097323601,99.02676399026764,49.87834549878345,49.148418491484186
11114,11,114,998,502,7,495,252,243,50.300601202404806,1.394422310756972,98.60557768924303,50.199203187250994,48.40637450199203
11115,11,115,914,463,9,454,203,251,50.65645514223195,1.9438444924406046,98.0561555075594,43.84449244060475,54.21166306695464
11116,11,116,986,537,9,528,251,277,54.462474645030426,1.675977653631285,98.32402234636871,46.74115456238361,51.5828677839851
11117,11,117,1117,480,10,470,281,189,42.972247090420765,2.083333333333333,97.91666666666666,58.54166666666667,39.375
11118,11,118,1044,492,29,463,240,223,47.12643678160919,5.894308943089431,94.10569105691057,48.78048780487805,45.32520325203252
11119,11,119,1304,598,14,584,347,237,45.858895705521476,2.341137123745819,97.65886287625418,58.026755852842804,39.63210702341137
11120,11,120,1347,566,22,544,305,239,42.01930215293244,3.8869257950530036,96.113074204947,53.88692579505301,42.226148409893995
11121,11,121,1066,507,7,500,294,206,47.5609756097561,1.3806706114398422,98.61932938856016,57.98816568047337,40.63116370808679
11122,11,122,1245,653,12,641,340,301,52.44979919678715,1.8376722817764166,98.16232771822358,52.06738131699847,46.094946401225116
11123,11,123,1223,644,4,640,289,351,52.6573998364677,0.6211180124223602,99.37888198757764,44.87577639751553,54.503105590062106
11124,11,124,1050,489,10,479,266,213,46.57142857142857,2.044989775051125,97.95501022494888,54.396728016359916,43.558282208588956
11125,11,125,1229,603,11,592,314,278,49.064279902359644,1.8242122719734661,98.17578772802653,52.072968490878935,46.1028192371476
11126,11,126,1175,542,14,528,291,237,46.12765957446808,2.5830258302583027,97.41697416974169,53.69003690036901,43.7269372693727
11127,11,127,1211,634,14,620,284,336,52.353426919900905,2.2082018927444795,97.79179810725552,44.79495268138801,52.99684542586751
11201,11,201,967,467,3,464,160,304,48.293691830403304,0.6423982869379015,99.3576017130621,34.26124197002141,65.0963597430407
11202,11,202,1273,675,23,652,294,358,53.024351924587585,3.4074074074074074,96.5925925925926,43.55555555555555,53.03703703703704
11203,11,203,1244,632,7,625,284,341,50.80385852090033,1.1075949367088607,98.89240506329115,44.936708860759495,53.95569620253164
11204,11,204,1094,525,9,516,262,254,47.98903107861061,1.7142857142857144,98.28571428571429,49.904761904761905,48.38095238095238
11205,11,205,1146,552,3,549,282,267,48.167539267015705,0.5434782608695652,99.45652173913044,51.08695652173913,48.369565217391305
11206,11,206,1138,552,12,540,288,252,48.50615114235501,2.1739130434782608,97.82608695652173,52.17391304347826,45.65217391304348
11207,11,207,1059,510,8,502,282,220,48.1586402266289,1.5686274509803921,98.4313725490196,55.294117647058826,43.13725490196079
11208,11,208,878,391,2,389,227,162,44.533029612756266,0.5115089514066496,99.48849104859335,58.05626598465473,41.432225063938624
11209,11,209,960,476,10,466,267,199,49.583333333333336,2.100840336134454,97.89915966386555,56.09243697478992,41.806722689075634
11210,11,210,1178,625,11,614,231,383,53.0560271646859,1.76,98.24000000000001,36.96,61.28
11211,11,211,1065,577,2,575,185,390,54.178403755868544,0.34662045060658575,99.65337954939342,32.06239168110919,67.59098786828423
11212,11,212,1116,561,13,548,280,268,50.26881720430107,2.3172905525846703,97.68270944741533,49.9108734402852,47.771836007130126
11213,11,213,1377,752,12,740,358,382,54.61147421931736,1.5957446808510638,98.40425531914893,47.6063829787234,50.797872340425535
11214,11,214,915,497,2,495,243,252,54.31693989071038,0.4024144869215292,99.59758551307847,48.89336016096579,50.70422535211267
11215,11,215,988,447,8,439,239,200,45.24291497975709,1.7897091722595078,98.2102908277405,53.46756152125279,44.742729306487696
11216,11,216,1367,793,21,772,341,431,58.01024140453548,2.648171500630517,97.35182849936949,43.00126103404792,54.35056746532156
11217,11,217,1184,621,14,607,288,319,52.44932432432432,2.254428341384863,97.74557165861513,46.3768115942029,51.368760064412236
11218,11,218,1635,799,12,787,420,367,48.86850152905199,1.5018773466833542,98.49812265331664,52.56570713391739,45.93241551939925
11219,11,219,993,535,4,531,228,303,53.87713997985901,0.7476635514018692,99.25233644859813,42.61682242990654,56.63551401869159
11220,11,220,1128,656,2,654,253,401,58.156028368794324,0.3048780487804878,99.6951219512195,38.56707317073171,61.12804878048781
11221,11,221,1193,678,8,670,356,314,56.83151718357083,1.1799410029498525,98.82005899705014,52.50737463126843,46.312684365781706
11222,11,222,1286,669,22,647,299,348,52.02177293934681,3.288490284005979,96.71150971599403,44.69357249626308,52.01793721973094
11223,11,223,1157,611,29,582,308,274,52.80898876404494,4.746317512274959,95.25368248772504,50.40916530278232,44.84451718494272
11224,11,224,1420,777,9,768,347,421,54.718309859154935,1.1583011583011582,98.84169884169884,44.65894465894466,54.18275418275418
11225,11,225,1218,636,23,613,330,283,52.21674876847291,3.6163522012578615,96.38364779874213,51.886792452830186,44.49685534591195
11226,11,226,1250,711,28,683,323,360,56.879999999999995,3.938115330520394,96.0618846694796,45.42897327707454,50.63291139240506
11227,11,227,1232,697,21,676,379,297,56.574675324675326,3.012912482065997,96.987087517934,54.375896700143464,42.61119081779053
11228,11,228,1175,657,10,647,306,341,55.91489361702128,1.5220700152207,98.4779299847793,46.57534246575342,51.90258751902588
11301,11,301,1165,594,26,568,308,260,50.987124463519315,4.377104377104377,95.62289562289563,51.85185185185185,43.77104377104377
11302,11,302,917,525,10,515,255,260,57.25190839694656,1.9047619047619049,98.09523809523809,48.57142857142857,49.523809523809526
11303,11,303,1005,448,8,440,259,181,44.5771144278607,1.7857142857142856,98.21428571428571,57.8125,40.401785714285715
11304,11,304,1295,644,21,623,358,265,49.72972972972973,3.260869565217391,96.73913043478261,55.590062111801245,41.14906832298137
11305,11,305,1173,624,12,612,322,290,53.196930946291566,1.9230769230769231,98.07692307692307,51.60256410256411,46.47435897435898
11306,11,306,1430,679,11,668,384,284,47.48251748251748,1.6200294550810017,98.37997054491899,56.553755522827686,41.82621502209131
11307,11,307,1717,911,19,892,404,488,53.057658707047175,2.0856201975850714,97.91437980241493,44.34687156970362,53.567508232711305
11308,11,308,1366,736,18,718,387,331,53.879941434846266,2.4456521739130435,97.55434782608695,52.58152173913043,44.97282608695652
11309,11,309,1225,604,14,590,356,234,49.306122448979586,2.3178807947019866,97.68211920529801,58.94039735099338,38.741721854304636
11310,11,310,1283,655,9,646,338,308,51.05222135619641,1.3740458015267176,98.62595419847328,51.6030534351145,47.02290076335878
11311,11,311,1173,560,9,551,317,234,47.74083546462063,1.607142857142857,98.39285714285714,56.607142857142854,41.785714285714285
11312,11,312,1064,474,3,471,230,241,44.54887218045113,0.6329113924050633,99.36708860759494,48.52320675105485,50.84388185654009
11313,11,313,1332,732,7,725,399,326,54.95495495495496,0.9562841530054645,99.04371584699454,54.50819672131148,44.53551912568306
11314,11,314,1258,659,20,639,365,274,52.38473767885533,3.0349013657056148,96.96509863429439,55.38694992412747,41.578148710166914
11315,11,315,1207,741,9,732,368,364,61.39188069594035,1.214574898785425,98.78542510121457,49.662618083670715,49.122807017543856
11316,11,316,1106,544,11,533,279,254,49.186256781193485,2.0220588235294117,97.97794117647058,51.28676470588235,46.69117647058824
11317,11,317,799,442,11,431,229,202,55.319148936170215,2.48868778280543,97.51131221719457,51.80995475113123,45.70135746606335
11318,11,318,1312,671,12,659,355,304,51.143292682926834,1.7883755588673622,98.21162444113264,52.90611028315947,45.30551415797318
11319,11,319,1085,482,13,469,255,214,44.423963133640555,2.6970954356846475,97.30290456431536,52.9045643153527,44.398340248962654
11320,11,320,1034,470,12,458,228,230,45.45454545454545,2.553191489361702,97.44680851063829,48.51063829787234,48.93617021276596
11321,11,321,1052,488,10,478,257,221,46.38783269961977,2.0491803278688523,97.95081967213115,52.66393442622951,45.28688524590164
11322,11,322,1180,590,14,576,312,264,50.0,2.3728813559322033,97.6271186440678,52.88135593220339,44.74576271186441
11323,11,323,1301,640,14,626,334,292,49.19292851652575,2.1875,97.8125,52.1875,45.625
11324,11,324,975,467,14,453,256,197,47.8974358974359,2.9978586723768736,97.00214132762312,54.81798715203426,42.184154175588866
11325,11,325,1305,582,13,569,311,258,44.59770114942529,2.2336769759450172,97.76632302405498,53.43642611683849,44.329896907216494
11326,11,326,1728,671,15,656,305,351,38.83101851851852,2.235469448584203,97.7645305514158,45.45454545454545,52.309985096870335
11327,11,327,1218,608,31,577,306,271,49.917898193760266,5.098684210526316,94.90131578947368,50.32894736842105,44.57236842105263
11328,11,328,1329,743,19,724,362,362,55.90669676448458,2.557200538358008,97.442799461642,48.721399730821,48.721399730821
11329,11,329,1293,621,17,604,304,300,48.027842227378194,2.737520128824477,97.26247987117553,48.953301127214175,48.309178743961354
11401,11,401,1200,575,25,550,291,259,47.91666666666667,4.3478260869565215,95.65217391304348,50.60869565217392,45.04347826086956
11402,11,402,1231,680,15,665,336,329,55.239642567018684,2.2058823529411766,97.79411764705883,49.411764705882355,48.38235294117647
11403,11,403,1341,659,8,651,331,320,49.142431021625654,1.2139605462822458,98.78603945371776,50.22761760242792,48.558421851289836
11404,11,404,1019,556,14,542,256,286,54.563297350343476,2.5179856115107913,97.48201438848922,46.043165467625904,51.438848920863315
11405,11,405,1171,548,8,540,296,244,46.79760888129804,1.4598540145985401,98.54014598540147,54.01459854014598,44.52554744525548
11406,11,406,1307,663,16,647,325,322,50.726855394032135,2.413273001508296,97.5867269984917,49.01960784313725,48.56711915535445
11407,11,407,1341,715,26,689,334,355,53.318419090231174,3.6363636363636362,96.36363636363636,46.71328671328671,49.65034965034965
11408,11,408,1307,591,26,565,273,292,45.21805661820964,4.39932318104907,95.60067681895093,46.192893401015226,49.407783417935704
11409,11,409,1196,593,11,582,318,264,49.5819397993311,1.854974704890388,98.1450252951096,53.62563237774031,44.51939291736931
11410,11,410,1254,608,22,586,317,269,48.484848484848484,3.618421052631579,96.38157894736842,52.13815789473685,44.243421052631575
11411,11,411,1544,710,17,693,333,360,45.984455958549226,2.3943661971830985,97.60563380281691,46.901408450704224,50.70422535211267
11412,11,412,957,473,11,462,209,253,49.42528735632184,2.3255813953488373,97.67441860465115,44.18604651162791,53.48837209302325
11413,11,413,1498,749,17,732,389,343,50.0,2.2696929238985315,97.73030707610147,51.93591455273698,45.794392523364486
11414,11,414,1221,577,9,568,272,296,47.25634725634726,1.559792027729636,98.44020797227037,47.14038128249567,51.2998266897747
11415,11,415,1312,716,35,681,341,340,54.57317073170732,4.888268156424581,95.11173184357543,47.625698324022345,47.486033519553075
11416,11,416,1345,707,22,685,342,343,52.56505576208178,3.1117397454031117,96.88826025459689,48.373408769448375,48.51485148514851
11417,11,417,1334,654,20,634,335,299,49.02548725637181,3.058103975535168,96.94189602446484,51.223241590214066,45.718654434250766
11418,11,418,1256,647,12,635,350,285,51.51273885350318,1.8547140649149922,98.145285935085,54.09582689335394,44.04945904173106
11419,11,419,1263,636,11,625,328,297,50.3562945368171,1.729559748427673,98.27044025157232,51.57232704402516,46.69811320754717
11420,11,420,1521,785,26,759,361,398,51.610782380013156,3.3121019108280256,96.68789808917198,45.98726114649681,50.70063694267516
11421,11,421,1206,566,27,539,287,252,46.93200663349917,4.770318021201414,95.22968197879858,50.70671378091873,44.522968197879855
11422,11,422,1300,661,14,647,354,293,50.84615384615384,2.118003025718608,97.88199697428139,53.5552193645991,44.3267776096823
11423,11,423,1403,712,18,694,374,320,50.74839629365645,2.528089887640449,97.47191011235955,52.52808988764045,44.9438202247191
11424,11,424,1130,556,14,542,312,230,49.20353982300885,2.5179856115107913,97.48201438848922,56.11510791366906,41.36690647482014
11425,11,425,1219,656,12,644,295,349,53.814602132895814,1.8292682926829267,98.17073170731707,44.96951219512195,53.20121951219512
11426,11,426,970,486,6,480,250,230,50.103092783505154,1.2345679012345678,98.76543209876543,51.440329218106996,47.325102880658434
11427,11,427,1160,600,11,589,297,292,51.724137931034484,1.8333333333333333,98.16666666666667,49.5,48.66666666666667
11428,11,428,975,534,12,522,280,242,54.769230769230774,2.247191011235955,97.75280898876404,52.43445692883895,45.31835205992509
11501,11,501,1303,541,8,533,276,257,41.51957022256332,1.478743068391867,98.52125693160814,51.01663585951941,47.504621072088725
11502,11,502,1573,787,18,769,459,310,50.03178639542276,2.2871664548919948,97.712833545108,58.32274459974587,39.39008894536214
11503,11,503,1343,700,16,684,413,271,52.12211466865227,2.2857142857142856,97.71428571428571,59.0,38.714285714285715
11504,11,504,1057,471,11,460,247,213,44.5600756859035,2.335456475583864,97.66454352441613,52.4416135881104,45.22292993630573
11505,11,505,1067,547,8,539,311,228,51.26522961574508,1.4625228519195612,98.53747714808044,56.855575868372945,41.681901279707496
11506,11,506,1126,546,11,535,301,234,48.49023090586146,2.0146520146520146,97.98534798534799,55.12820512820513,42.857142857142854
11507,11,507,958,496,19,477,287,190,51.774530271398746,3.8306451612903225,96.16935483870968,57.86290322580645,38.306451612903224
11508,11,508,1430,748,15,733,400,333,52.307692307692314,2.0053475935828877,97.99465240641712,53.475935828877006,44.518716577540104
11509,11,509,1459,737,18,719,375,344,50.51405071967101,2.4423337856173677,97.55766621438264,50.88195386702849,46.675712347354136
11510,11,510,1267,646,13,633,333,300,50.98658247829518,2.0123839009287927,97.9876160990712,51.547987616099064,46.43962848297213
11511,11,511,1064,568,11,557,312,245,53.383458646616546,1.936619718309859,98.06338028169014,54.929577464788736,43.13380281690141
11512,11,512,1242,666,9,657,327,330,53.62318840579711,1.3513513513513513,98.64864864864865,49.0990990990991,49.549549549549546
11513,11,513,1216,567,12,555,291,264,46.62828947368421,2.1164021164021163,97.88359788359789,51.32275132275132,46.56084656084656
11514,11,514,1298,582,7,575,307,268,44.8382126348228,1.202749140893471,98.79725085910653,52.749140893470795,46.04810996563574
11515,11,515,1125,579,15,564,321,243,51.46666666666667,2.5906735751295336,97.40932642487047,55.44041450777202,41.968911917098445
11516,11,516,1090,564,12,552,290,262,51.74311926605505,2.127659574468085,97.87234042553192,51.41843971631206,46.45390070921986
11517,11,517,1063,580,14,566,287,279,54.562558795860774,2.413793103448276,97.58620689655172,49.48275862068965,48.10344827586207
11518,11,518,1259,593,22,571,315,256,47.10087370929309,3.709949409780776,96.29005059021922,53.119730185497474,43.17032040472175
11519,11,519,1476,838,25,813,308,505,56.77506775067751,2.983293556085919,97.01670644391407,36.754176610978526,60.26252983293556
11520,11,520,1264,744,22,722,284,438,58.86075949367089,2.956989247311828,97.04301075268818,38.17204301075269,58.87096774193549
11521,11,521,1345,694,29,665,298,367,51.59851301115241,4.178674351585014,95.82132564841498,42.93948126801153,52.88184438040345
11522,11,522,1051,571,15,556,257,299,54.329210275927686,2.626970227670753,97.37302977232925,45.008756567425564,52.364273204903675
11523,11,523,1325,694,5,689,339,350,52.37735849056604,0.7204610951008645,99.27953890489914,48.84726224783862,50.43227665706051
11524,11,524,1269,650,14,636,346,290,51.2214342001576,2.1538461538461537,97.84615384615385,53.230769230769226,44.61538461538462
11525,11,525,1269,629,22,607,328,279,49.5665878644602,3.4976152623211445,96.50238473767885,52.14626391096979,44.35612082670906
11526,11,526,1286,678,20,658,294,364,52.72161741835147,2.949852507374631,97.05014749262537,43.36283185840708,53.687315634218294
11527,11,527,1139,583,13,570,275,295,51.18525021949078,2.2298456260720414,97.77015437392797,47.16981132075472,50.60034305317325
11528,11,528,1283,672,21,651,310,341,52.37724084177708,3.125,96.875,46.13095238095239,50.74404761904761
11601,11,601,1269,660,19,641,324,317,52.00945626477541,2.878787878787879,97.12121212121212,49.09090909090909,48.03030303030303
11602,11,602,1299,704,22,682,303,379,54.195535026943794,3.125,96.875,43.03977272727273,53.83522727272727
11603,11,603,1083,555,18,537,289,248,51.24653739612188,3.2432432432432434,96.75675675675676,52.072072072072075,44.68468468468468
11604,11,604,1006,515,13,502,247,255,51.192842942345926,2.524271844660194,97.47572815533981,47.96116504854369,49.51456310679612
11605,11,605,1228,647,13,634,308,326,52.68729641693811,2.009273570324575,97.99072642967542,47.60432766615147,50.38639876352396
11606,11,606,1173,593,12,581,298,283,50.5541346973572,2.0236087689713322,97.97639123102867,50.252951096121414,47.72344013490725
11607,11,607,1222,628,18,610,318,292,51.391162029459906,2.8662420382165608,97.13375796178345,50.63694267515923,46.496815286624205
11608,11,608,1087,547,14,533,267,266,50.321987120515175,2.5594149908592323,97.44058500914076,48.81170018281536,48.62888482632541
11609,11,609,1347,726,17,709,359,350,53.89755011135857,2.3415977961432506,97.65840220385675,49.44903581267218,48.209366391184574
11610,11,610,1395,679,11,668,377,291,48.67383512544803,1.6200294550810017,98.37997054491899,55.52282768777614,42.857142857142854
11611,11,611,1628,840,44,796,435,361,51.5970515970516,5.238095238095238,94.76190476190476,51.78571428571429,42.97619047619048
11612,11,612,1290,604,13,591,291,300,46.821705426356594,2.152317880794702,97.84768211920529,48.17880794701987,49.668874172185426
11613,11,613,1249,723,20,703,287,416,57.886309047237795,2.7662517289073305,97.23374827109267,39.695712309820195,57.53803596127247
11614,11,614,1174,731,11,720,289,431,62.265758091993185,1.5047879616963065,98.49521203830369,39.53488372093023,58.96032831737345
11615,11,615,1275,712,14,698,349,349,55.84313725490196,1.9662921348314606,98.03370786516854,49.01685393258427,49.01685393258427
11616,11,616,1815,961,6,955,487,468,52.94765840220386,0.6243496357960457,99.37565036420395,50.676378772112386,48.69927159209157
11617,11,617,981,549,7,542,253,289,55.96330275229357,1.2750455373406193,98.72495446265937,46.083788706739526,52.64116575591985
11618,11,618,1113,567,13,554,260,294,50.943396226415096,2.2927689594356258,97.70723104056437,45.85537918871252,51.85185185185185
11619,11,619,1174,670,9,661,317,344,57.06984667802385,1.3432835820895521,98.65671641791045,47.3134328358209,51.34328358208955
11620,11,620,1059,575,17,558,239,319,54.296506137865904,2.9565217391304346,97.04347826086956,41.56521739130435,55.47826086956522
11621,11,621,1461,876,14,862,389,473,59.95893223819302,1.5981735159817352,98.40182648401826,44.40639269406393,53.99543378995434
11622,11,622,1302,744,19,725,319,406,57.14285714285714,2.553763440860215,97.44623655913979,42.876344086021504,54.56989247311827
11623,11,623,1181,714,13,701,298,403,60.457239627434376,1.8207282913165268,98.17927170868347,41.73669467787115,56.44257703081232
11624,11,624,959,527,17,510,215,295,54.95307612095933,3.225806451612903,96.7741935483871,40.79696394686907,55.97722960151803
11625,11,625,1158,709,15,694,293,401,61.226252158894646,2.1156558533145273,97.88434414668548,41.32581100141044,56.558533145275035
11626,11,626,1281,781,13,768,347,421,60.967993754879004,1.6645326504481435,98.33546734955185,44.43021766965429,53.90524967989757
11627,11,627,1399,775,16,759,299,460,55.39671193709793,2.064516129032258,97.93548387096774,38.58064516129032,59.354838709677416
11628,11,628,1218,687,11,676,263,413,56.40394088669951,1.6011644832605532,98.39883551673945,38.28238719068413,60.11644832605532
11629,11,629,1144,641,19,622,278,344,56.03146853146853,2.9641185647425896,97.03588143525741,43.36973478939157,53.66614664586583
11630,11,630,963,632,6,626,217,409,65.6282450674974,0.949367088607595,99.0506329113924,34.335443037974684,64.71518987341773
12101,12,101,1186,574,4,570,292,278,48.397976391231026,0.6968641114982579,99.30313588850174,50.87108013937283,48.43205574912892
12102,12,102,903,417,10,407,256,151,46.179401993355484,2.3980815347721824,97.60191846522783,61.39088729016786,36.21103117505996
12103,12,103,849,386,6,380,245,135,45.46525323910483,1.5544041450777202,98.44559585492227,63.47150259067358,34.97409326424871
12104,12,104,914,460,8,452,264,188,50.32822757111597,1.7391304347826086,98.26086956521739,57.391304347826086,40.869565217391305
12105,12,105,816,355,2,353,211,142,43.504901960784316,0.5633802816901409,99.43661971830986,59.436619718309856,40.0
12106,12,106,1142,551,9,542,282,260,48.24868651488616,1.6333938294010888,98.36660617059891,51.17967332123412,47.186932849364794
12107,12,107,892,508,4,504,242,262,56.95067264573991,0.7874015748031495,99.21259842519686,47.63779527559055,51.574803149606296
12108,12,108,1223,676,12,664,387,277,55.2739165985282,1.7751479289940828,98.22485207100591,57.24852071005917,40.976331360946745
12109,12,109,910,399,4,395,210,185,43.84615384615385,1.0025062656641603,98.99749373433583,52.63157894736842,46.365914786967416
12110,12,110,934,402,7,395,208,187,43.0406852248394,1.7412935323383085,98.2587064676617,51.741293532338304,46.517412935323385
12111,12,111,1183,593,4,589,324,265,50.12679628064244,0.6745362563237773,99.32546374367622,54.63743676222597,44.68802698145025
12112,12,112,1232,552,3,549,304,245,44.8051948051948,0.5434782608695652,99.45652173913044,55.072463768115945,44.38405797101449
12113,12,113,671,317,2,315,183,132,47.24292101341281,0.6309148264984227,99.36908517350159,57.72870662460568,41.6403785488959
12114,12,114,1747,801,12,789,499,290,45.850028620492274,1.4981273408239701,98.50187265917603,62.297128589263416,36.20474406991261
12115,12,115,674,335,5,330,179,151,49.70326409495549,1.4925373134328357,98.50746268656717,53.43283582089552,45.07462686567164
12116,12,116,1071,519,8,511,305,206,48.4593837535014,1.5414258188824663,98.45857418111753,58.76685934489403,39.691714836223504
12117,12,117,1587,677,11,666,355,311,42.6591052299937,1.6248153618906942,98.3751846381093,52.437223042836045,45.937961595273265
12118,12,118,1470,570,14,556,302,254,38.775510204081634,2.456140350877193,97.54385964912281,52.98245614035088,44.56140350877193
12119,12,119,1317,691,12,679,359,320,52.467729688686404,1.7366136034732274,98.26338639652677,51.953690303907386,46.30969609261939
12120,12,120,1360,674,8,666,317,349,49.55882352941177,1.1869436201780417,98.81305637982196,47.032640949554896,51.780415430267055
12121,12,121,1189,554,9,545,309,236,46.59377628259041,1.6245487364620936,98.37545126353791,55.77617328519856,42.59927797833935
12122,12,122,1477,711,6,705,383,322,48.13811780636425,0.8438818565400843,99.15611814345992,53.867791842475384,45.28832630098453
12123,12,123,1511,673,7,666,361,305,44.54003970880212,1.040118870728083,98.95988112927192,53.64041604754829,45.31946508172363
12124,12,124,1048,481,8,473,282,191,45.896946564885496,1.6632016632016633,98.33679833679834,58.62785862785863,39.70893970893971
12125,12,125,1238,557,8,549,323,226,44.99192245557351,1.436265709156194,98.56373429084381,57.989228007181325,40.57450628366247
12126,12,126,1160,565,10,555,301,254,48.706896551724135,1.7699115044247788,98.23008849557522,53.27433628318584,44.955752212389385
12201,12,201,1096,602,1,601,444,157,54.92700729927007,0.16611295681063123,99.83388704318938,73.75415282392026,26.079734219269103
12202,12,202,1173,537,6,531,323,208,45.78005115089514,1.1173184357541899,98.88268156424581,60.14897579143389,38.733705772811916
12203,12,203,1418,715,4,711,335,376,50.423131170662906,0.5594405594405595,99.44055944055944,46.85314685314685,52.58741258741259
12204,12,204,763,410,2,408,223,185,53.73525557011796,0.4878048780487805,99.51219512195122,54.390243902439025,45.1219512195122
12205,12,205,782,438,5,433,215,218,56.01023017902813,1.141552511415525,98.85844748858447,49.08675799086758,49.77168949771689
12206,12,206,1211,457,0,457,232,225,37.737407101568955,0.0,100.0,50.76586433260394,49.23413566739606
12207,12,207,1458,733,17,716,494,222,50.27434842249657,2.3192360163710775,97.68076398362892,67.39427012278308,30.286493860845837
12208,12,208,1309,674,28,646,428,218,51.48968678380443,4.154302670623145,95.84569732937686,63.50148367952523,32.34421364985163
12209,12,209,1250,542,5,537,355,182,43.36,0.9225092250922509,99.07749077490774,65.49815498154982,33.579335793357934
12210,12,210,1466,703,2,701,442,259,47.953615279672576,0.2844950213371266,99.71550497866288,62.87339971550497,36.84210526315789
12211,12,211,1227,605,9,596,358,238,49.30725346373268,1.487603305785124,98.51239669421487,59.17355371900827,39.33884297520661
12212,12,212,1657,790,7,783,480,303,47.67652383826192,0.8860759493670887,99.1139240506329,60.75949367088608,38.35443037974684
12213,12,213,1647,802,14,788,517,271,48.69459623557984,1.7456359102244388,98.25436408977556,64.46384039900249,33.790523690773064
12214,12,214,1079,572,13,559,344,215,53.01204819277109,2.272727272727273,97.72727272727273,60.13986013986013,37.58741258741259
12215,12,215,1443,720,8,712,419,293,49.8960498960499,1.1111111111111112,98.88888888888889,58.19444444444445,40.69444444444444
12216,12,216,1576,749,8,741,466,275,47.525380710659896,1.0680907877169559,98.93190921228305,62.21628838451269,36.715620827770366
12217,12,217,1414,677,7,670,379,291,47.878359264497874,1.03397341211226,98.96602658788774,55.98227474150664,42.98375184638109
12218,12,218,1049,409,5,404,240,164,38.989513822688274,1.2224938875305624,98.77750611246944,58.679706601467,40.09779951100245
12219,12,219,1106,539,0,539,229,310,48.734177215189874,0.0,100.0,42.486085343228204,57.5139146567718
12220,12,220,1325,555,13,542,394,148,41.88679245283019,2.3423423423423424,97.65765765765767,70.990990990991,26.666666666666668
12221,12,221,1467,656,5,651,395,256,44.7171097477846,0.7621951219512195,99.23780487804879,60.213414634146346,39.02439024390244
12222,12,222,983,423,6,417,224,193,43.03153611393693,1.4184397163120568,98.58156028368793,52.95508274231678,45.62647754137116
12223,12,223,584,327,1,326,85,241,55.9931506849315,0.3058103975535168,99.69418960244649,25.993883792048926,73.70030581039755
12224,12,224,354,184,1,183,139,44,51.9774011299435,0.5434782608695652,99.45652173913044,75.54347826086956,23.91304347826087
12225,12,225,1179,543,2,541,320,221,46.0559796437659,0.3683241252302026,99.6316758747698,58.93186003683242,40.699815837937386
12301,12,301,1536,952,19,933,602,331,61.979166666666664,1.9957983193277309,98.00420168067227,63.23529411764706,34.76890756302521
12302,12,302,1010,574,6,568,375,193,56.83168316831683,1.0452961672473868,98.95470383275261,65.33101045296166,33.62369337979094
12303,12,303,1134,662,17,645,463,182,58.377425044091716,2.56797583081571,97.43202416918429,69.93957703927492,27.492447129909365
12304,12,304,980,455,3,452,279,173,46.42857142857143,0.6593406593406593,99.34065934065934,61.31868131868132,38.02197802197802
12305,12,305,1405,771,10,761,486,275,54.87544483985766,1.297016861219196,98.70298313878081,63.035019455252915,35.66796368352789
12306,12,306,1392,807,5,802,558,244,57.974137931034484,0.6195786864931847,99.38042131350682,69.14498141263941,30.235439900867412
12307,12,307,1395,809,3,806,574,232,57.992831541218635,0.3708281829419036,99.6291718170581,70.95179233621755,28.677379480840543
12308,12,308,1274,664,7,657,398,259,52.119309262166404,1.0542168674698795,98.94578313253012,59.93975903614458,39.006024096385545
12309,12,309,1340,681,8,673,453,220,50.82089552238806,1.1747430249632893,98.82525697503671,66.51982378854625,32.305433186490454
12310,12,310,1114,650,10,640,424,216,58.34829443447038,1.5384615384615385,98.46153846153847,65.23076923076923,33.23076923076923
12311,12,311,1258,624,10,614,410,204,49.60254372019078,1.6025641025641024,98.3974358974359,65.7051282051282,32.69230769230769
12312,12,312,1416,844,18,826,541,285,59.6045197740113,2.132701421800948,97.86729857819904,64.0995260663507,33.76777251184834
12313,12,313,1262,642,6,636,363,273,50.871632329635496,0.9345794392523363,99.06542056074767,56.54205607476636,42.523364485981304
12314,12,314,1824,999,15,984,657,327,54.76973684210527,1.5015015015015014,98.49849849849849,65.76576576576578,32.732732732732735
12315,12,315,1249,675,9,666,379,287,54.04323458767014,1.3333333333333335,98.66666666666667,56.148148148148145,42.51851851851852
12316,12,316,1674,897,15,882,560,322,53.584229390681,1.6722408026755853,98.32775919732441,62.430323299888514,35.8974358974359
12317,12,317,1702,877,9,868,580,288,51.527614571092826,1.0262257696693273,98.97377423033066,66.1345496009122,32.839224629418474
12318,12,318,1197,709,8,701,359,342,59.23141186299081,1.1283497884344147,98.8716502115656,50.634696755994355,48.23695345557123
12319,12,319,1605,871,14,857,618,239,54.26791277258567,1.6073478760045925,98.3926521239954,70.95292766934558,27.439724454649827
12320,12,320,960,482,4,478,323,155,50.208333333333336,0.8298755186721992,99.1701244813278,67.01244813278008,32.15767634854772
12321,12,321,1294,643,10,633,422,211,49.69088098918083,1.5552099533437014,98.4447900466563,65.6298600311042,32.8149300155521
12322,12,322,1568,819,10,809,524,285,52.23214285714286,1.221001221001221,98.77899877899878,63.98046398046397,34.798534798534796
12323,12,323,1117,649,5,644,258,386,58.10205908683975,0.7704160246533128,99.22958397534669,39.753466872110934,59.47611710323575
12324,12,324,254,127,0,127,23,104,50.0,0.0,100.0,18.11023622047244,81.88976377952756
12401,12,401,1383,753,9,744,476,268,54.4468546637744,1.1952191235059761,98.80478087649402,63.213811420982736,35.59096945551129
12402,12,402,1218,632,9,623,448,175,51.88834154351396,1.4240506329113924,98.57594936708861,70.88607594936708,27.689873417721518
12403,12,403,777,391,1,390,250,140,50.32175032175032,0.2557544757033248,99.74424552429667,63.9386189258312,35.80562659846547
12404,12,404,1521,722,13,709,558,151,47.46877054569362,1.8005540166204987,98.19944598337949,77.28531855955679,20.914127423822716
12405,12,405,1618,818,13,805,579,226,50.55624227441285,1.5892420537897312,98.41075794621027,70.78239608801957,27.628361858190708
12406,12,406,1809,924,21,903,600,303,51.07794361525705,2.272727272727273,97.72727272727273,64.93506493506493,32.7922077922078
12407,12,407,1172,689,3,686,455,231,58.78839590443686,0.43541364296081275,99.56458635703919,66.0377358490566,33.52685050798258
12408,12,408,1372,814,8,806,496,310,59.329446064139944,0.9828009828009828,99.01719901719902,60.93366093366094,38.08353808353808
12409,12,409,1113,590,9,581,414,167,53.00988319856245,1.5254237288135595,98.47457627118644,70.16949152542374,28.30508474576271
12410,12,410,1089,621,6,615,446,169,57.02479338842975,0.966183574879227,99.03381642512076,71.81964573268921,27.214170692431562
12411,12,411,870,478,6,472,338,134,54.94252873563218,1.2552301255230125,98.74476987447699,70.7112970711297,28.03347280334728
12412,12,412,1652,968,9,959,644,315,58.595641646489106,0.9297520661157025,99.07024793388429,66.52892561983471,32.54132231404959
12413,12,413,1468,799,7,792,504,288,54.427792915531334,0.8760951188986232,99.12390488110138,63.07884856070088,36.0450563204005
12414,12,414,1448,736,5,731,454,277,50.82872928176796,0.6793478260869565,99.32065217391305,61.684782608695656,37.63586956521739
12415,12,415,1684,775,8,767,541,226,46.02137767220903,1.032258064516129,98.96774193548387,69.80645161290323,29.161290322580648
12416,12,416,1825,1003,16,987,706,281,54.95890410958905,1.5952143569292123,98.4047856430708,70.38883349950149,28.015952143569294
12417,12,417,1596,833,8,825,466,359,52.19298245614035,0.9603841536614646,99.03961584633853,55.942376950780314,43.09723889555822
12418,12,418,1169,580,4,576,413,163,49.615055603079554,0.6896551724137931,99.3103448275862,71.20689655172414,28.10344827586207
12419,12,419,1578,758,4,754,519,235,48.03548795944233,0.5277044854881267,99.47229551451187,68.46965699208444,31.00263852242744
12420,12,420,1027,602,8,594,437,157,58.61733203505355,1.3289036544850499,98.67109634551495,72.59136212624585,26.079734219269103
12421,12,421,1046,618,13,605,399,206,59.08221797323135,2.103559870550162,97.89644012944983,64.56310679611651,33.33333333333333
12422,12,422,1599,831,6,825,532,293,51.969981238273924,0.7220216606498195,99.27797833935018,64.01925391095065,35.25872442839952
12423,12,423,1364,730,9,721,497,224,53.51906158357771,1.2328767123287672,98.76712328767124,68.08219178082192,30.684931506849317
12424,12,424,772,391,5,386,239,147,50.64766839378238,1.278772378516624,98.72122762148338,61.125319693094625,37.59590792838875
12425,12,425,1809,970,1,969,630,339,53.62078496406855,0.10309278350515465,99.89690721649484,64.94845360824742,34.94845360824742
12426,12,426,655,350,2,348,221,127,53.43511450381679,0.5714285714285714,99.42857142857143,63.142857142857146,36.285714285714285
12501,12,501,854,491,2,489,299,190,57.494145199063226,0.40733197556008144,99.59266802443992,60.896130346232184,38.69653767820774
12502,12,502,1267,711,13,698,480,218,56.11681136543015,1.8284106891701828,98.17158931082982,67.51054852320675,30.66104078762307
12503,12,503,1722,1030,11,1019,718,301,59.814169570267126,1.0679611650485437,98.93203883495146,69.70873786407768,29.22330097087379
12504,12,504,1295,626,35,591,455,136,48.33976833976834,5.5910543130990416,94.40894568690096,72.68370607028754,21.72523961661342
12505,12,505,852,470,10,460,346,114,55.16431924882629,2.127659574468085,97.87234042553192,73.61702127659574,24.25531914893617
12506,12,506,876,461,7,454,338,116,52.62557077625571,1.5184381778741864,98.48156182212581,73.31887201735357,25.16268980477224
12507,12,507,841,403,6,397,302,95,47.91914387633769,1.488833746898263,98.51116625310173,74.93796526054591,23.573200992555833
12508,12,508,639,292,8,284,209,75,45.69640062597809,2.73972602739726,97.26027397260275,71.57534246575342,25.684931506849317
12509,12,509,979,472,12,460,360,100,48.212461695607765,2.5423728813559325,97.45762711864407,76.27118644067797,21.1864406779661
12510,12,510,761,355,5,350,279,71,46.64914586070959,1.4084507042253522,98.59154929577466,78.59154929577464,20.0
12511,12,511,902,389,8,381,304,77,43.12638580931264,2.056555269922879,97.94344473007712,78.1491002570694,19.794344473007712
12512,12,512,971,505,1,504,394,110,52.00823892893924,0.19801980198019803,99.8019801980198,78.01980198019803,21.782178217821784
12513,12,513,1460,630,10,620,465,155,43.15068493150685,1.5873015873015872,98.4126984126984,73.80952380952381,24.6031746031746
12514,12,514,1337,455,3,452,324,128,34.031413612565444,0.6593406593406593,99.34065934065934,71.20879120879121,28.13186813186813
12515,12,515,854,403,1,402,292,110,47.18969555035129,0.24813895781637718,99.75186104218362,72.45657568238212,27.29528535980149
12516,12,516,1267,598,7,591,460,131,47.19810576164167,1.1705685618729096,98.82943143812709,76.92307692307693,21.906354515050168
12517,12,517,942,418,9,409,319,90,44.37367303609342,2.15311004784689,97.84688995215312,76.31578947368422,21.5311004784689
12518,12,518,987,530,5,525,383,142,53.69807497467072,0.9433962264150944,99.05660377358491,72.26415094339622,26.79245283018868
12519,12,519,1088,546,13,533,396,137,50.18382352941176,2.380952380952381,97.61904761904762,72.52747252747253,25.09157509157509
12520,12,520,1026,374,15,359,273,86,36.45224171539961,4.010695187165775,95.98930481283422,72.99465240641712,22.994652406417114
12521,12,521,1069,523,3,520,371,149,48.92422825070159,0.5736137667304015,99.4263862332696,70.93690248565966,28.489483747609945
12522,12,522,811,363,1,362,259,103,44.75955610357583,0.27548209366391185,99.72451790633609,71.34986225895317,28.37465564738292
12523,12,523,1068,521,9,512,378,134,48.78277153558053,1.727447216890595,98.2725527831094,72.552783109405,25.719769673704413
12524,12,524,1157,522,5,517,399,118,45.116681071737254,0.9578544061302682,99.04214559386973,76.4367816091954,22.60536398467433
12525,12,525,805,480,5,475,339,136,59.62732919254658,1.0416666666666665,98.95833333333334,70.625,28.333333333333332
12526,12,526,1448,766,4,762,598,164,52.90055248618785,0.5221932114882507,99.47780678851174,78.06788511749347,21.409921671018274
12601,12,601,260,163,1,162,97,65,62.69230769230769,0.6134969325153374,99.38650306748467,59.50920245398773,39.87730061349693
12602,12,602,1389,814,9,805,557,248,58.60331173506119,1.1056511056511056,98.8943488943489,68.42751842751844,30.46683046683047
12603,12,603,1203,646,7,639,433,206,53.69908561928513,1.08359133126935,98.91640866873065,67.02786377708978,31.88854489164087
12604,12,604,1055,598,5,593,385,208,56.6824644549763,0.8361204013377926,99.1638795986622,64.38127090301003,34.78260869565217
12605,12,605,929,486,12,474,301,173,52.31431646932185,2.4691358024691357,97.53086419753086,61.934156378600825,35.59670781893004
12606,12,606,1249,710,10,700,495,205,56.84547638110489,1.4084507042253522,98.59154929577466,69.71830985915493,28.87323943661972
12607,12,607,1020,567,5,562,394,168,55.58823529411765,0.8818342151675485,99.11816578483244,69.48853615520282,29.629629629629626
12608,12,608,765,415,9,406,297,109,54.248366013071895,2.1686746987951806,97.83132530120481,71.56626506024097,26.265060240963855
12609,12,609,1453,790,7,783,506,277,54.370268410185815,0.8860759493670887,99.1139240506329,64.0506329113924,35.063291139240505
12610,12,610,1013,569,6,563,383,180,56.16979269496545,1.054481546572935,98.94551845342706,67.31107205623901,31.63444639718805
12611,12,611,841,497,7,490,332,158,59.096313912009514,1.4084507042253522,98.59154929577466,66.80080482897385,31.790744466800803
12612,12,612,1097,549,8,541,354,187,50.04557885141294,1.4571948998178506,98.54280510018215,64.48087431693989,34.06193078324226
12613,12,613,1127,600,14,586,384,202,53.23868677905945,2.3333333333333335,97.66666666666667,64.0,33.666666666666664
12614,12,614,1426,707,8,699,436,263,49.57924263674614,1.1315417256011315,98.86845827439888,61.669024045261665,37.1994342291372
12615,12,615,1790,959,14,945,650,295,53.575418994413404,1.4598540145985401,98.54014598540147,67.77893639207507,30.761209593326384
12616,12,616,1442,823,6,817,550,267,57.07350901525658,0.7290400972053462,99.27095990279466,66.82867557715674,32.44228432563791
12617,12,617,1131,630,11,619,416,203,55.702917771883286,1.746031746031746,98.25396825396825,66.03174603174602,32.22222222222222
12618,12,618,1433,794,13,781,512,269,55.40823447313329,1.63727959697733,98.36272040302268,64.48362720403023,33.87909319899244
12619,12,619,1715,952,16,936,604,332,55.51020408163265,1.680672268907563,98.31932773109243,63.4453781512605,34.87394957983193
12620,12,620,1020,578,2,576,373,203,56.666666666666664,0.34602076124567477,99.65397923875432,64.53287197231833,35.121107266435985
12621,12,621,932,486,2,484,320,164,52.14592274678112,0.411522633744856,99.58847736625515,65.84362139917695,33.744855967078195
12622,12,622,1071,593,3,590,381,209,55.368814192343606,0.5059021922428331,99.49409780775717,64.2495784148398,35.24451939291737
12623,12,623,891,487,7,480,307,173,54.65768799102132,1.4373716632443532,98.56262833675564,63.039014373716626,35.52361396303901
12624,12,624,1194,722,9,713,473,240,60.46901172529313,1.2465373961218837,98.75346260387812,65.51246537396122,33.2409972299169
12625,12,625,1104,661,11,650,428,222,59.87318840579711,1.6641452344931922,98.33585476550681,64.75037821482601,33.58547655068079
011A,01,1A,0,1982,2,1980,1223,757,inf,0.10090817356205853,99.89909182643795,61.70534813319879,38.19374369323915
011B,01,1B,0,1184,5,1179,767,412,inf,0.4222972972972973,99.5777027027027,64.7804054054054,34.7972972972973
011C,01,1C,0,1063,9,1054,611,443,inf,0.8466603951081844,99.15333960489181,57.47883349012229,41.67450611476952
011D,01,1D,0,1433,208,1225,688,537,inf,14.515003489183531,85.48499651081647,48.01116538729937,37.4738311235171
011E,01,1E,0,1494,5,1489,860,629,inf,0.33467202141900937,99.66532797858099,57.56358768406962,42.10174029451138
012A,01,2A,0,1522,7,1515,925,590,inf,0.45992115637319314,99.54007884362682,60.775295663600524,38.76478318002628
012B,01,2B,0,1334,12,1322,733,589,inf,0.8995502248875562,99.10044977511244,54.94752623688156,44.15292353823089
012C,01,2C,0,1171,10,1161,638,523,inf,0.8539709649871904,99.1460290350128,54.48334756618275,44.662681468830066
012D,01,2D,0,926,3,923,440,483,inf,0.32397408207343414,99.67602591792657,47.51619870410367,52.159827213822894
012E,01,2E,0,1104,7,1097,557,540,inf,0.6340579710144928,99.36594202898551,50.45289855072463,48.91304347826087
012F,01,2F,0,1277,10,1267,615,652,inf,0.7830853563038371,99.21691464369616,48.15974941268598,51.05716523101018
013A,01,3A,0,1026,14,1012,587,425,inf,1.364522417153996,98.635477582846,57.21247563352827,41.42300194931774
013B,01,3B,0,1490,159,1331,729,602,inf,10.671140939597315,89.32885906040269,48.9261744966443,40.40268456375839
013C,01,3C,0,1344,134,1210,721,489,inf,9.970238095238097,90.02976190476191,53.645833333333336,36.38392857142857
013D,01,3D,0,1009,10,999,616,383,inf,0.9910802775024776,99.00891972249752,61.05054509415263,37.9583746283449
013E,01,3E,0,1457,12,1445,990,455,inf,0.8236101578586137,99.17638984214139,67.94783802333562,31.228551818805766
013F,01,3F,0,718,1,717,418,299,inf,0.1392757660167131,99.86072423398329,58.21727019498607,41.64345403899721
014A,01,4A,0,1144,8,1136,742,394,inf,0.6993006993006993,99.3006993006993,64.86013986013987,34.44055944055944
014B,01,4B,0,1250,11,1239,725,514,inf,0.88,99.11999999999999,57.99999999999999,41.120000000000005
014C,01,4C,0,1061,10,1051,589,462,inf,0.9425070688030159,99.05749293119699,55.51366635249765,43.54382657869934
014D,01,4D,0,1142,12,1130,656,474,inf,1.0507880910683012,98.9492119089317,57.4430823117338,41.5061295971979
014E,01,4E,0,1487,9,1478,792,686,inf,0.605245460659045,99.39475453934095,53.26160053799597,46.13315400134499
015A,01,5A,0,1101,4,1097,561,536,inf,0.36330608537693004,99.63669391462307,50.95367847411444,48.68301544050863
015B,01,5B,0,1024,3,1021,478,543,inf,0.29296875,99.70703125,46.6796875,53.02734375
015C,01,5C,0,893,5,888,460,428,inf,0.5599104143337066,99.44008958566629,51.51175811870101,47.92833146696528
015D,01,5D,0,1288,12,1276,594,682,inf,0.9316770186335404,99.06832298136646,46.11801242236025,52.95031055900621
015E,01,5E,0,855,66,789,397,392,inf,7.719298245614035,92.28070175438596,46.4327485380117,45.84795321637427
016A,01,6A,0,768,0,768,303,465,inf,0.0,100.0,39.453125,60.546875
016B,01,6B,0,733,3,730,334,396,inf,0.4092769440654843,99.59072305593452,45.56616643929058,54.02455661664393
016C,01,6C,0,1016,6,1010,470,540,inf,0.5905511811023622,99.40944881889764,46.25984251968504,53.14960629921261
016D,01,6D,0,797,10,787,410,377,inf,1.2547051442910917,98.7452948557089,51.44291091593476,47.30238393977415
016E,01,6E,0,879,79,800,411,389,inf,8.987485779294653,91.01251422070534,46.75767918088737,44.254835039817976
017A,01,7A,0,1041,10,1031,530,501,inf,0.9606147934678195,99.03938520653219,50.91258405379443,48.126801152737755
017B,01,7B,0,1163,7,1156,619,537,inf,0.6018916595012898,99.39810834049871,53.224419604471194,46.173688736027515
017C,01,7C,0,759,9,750,451,299,inf,1.185770750988142,98.81422924901186,59.42028985507246,39.39393939393939
017D,01,7D,0,571,3,568,366,202,inf,0.5253940455341506,99.47460595446584,64.09807355516638,35.37653239929948
017E,01,7E,0,934,6,928,548,380,inf,0.6423982869379015,99.3576017130621,58.67237687366167,40.68522483940043
021A,02,1A,0,772,14,758,374,384,inf,1.8134715025906734,98.18652849740933,48.44559585492228,49.740932642487046
021B,02,1B,0,707,7,700,307,393,inf,0.9900990099009901,99.00990099009901,43.42291371994342,55.58698727015559
021C,02,1C,0,770,8,762,359,403,inf,1.0389610389610389,98.96103896103897,46.62337662337662,52.33766233766234
021D,02,1D,0,688,8,680,281,399,inf,1.1627906976744187,98.83720930232558,40.843023255813954,57.99418604651163
021E,02,1E,0,661,5,656,289,367,inf,0.7564296520423601,99.24357034795764,43.72163388804841,55.52193645990923
021F,02,1F,0,734,9,725,325,400,inf,1.226158038147139,98.77384196185287,44.27792915531335,54.495912806539515
021G,02,1G,0,661,6,655,276,379,inf,0.9077155824508321,99.09228441754917,41.75491679273828,57.337367624810895
021H,02,1H,0,638,6,632,244,388,inf,0.9404388714733543,99.05956112852664,38.24451410658307,60.81504702194357
021J,02,1J,0,573,14,559,241,318,inf,2.4432809773123907,97.55671902268762,42.059336823734725,55.497382198952884
021K,02,1K,0,441,6,435,169,266,inf,1.3605442176870748,98.63945578231292,38.32199546485261,60.317460317460316
021L,02,1L,0,419,7,412,196,216,inf,1.6706443914081146,98.32935560859188,46.77804295942721,51.551312649164686
021M,02,1M,0,449,6,443,226,217,inf,1.3363028953229399,98.66369710467706,50.33407572383074,48.329621380846326
021N,02,1N,0,494,4,490,234,256,inf,0.8097165991902834,99.19028340080972,47.368421052631575,51.821862348178136
022A,02,2A,0,439,7,432,192,240,inf,1.5945330296127564,98.40546697038725,43.735763097949885,54.66970387243736
022B,02,2B,0,579,7,572,261,311,inf,1.2089810017271159,98.79101899827289,45.07772020725388,53.71329879101899
022C,02,2C,0,430,3,427,180,247,inf,0.6976744186046512,99.30232558139535,41.86046511627907,57.44186046511628
022D,02,2D,0,521,4,517,198,319,inf,0.7677543186180422,99.23224568138195,38.00383877159309,61.228406909788866
022E,02,2E,0,388,8,380,165,215,inf,2.0618556701030926,97.9381443298969,42.52577319587629,55.412371134020624
022F,02,2F,0,412,7,405,143,262,inf,1.6990291262135921,98.30097087378641,34.70873786407767,63.59223300970874
022G,02,2G,0,425,9,416,180,236,inf,2.1176470588235294,97.88235294117648,42.35294117647059,55.529411764705884
022H,02,2H,0,824,12,812,381,431,inf,1.4563106796116505,98.54368932038835,46.237864077669904,52.30582524271845
022J,02,2J,0,756,14,742,303,439,inf,1.8518518518518516,98.14814814814815,40.07936507936508,58.06878306878307
022K,02,2K,0,597,5,592,302,290,inf,0.8375209380234505,99.16247906197655,50.58626465661642,48.57621440536013
022L,02,2L,0,595,8,587,278,309,inf,1.3445378151260505,98.65546218487395,46.72268907563025,51.932773109243705
022M,02,2M,0,672,5,667,314,353,inf,0.744047619047619,99.25595238095238,46.726190476190474,52.529761904761905
022N,02,2N,0,558,8,550,245,305,inf,1.4336917562724014,98.56630824372759,43.90681003584229,54.659498207885306
023A,02,3A,0,391,2,389,242,147,inf,0.5115089514066496,99.48849104859335,61.892583120204606,37.59590792838875
023B,02,3B,0,331,5,326,166,160,inf,1.5105740181268883,98.48942598187311,50.15105740181269,48.338368580060425
023C,02,3C,0,607,5,602,376,226,inf,0.8237232289950577,99.17627677100495,61.94398682042833,37.23228995057661
023D,02,3D,0,551,10,541,337,204,inf,1.8148820326678767,98.18511796733212,61.16152450090744,37.02359346642468
023E,02,3E,0,637,8,629,277,352,inf,1.2558869701726845,98.74411302982732,43.4850863422292,55.25902668759811
023F,02,3F,0,461,4,457,270,187,inf,0.8676789587852495,99.13232104121475,58.56832971800434,40.563991323210416
023G,02,3G,0,448,15,433,207,226,inf,3.3482142857142856,96.65178571428571,46.205357142857146,50.44642857142857
023H,02,3H,0,693,7,686,246,440,inf,1.0101010101010102,98.98989898989899,35.4978354978355,63.49206349206349
023J,02,3J,0,641,4,637,275,362,inf,0.62402496099844,99.37597503900156,42.90171606864275,56.47425897035882
024A,02,4A,0,531,5,526,262,264,inf,0.9416195856873822,99.05838041431262,49.34086629001883,49.717514124293785
024B,02,4B,0,435,3,432,194,238,inf,0.6896551724137931,99.3103448275862,44.59770114942529,54.71264367816092
024C,02,4C,0,506,7,499,243,256,inf,1.383399209486166,98.61660079051383,48.023715415019765,50.59288537549407
024D,02,4D,0,600,7,593,291,302,inf,1.1666666666666667,98.83333333333333,48.5,50.33333333333333
024E,02,4E,0,522,6,516,229,287,inf,1.1494252873563218,98.85057471264368,43.86973180076628,54.98084291187739
024F,02,4F,0,412,2,410,208,202,inf,0.48543689320388345,99.51456310679612,50.48543689320388,49.029126213592235
024G,02,4G,0,566,7,559,251,308,inf,1.2367491166077738,98.76325088339223,44.34628975265017,54.416961130742045
024H,02,4H,0,691,9,682,315,367,inf,1.3024602026049203,98.69753979739508,45.58610709117221,53.111432706222864
024J,02,4J,0,482,1,481,249,232,inf,0.2074688796680498,99.79253112033194,51.65975103734441,48.13278008298755
024K,02,4K,0,555,1,554,250,304,inf,0.18018018018018017,99.81981981981983,45.04504504504504,54.77477477477477
024L,02,4L,0,598,5,593,271,322,inf,0.8361204013377926,99.1638795986622,45.31772575250836,53.84615384615385
024M,02,4M,0,475,7,468,214,254,inf,1.4736842105263157,98.52631578947368,45.05263157894737,53.473684210526315
024N,02,4N,0,584,4,580,299,281,inf,0.684931506849315,99.31506849315068,51.1986301369863,48.11643835616438
025A,02,5A,0,649,9,640,318,322,inf,1.386748844375963,98.61325115562404,48.99845916795069,49.61479198767334
025B,02,5B,0,527,12,515,210,305,inf,2.2770398481973433,97.72296015180265,39.84819734345351,57.874762808349146
025C,02,5C,0,650,5,645,311,334,inf,0.7692307692307693,99.23076923076923,47.84615384615385,51.38461538461539
025D,02,5D,0,820,11,809,377,432,inf,1.3414634146341464,98.65853658536585,45.97560975609756,52.6829268292683
025E,02,5E,0,831,14,817,371,446,inf,1.684717208182912,98.31528279181708,44.64500601684717,53.67027677496991
025F,02,5F,0,467,4,463,229,234,inf,0.8565310492505354,99.14346895074947,49.03640256959314,50.107066381156315
025G,02,5G,0,551,4,547,258,289,inf,0.7259528130671506,99.27404718693285,46.82395644283122,52.45009074410163
025H,02,5H,0,544,9,535,251,284,inf,1.6544117647058825,98.34558823529412,46.13970588235294,52.20588235294118
025J,02,5J,0,629,10,619,267,352,inf,1.5898251192368837,98.41017488076311,42.4483306836248,55.96184419713831
025K,02,5K,0,649,9,640,269,371,inf,1.386748844375963,98.61325115562404,41.44838212634823,57.16486902927581
025L,02,5L,0,528,6,522,244,278,inf,1.1363636363636365,98.86363636363636,46.21212121212121,52.65151515151515
025M,02,5M,0,817,16,801,378,423,inf,1.9583843329253363,98.04161566707467,46.266829865361075,51.774785801713584
025N,02,5N,0,629,6,623,308,315,inf,0.9538950715421303,99.04610492845786,48.966613672496024,50.07949125596184
031A,03,1A,0,824,2,822,406,416,inf,0.24271844660194172,99.75728155339806,49.271844660194176,50.48543689320388
031B,03,1B,0,484,5,479,254,225,inf,1.0330578512396695,98.96694214876032,52.47933884297521,46.48760330578512
031C,03,1C,0,371,3,368,215,153,inf,0.8086253369272237,99.19137466307278,57.95148247978437,41.23989218328841
031D,03,1D,0,615,2,613,349,264,inf,0.3252032520325203,99.67479674796748,56.7479674796748,42.926829268292686
031E,03,1E,0,397,5,392,208,184,inf,1.2594458438287155,98.74055415617129,52.39294710327456,46.34760705289673
031F,03,1F,0,542,4,538,266,272,inf,0.7380073800738007,99.2619926199262,49.07749077490775,50.184501845018445
031G,03,1G,0,608,2,606,308,298,inf,0.3289473684210526,99.67105263157895,50.6578947368421,49.01315789473684
031H,03,1H,0,397,1,396,238,158,inf,0.2518891687657431,99.74811083123426,59.949622166246854,39.79848866498741
031I,03,1I,0,600,3,597,271,326,inf,0.5,99.5,45.166666666666664,54.333333333333336
031K,03,1K,0,686,0,686,321,365,inf,0.0,100.0,46.79300291545189,53.2069970845481
031L,03,1L,0,578,0,578,314,264,inf,0.0,100.0,54.325259515570934,45.674740484429066
032A,03,2A,0,632,3,629,350,279,inf,0.4746835443037975,99.5253164556962,55.379746835443036,44.14556962025317
032B,03,2B,0,488,6,482,270,212,inf,1.2295081967213115,98.77049180327869,55.32786885245902,43.44262295081967
032C,03,2C,0,611,6,605,355,250,inf,0.9819967266775778,99.01800327332242,58.10147299509002,40.91653027823241
032D,03,2D,0,930,3,927,465,462,inf,0.3225806451612903,99.67741935483872,50.0,49.67741935483871
032E,03,2E,0,1022,3,1019,416,603,inf,0.29354207436399216,99.706457925636,40.704500978473575,59.00195694716243
032F,03,2F,0,602,6,596,311,285,inf,0.9966777408637874,99.00332225913621,51.66112956810631,47.3421926910299
032G,03,2G,0,721,2,719,334,385,inf,0.27739251040221913,99.72260748959778,46.3245492371706,53.398058252427184
032H,03,2H,0,1027,3,1024,437,587,inf,0.2921129503407984,99.7078870496592,42.55111976630964,57.156767283349566
032I,03,2I,0,993,5,988,313,675,inf,0.5035246727089627,99.49647532729104,31.520644511581068,67.97583081570997
033A,03,3A,0,649,3,646,273,373,inf,0.46224961479198773,99.53775038520801,42.06471494607088,57.473035439137135
033B,03,3B,0,752,4,748,288,460,inf,0.5319148936170213,99.46808510638297,38.297872340425535,61.170212765957444
033C,03,3C,0,803,6,797,281,516,inf,0.7471980074719801,99.25280199252802,34.99377334993773,64.2590286425903
033D,03,3D,0,640,4,636,156,480,inf,0.625,99.375,24.375,75.0
033E,03,3E,0,616,3,613,196,417,inf,0.487012987012987,99.51298701298701,31.818181818181817,67.6948051948052
033F,03,3F,0,654,4,650,199,451,inf,0.6116207951070336,99.38837920489296,30.428134556574925,68.96024464831805
033G,03,3G,0,1091,8,1083,207,876,inf,0.7332722273143905,99.26672777268561,18.973418881759855,80.29330889092576
033H,03,3H,0,1251,5,1246,292,954,inf,0.3996802557953637,99.60031974420464,23.341326938449242,76.2589928057554
033I,03,3I,0,1355,6,1349,302,1047,inf,0.44280442804428044,99.55719557195572,22.287822878228784,77.26937269372694
034A,03,4A,0,699,4,695,279,416,inf,0.5722460658082975,99.4277539341917,39.91416309012876,59.513590844062946
034B,03,4B,0,900,6,894,350,544,inf,0.6666666666666667,99.33333333333333,38.88888888888889,60.44444444444444
034C,03,4C,0,575,6,569,224,345,inf,1.0434782608695654,98.95652173913044,38.95652173913044,60.0
034D,03,4D,0,554,4,550,274,276,inf,0.7220216606498195,99.27797833935018,49.458483754512635,49.81949458483754
034E,03,4E,0,509,7,502,189,313,inf,1.37524557956778,98.62475442043221,37.13163064833006,61.493123772102166
034F,03,4F,0,504,2,502,220,282,inf,0.3968253968253968,99.60317460317461,43.65079365079365,55.952380952380956
034G,03,4G,0,810,4,806,194,612,inf,0.49382716049382713,99.50617283950616,23.950617283950617,75.55555555555556
034H,03,4H,0,1085,1,1084,351,733,inf,0.09216589861751152,99.90783410138249,32.35023041474655,67.55760368663594
034I,03,4I,0,415,1,414,202,212,inf,0.24096385542168677,99.75903614457832,48.674698795180724,51.08433734939759
035A,03,5A,0,629,1,628,205,423,inf,0.1589825119236884,99.84101748807632,32.591414944356124,67.24960254372019
035B,03,5B,0,651,2,649,221,428,inf,0.30721966205837176,99.69278033794163,33.94777265745007,65.74500768049155
035C,03,5C,0,610,4,606,195,411,inf,0.6557377049180327,99.34426229508196,31.967213114754102,67.37704918032786
035D,03,5D,0,582,6,576,224,352,inf,1.0309278350515463,98.96907216494846,38.48797250859107,60.48109965635739
035E,03,5E,0,813,3,810,333,477,inf,0.36900369003690037,99.63099630996311,40.959409594095945,58.671586715867164
035F,03,5F,0,728,3,725,255,470,inf,0.4120879120879121,99.58791208791209,35.027472527472526,64.56043956043956
035G,03,5G,0,629,3,626,214,412,inf,0.47694753577106513,99.52305246422894,34.02225755166931,65.50079491255963
035H,03,5H,0,688,8,680,199,481,inf,1.1627906976744187,98.83720930232558,28.924418604651166,69.91279069767442
035I,03,5I,0,466,1,465,149,316,inf,0.2145922746781116,99.78540772532189,31.97424892703863,67.81115879828327
035K,03,5K,0,691,4,687,110,577,inf,0.5788712011577424,99.42112879884226,15.918958031837915,83.50217076700434
036A,03,6A,0,627,5,622,223,399,inf,0.7974481658692184,99.20255183413079,35.56618819776715,63.63636363636363
036B,03,6B,0,633,9,624,282,342,inf,1.4218009478672986,98.5781990521327,44.54976303317535,54.02843601895735
036C,03,6C,0,638,2,636,266,370,inf,0.3134796238244514,99.68652037617555,41.692789968652036,57.993730407523515
036D,03,6D,0,913,4,909,423,486,inf,0.43811610076670315,99.5618838992333,46.33077765607886,53.231106243154436
036E,03,6E,0,748,8,740,342,398,inf,1.06951871657754,98.93048128342245,45.72192513368984,53.20855614973262
036F,03,6F,0,707,7,700,315,385,inf,0.9900990099009901,99.00990099009901,44.554455445544555,54.45544554455446
036G,03,6G,0,771,2,769,357,412,inf,0.25940337224383914,99.74059662775616,46.30350194552529,53.43709468223087
036H,03,6H,0,997,11,986,483,503,inf,1.103309929789368,98.89669007021064,48.44533600802407,50.45135406218656
036I,03,6I,0,897,5,892,452,440,inf,0.5574136008918618,99.44258639910814,50.390189520624304,49.05239687848383
036K,03,6K,0,809,5,804,352,452,inf,0.6180469715698393,99.38195302843016,43.51050679851669,55.87144622991347
037A,03,7A,0,848,2,846,426,420,inf,0.2358490566037736,99.76415094339622,50.235849056603776,49.528301886792455
037B,03,7B,0,518,4,514,255,259,inf,0.7722007722007722,99.22779922779922,49.22779922779923,50.0
037C,03,7C,0,632,5,627,275,352,inf,0.7911392405063291,99.20886075949366,43.5126582278481,55.69620253164557
037D,03,7D,0,783,6,777,406,371,inf,0.7662835249042145,99.23371647509579,51.85185185185185,47.381864623243935
037E,03,7E,0,581,1,580,278,302,inf,0.17211703958691912,99.82788296041308,47.84853700516351,51.97934595524957
037F,03,7F,0,713,3,710,328,382,inf,0.42075736325385693,99.57924263674614,46.00280504908836,53.576437587657786
037G,03,7G,0,1024,0,1024,490,534,inf,0.0,100.0,47.8515625,52.1484375
037H,03,7H,0,719,3,716,314,402,inf,0.4172461752433936,99.58275382475661,43.671766342141865,55.910987482614736
037I,03,7I,0,511,3,508,220,288,inf,0.5870841487279843,99.412915851272,43.05283757338552,56.360078277886494
038A,03,8A,0,635,8,627,306,321,inf,1.2598425196850394,98.74015748031496,48.188976377952756,50.55118110236221
038B,03,8B,0,674,3,671,339,332,inf,0.44510385756676557,99.55489614243324,50.29673590504451,49.25816023738873
038C,03,8C,0,1049,6,1043,521,522,inf,0.5719733079122974,99.4280266920877,49.666348903717825,49.76167778836987
038D,03,8D,0,751,4,747,368,379,inf,0.5326231691078562,99.46737683089214,49.00133155792277,50.466045272969374
038E,03,8E,0,764,8,756,403,353,inf,1.0471204188481675,98.95287958115183,52.74869109947644,46.20418848167539
038F,03,8F,0,773,5,768,369,399,inf,0.646830530401035,99.35316946959897,47.73609314359638,51.61707632600259
038G,03,8G,0,971,5,966,515,451,inf,0.5149330587023687,99.48506694129763,53.03810504634397,46.44696189495365
038H,03,8H,0,688,2,686,329,357,inf,0.29069767441860467,99.70930232558139,47.81976744186046,51.889534883720934
038I,03,8I,0,906,2,904,490,414,inf,0.22075055187637968,99.77924944812362,54.083885209713024,45.6953642384106
039A,03,9A,0,516,0,516,214,302,inf,0.0,100.0,41.47286821705426,58.52713178294574
039B,03,9B,0,677,4,673,296,377,inf,0.5908419497784343,99.40915805022156,43.72230428360414,55.686853766617425
039C,03,9C,0,594,5,589,264,325,inf,0.8417508417508417,99.15824915824916,44.44444444444444,54.71380471380471
039D,03,9D,0,643,5,638,325,313,inf,0.7776049766718507,99.22239502332815,50.5443234836703,48.67807153965785
039E,03,9E,0,768,3,765,373,392,inf,0.390625,99.609375,48.56770833333333,51.041666666666664
039F,03,9F,0,597,3,594,291,303,inf,0.5025125628140703,99.49748743718592,48.743718592964825,50.753768844221106
039G,03,9G,0,622,4,618,273,345,inf,0.6430868167202572,99.35691318327974,43.89067524115756,55.466237942122184
039H,03,9H,0,739,5,734,354,380,inf,0.6765899864682002,99.3234100135318,47.902571041948576,51.420838971583215
039I,03,9I,0,1051,2,1049,455,594,inf,0.19029495718363465,99.80970504281636,43.29210275927688,56.51760228353948
039K,03,9K,0,375,3,372,191,181,inf,0.8,99.2,50.93333333333333,48.266666666666666
041A,04,1A,0,689,4,685,498,187,inf,0.5805515239477503,99.41944847605225,72.27866473149493,27.14078374455733
041B,04,1B,0,697,3,694,459,235,inf,0.430416068866571,99.56958393113344,65.85365853658537,33.715925394548066
041C,04,1C,0,658,8,650,462,188,inf,1.21580547112462,98.78419452887537,70.2127659574468,28.57142857142857
041D,04,1D,0,1004,10,994,745,249,inf,0.9960159362549801,99.00398406374502,74.20318725099602,24.800796812749006
041E,04,1E,0,1070,3,1067,741,326,inf,0.2803738317757009,99.7196261682243,69.25233644859813,30.467289719626166
042A,04,2A,0,1001,28,973,678,295,inf,2.797202797202797,97.2027972027972,67.73226773226774,29.47052947052947
042B,04,2B,0,815,1,814,586,228,inf,0.1226993865030675,99.87730061349693,71.90184049079754,27.975460122699385
042C,04,2C,0,641,3,638,464,174,inf,0.46801872074883,99.53198127925117,72.38689547581903,27.14508580343214
042D,04,2D,0,894,4,890,627,263,inf,0.44742729306487694,99.55257270693512,70.13422818791946,29.418344519015662
042E,04,2E,0,939,4,935,690,245,inf,0.42598509052183176,99.57401490947817,73.48242811501598,26.091586794462195
042F,04,2F,0,774,0,774,590,184,inf,0.0,100.0,76.22739018087856,23.772609819121445
042G,04,2G,0,958,4,954,724,230,inf,0.41753653444676403,99.58246346555325,75.5741127348643,24.008350730688935
042H,04,2H,0,949,5,944,681,263,inf,0.5268703898840885,99.4731296101159,71.75974710221286,27.713382507903056
042J,04,2J,0,1040,9,1031,763,268,inf,0.8653846153846154,99.13461538461539,73.36538461538461,25.769230769230766
043A,04,3A,0,1162,10,1152,808,344,inf,0.8605851979345954,99.1394148020654,69.53528399311531,29.604130808950085
043B,04,3B,0,956,8,948,625,323,inf,0.8368200836820083,99.16317991631799,65.3765690376569,33.78661087866109
043C,04,3C,0,995,6,989,715,274,inf,0.6030150753768844,99.39698492462311,71.85929648241206,27.537688442211056
043D,04,3D,0,932,7,925,667,258,inf,0.7510729613733905,99.2489270386266,71.56652360515021,27.682403433476395
043E,04,3E,0,1005,4,1001,662,339,inf,0.3980099502487562,99.60199004975124,65.87064676616914,33.731343283582085
043F,04,3F,0,1019,9,1010,668,342,inf,0.8832188420019628,99.11678115799803,65.55446516192346,33.56231599607458
043G,04,3G,0,891,7,884,612,272,inf,0.7856341189674524,99.21436588103255,68.68686868686868,30.52749719416386
043H,04,3H,0,801,7,794,600,194,inf,0.8739076154806492,99.12609238451935,74.90636704119851,24.21972534332085
044A,04,4A,0,891,10,881,610,271,inf,1.122334455667789,98.87766554433222,68.46240179573513,30.41526374859708
044B,04,4B,0,1282,9,1273,1008,265,inf,0.702028081123245,99.29797191887675,78.62714508580343,20.67082683307332
044C,04,4C,0,940,4,936,671,265,inf,0.425531914893617,99.57446808510639,71.38297872340425,28.191489361702125
044D,04,4D,0,1056,8,1048,755,293,inf,0.7575757575757576,99.24242424242425,71.49621212121212,27.74621212121212
044E,04,4E,0,942,7,935,681,254,inf,0.743099787685775,99.25690021231422,72.29299363057325,26.963906581740975
044F,04,4F,0,974,8,966,710,256,inf,0.8213552361396305,99.17864476386036,72.8952772073922,26.283367556468175
044G,04,4G,0,944,2,942,740,202,inf,0.211864406779661,99.78813559322035,78.38983050847457,21.398305084745765
044H,04,4H,0,860,5,855,670,185,inf,0.5813953488372093,99.4186046511628,77.90697674418605,21.511627906976745
045A,04,5A,0,789,2,787,640,147,inf,0.25348542458808615,99.74651457541192,81.11533586818757,18.631178707224336
045B,04,5B,0,823,4,819,628,191,inf,0.48602673147023084,99.51397326852977,76.30619684082625,23.207776427703525
045C,04,5C,0,811,6,805,565,240,inf,0.7398273736128237,99.26017262638717,69.66707768187423,29.59309494451295
045D,04,5D,0,947,3,944,707,237,inf,0.31678986272439286,99.68321013727561,74.65681098204857,25.02639915522703
045E,04,5E,0,927,3,924,668,256,inf,0.3236245954692557,99.67637540453075,72.06040992448759,27.615965480043148
045F,04,5F,0,1119,10,1109,876,233,inf,0.8936550491510277,99.10634495084896,78.28418230563003,20.822162645218945
045G,04,5G,0,648,3,645,510,135,inf,0.4629629629629629,99.53703703703704,78.70370370370371,20.833333333333336
045H,04,5H,0,987,6,981,839,142,inf,0.60790273556231,99.3920972644377,85.00506585612969,14.387031408308005
045J,04,5J,0,827,4,823,655,168,inf,0.48367593712212814,99.51632406287787,79.20193470374849,20.314389359129382
046A,04,6A,0,981,3,978,734,244,inf,0.3058103975535168,99.69418960244649,74.82161060142711,24.872579001019368
046B,04,6B,0,763,2,761,529,232,inf,0.2621231979030144,99.73787680209698,69.3315858453473,30.40629095674967
046C,04,6C,0,1284,10,1274,915,359,inf,0.778816199376947,99.22118380062305,71.26168224299066,27.9595015576324
046D,04,6D,0,1058,9,1049,685,364,inf,0.8506616257088847,99.14933837429112,64.74480151228732,34.40453686200378
046E,04,6E,0,934,7,927,589,338,inf,0.7494646680942184,99.25053533190578,63.062098501070665,36.188436830835116
046F,04,6F,0,879,3,876,586,290,inf,0.3412969283276451,99.65870307167235,66.66666666666666,32.992036405005685
046G,04,6G,0,822,5,817,473,344,inf,0.6082725060827251,99.39172749391727,57.54257907542579,41.84914841849148
046H,04,6H,0,893,4,889,616,273,inf,0.4479283314669653,99.55207166853303,68.98096304591266,30.57110862262038
047A,04,7A,0,907,9,898,636,262,inf,0.9922822491730982,99.00771775082691,70.1212789415656,28.8864388092613
047B,04,7B,0,813,6,807,606,201,inf,0.7380073800738007,99.2619926199262,74.53874538745387,24.723247232472325
047C,04,7C,0,1008,10,998,632,366,inf,0.992063492063492,99.0079365079365,62.698412698412696,36.30952380952381
047D,04,7D,0,1058,9,1049,679,370,inf,0.8506616257088847,99.14933837429112,64.17769376181475,34.97164461247637
047E,04,7E,0,1061,9,1052,757,295,inf,0.8482563619227144,99.15174363807728,71.34778510838832,27.80395852968897
047F,04,7F,0,1105,7,1098,738,360,inf,0.6334841628959276,99.36651583710407,66.78733031674207,32.57918552036199
047G,04,7G,0,1096,2,1094,706,388,inf,0.18248175182481752,99.81751824817519,64.41605839416059,35.4014598540146
047H,04,7H,0,861,5,856,627,229,inf,0.5807200929152149,99.41927990708479,72.82229965156795,26.59698025551684
048A,04,8A,0,988,17,971,676,295,inf,1.7206477732793521,98.27935222672065,68.42105263157895,29.858299595141702
048B,04,8B,0,1183,10,1173,676,497,inf,0.84530853761623,99.15469146238377,57.14285714285714,42.01183431952663
051A,05,1A,0,780,4,776,424,352,inf,0.5128205128205128,99.48717948717949,54.35897435897436,45.12820512820513
051B,05,1B,0,639,2,637,342,295,inf,0.3129890453834116,99.68701095461658,53.52112676056338,46.165884194053206
051C,05,1C,0,942,5,937,446,491,inf,0.5307855626326964,99.4692144373673,47.346072186836516,52.12314225053078
051D,05,1D,0,716,3,713,341,372,inf,0.41899441340782123,99.58100558659217,47.625698324022345,51.955307262569825
051E,05,1E,0,787,2,785,359,426,inf,0.25412960609911056,99.74587039390089,45.61626429479034,54.129606099110546
051F,05,1F,0,770,3,767,254,513,inf,0.38961038961038963,99.61038961038962,32.98701298701299,66.62337662337663
051G,05,1G,0,760,1,759,412,347,inf,0.13157894736842105,99.86842105263159,54.21052631578947,45.6578947368421
051H,05,1H,0,722,1,721,362,359,inf,0.13850415512465375,99.86149584487535,50.13850415512465,49.72299168975069
052A,05,2A,0,694,2,692,316,376,inf,0.2881844380403458,99.71181556195965,45.53314121037464,54.17867435158501
052B,05,2B,0,718,3,715,351,364,inf,0.4178272980501393,99.58217270194986,48.8857938718663,50.69637883008357
052C,05,2C,0,716,0,716,430,286,inf,0.0,100.0,60.05586592178771,39.94413407821229
052D,05,2D,0,715,4,711,360,351,inf,0.5594405594405595,99.44055944055944,50.349650349650354,49.09090909090909
052E,05,2E,0,611,5,606,272,334,inf,0.8183306055646482,99.18166939443536,44.51718494271686,54.6644844517185
052F,05,2F,0,709,4,705,511,194,inf,0.5641748942172073,99.4358251057828,72.07334273624824,27.362482369534558
052G,05,2G,0,751,3,748,525,223,inf,0.3994673768308922,99.6005326231691,69.90679094540613,29.69374167776298
053A,05,3A,0,687,3,684,465,219,inf,0.43668122270742354,99.56331877729258,67.68558951965066,31.877729257641924
053B,05,3B,0,701,3,698,467,231,inf,0.42796005706134094,99.57203994293866,66.61911554921541,32.95292439372325
053C,05,3C,0,669,5,664,450,214,inf,0.7473841554559043,99.2526158445441,67.2645739910314,31.988041853512705
053D,05,3D,0,905,1,904,640,264,inf,0.11049723756906078,99.88950276243094,70.71823204419888,29.171270718232044
053E,05,3E,0,777,3,774,512,262,inf,0.3861003861003861,99.61389961389962,65.8944658944659,33.71943371943372
053F,05,3F,0,807,4,803,444,359,inf,0.49566294919454773,99.50433705080545,55.01858736059479,44.48574969021066
053G,05,3G,0,793,3,790,443,347,inf,0.37831021437578816,99.62168978562421,55.86380832282472,43.757881462799496
053H,05,3H,0,875,1,874,366,508,inf,0.1142857142857143,99.88571428571429,41.82857142857143,58.05714285714285
054A,05,4A,0,980,3,977,227,750,inf,0.30612244897959184,99.6938775510204,23.163265306122447,76.53061224489795
054B,05,4B,0,552,1,551,233,318,inf,0.18115942028985507,99.81884057971014,42.210144927536234,57.608695652173914
054C,05,4C,0,872,3,869,326,543,inf,0.34403669724770647,99.6559633027523,37.38532110091743,62.27064220183486
054D,05,4D,0,673,2,671,388,283,inf,0.2971768202080238,99.70282317979198,57.652303120356606,42.050520059435364
054E,05,4E,0,675,0,675,424,251,inf,0.0,100.0,62.81481481481481,37.18518518518519
054F,05,4F,0,817,2,815,530,285,inf,0.24479804161566704,99.75520195838433,64.87148102815178,34.883720930232556
054G,05,4G,0,892,5,887,508,379,inf,0.5605381165919282,99.43946188340807,56.95067264573991,42.488789237668165
054H,05,4H,0,845,0,845,203,642,inf,0.0,100.0,24.023668639053255,75.97633136094674
055A,05,5A,0,747,2,745,497,248,inf,0.2677376171352075,99.73226238286479,66.53279785809906,33.19946452476573
055B,05,5B,0,737,8,729,422,307,inf,1.0854816824966078,98.9145183175034,57.25915875169606,41.65535956580732
055C,05,5C,0,766,12,754,506,248,inf,1.5665796344647518,98.43342036553526,66.0574412532637,32.375979112271544
055D,05,5D,0,642,5,637,452,185,inf,0.778816199376947,99.22118380062305,70.40498442367601,28.81619937694704
055E,05,5E,0,618,7,611,426,185,inf,1.132686084142395,98.86731391585761,68.93203883495146,29.93527508090615
055F,05,5F,0,871,4,867,585,282,inf,0.4592422502870264,99.54075774971297,67.16417910447761,32.37657864523536
055G,05,5G,0,905,8,897,645,252,inf,0.8839779005524863,99.1160220994475,71.27071823204419,27.845303867403317
055H,05,5H,0,709,0,709,511,198,inf,0.0,100.0,72.07334273624824,27.926657263751764
055I,05,5I,0,547,2,545,404,141,inf,0.3656307129798903,99.6343692870201,73.85740402193784,25.776965265082268
055J,05,5J,0,490,0,490,378,112,inf,0.0,100.0,77.14285714285715,22.857142857142858
055K,05,5K,0,568,2,566,408,158,inf,0.35211267605633806,99.64788732394366,71.83098591549296,27.816901408450708
055L,05,5L,0,614,3,611,443,168,inf,0.4885993485342019,99.51140065146579,72.14983713355049,27.36156351791531
061A,06,1A,0,1098,17,1081,734,347,inf,1.5482695810564664,98.45173041894353,66.8488160291439,31.602914389799636
061B,06,1B,0,1113,5,1108,740,368,inf,0.44923629829290207,99.5507637017071,66.4869721473495,33.06379155435759
061C,06,1C,0,913,8,905,583,322,inf,0.8762322015334063,99.12376779846659,63.85542168674698,35.26834611171961
061D,06,1D,0,782,3,779,509,270,inf,0.3836317135549872,99.61636828644501,65.08951406649616,34.52685421994885
061E,06,1E,0,816,8,808,575,233,inf,0.9803921568627451,99.01960784313727,70.4656862745098,28.553921568627448
061F,06,1F,0,804,9,795,561,234,inf,1.1194029850746268,98.88059701492537,69.77611940298507,29.1044776119403
061G,06,1G,0,1116,13,1103,724,379,inf,1.1648745519713262,98.83512544802868,64.87455197132617,33.96057347670251
061H,06,1H,0,970,4,966,629,337,inf,0.4123711340206186,99.58762886597938,64.84536082474227,34.74226804123711
061I,06,1I,0,1016,6,1010,659,351,inf,0.5905511811023622,99.40944881889764,64.86220472440945,34.547244094488185
062A,06,2A,0,968,6,962,611,351,inf,0.6198347107438017,99.3801652892562,63.1198347107438,36.260330578512395
062B,06,2B,0,802,4,798,546,252,inf,0.4987531172069825,99.50124688279301,68.07980049875312,31.421446384039903
062C,06,2C,0,708,2,706,502,204,inf,0.2824858757062147,99.71751412429379,70.90395480225989,28.8135593220339
062D,06,2D,0,911,12,899,650,249,inf,1.3172338090010975,98.6827661909989,71.35016465422612,27.332601536772778
062E,06,2E,0,863,7,856,577,279,inf,0.8111239860950173,99.18887601390497,66.85979142526072,32.329084588644264
062F,06,2F,0,805,4,801,574,227,inf,0.4968944099378882,99.50310559006212,71.30434782608695,28.19875776397516
062G,06,2G,0,1048,10,1038,710,328,inf,0.9541984732824428,99.04580152671755,67.74809160305344,31.297709923664126
062H,06,2H,0,738,9,729,488,241,inf,1.2195121951219512,98.78048780487805,66.12466124661248,32.65582655826558
062I,06,2I,0,893,9,884,595,289,inf,1.007838745800672,98.99216125419933,66.62933930571108,32.36282194848824
063A,06,3A,0,1095,4,1091,767,324,inf,0.365296803652968,99.63470319634703,70.04566210045662,29.589041095890412
063B,06,3B,0,972,5,967,641,326,inf,0.51440329218107,99.48559670781893,65.94650205761316,33.53909465020576
063C,06,3C,0,950,6,944,673,271,inf,0.631578947368421,99.36842105263159,70.84210526315789,28.52631578947368
063D,06,3D,0,1048,7,1041,699,342,inf,0.6679389312977099,99.33206106870229,66.69847328244275,32.63358778625955
063E,06,3E,0,1241,1,1240,888,352,inf,0.08058017727639001,99.91941982272361,71.55519742143433,28.364222401289286
063F,06,3F,0,1039,4,1035,746,289,inf,0.384985563041386,99.61501443695862,71.79980750721849,27.815206929740132
063G,06,3G,0,1172,10,1162,854,308,inf,0.8532423208191127,99.14675767918088,72.86689419795222,26.27986348122867
063H,06,3H,0,1084,9,1075,788,287,inf,0.8302583025830259,99.16974169741697,72.69372693726937,26.476014760147603
063I,06,3I,0,1151,8,1143,847,296,inf,0.6950477845351868,99.30495221546481,73.5881841876629,25.716768027801912
064A,06,4A,0,875,4,871,643,228,inf,0.4571428571428572,99.54285714285714,73.4857142857143,26.057142857142857
064B,06,4B,0,934,6,928,667,261,inf,0.6423982869379015,99.3576017130621,71.41327623126338,27.944325481798714
064C,06,4C,0,1026,6,1020,679,341,inf,0.5847953216374269,99.41520467836257,66.17933723196882,33.23586744639376
064D,06,4D,0,805,4,801,578,223,inf,0.4968944099378882,99.50310559006212,71.80124223602485,27.701863354037265
064E,06,4E,0,1014,8,1006,732,274,inf,0.7889546351084813,99.21104536489152,72.18934911242604,27.021696252465482
064F,06,4F,0,889,0,889,672,217,inf,0.0,100.0,75.59055118110236,24.409448818897637
064G,06,4G,0,876,7,869,643,226,inf,0.7990867579908676,99.20091324200914,73.40182648401826,25.799086757990867
064H,06,4H,0,846,3,843,597,246,inf,0.3546099290780142,99.64539007092199,70.56737588652481,29.078014184397162
065A,06,5A,0,750,5,745,522,223,inf,0.6666666666666667,99.33333333333333,69.6,29.733333333333334
065B,06,5B,0,981,8,973,684,289,inf,0.8154943934760449,99.18450560652396,69.72477064220183,29.45973496432212
065C,06,5C,0,649,8,641,467,174,inf,1.2326656394453006,98.7673343605547,71.9568567026194,26.810477657935284
065D,06,5D,0,845,3,842,597,245,inf,0.35502958579881655,99.64497041420118,70.6508875739645,28.994082840236686
065E,06,5E,0,748,6,742,523,219,inf,0.8021390374331552,99.19786096256684,69.91978609625669,29.27807486631016
065F,06,5F,0,580,0,580,450,130,inf,0.0,100.0,77.58620689655173,22.413793103448278
065G,06,5G,0,701,8,693,545,148,inf,1.1412268188302426,98.85877318116975,77.74607703281026,21.112696148359486
065H,06,5H,0,785,0,785,599,186,inf,0.0,100.0,76.30573248407644,23.694267515923567
065I,06,5I,0,553,2,551,422,129,inf,0.3616636528028933,99.63833634719711,76.31103074141049,23.32730560578662
066A,06,6A,0,882,5,877,610,267,inf,0.5668934240362812,99.43310657596372,69.1609977324263,30.272108843537417
066B,06,6B,0,872,11,861,582,279,inf,1.261467889908257,98.73853211009175,66.74311926605505,31.995412844036696
066C,06,6C,0,1004,4,1000,692,308,inf,0.398406374501992,99.60159362549801,68.92430278884463,30.677290836653388
066D,06,6D,0,1060,7,1053,734,319,inf,0.6603773584905661,99.33962264150942,69.24528301886792,30.09433962264151
066E,06,6E,0,1164,8,1156,860,296,inf,0.6872852233676976,99.3127147766323,73.8831615120275,25.42955326460481
066F,06,6F,0,1069,10,1059,739,320,inf,0.9354536950420954,99.0645463049579,69.13002806361085,29.934518241347053
066G,06,6G,0,880,8,872,641,231,inf,0.9090909090909091,99.0909090909091,72.8409090909091,26.25
066H,06,6H,0,1024,11,1013,690,323,inf,1.07421875,98.92578125,67.3828125,31.54296875
066I,06,6I,0,1563,5,1558,1256,302,inf,0.3198976327575176,99.68010236724248,80.35828534868841,19.321817018554064
067A,06,7A,0,832,5,827,614,213,inf,0.6009615384615385,99.39903846153845,73.79807692307693,25.600961538461537
067B,06,7B,0,1000,4,996,753,243,inf,0.4,99.6,75.3,24.3
067C,06,7C,0,819,0,819,611,208,inf,0.0,100.0,74.60317460317461,25.396825396825395
067D,06,7D,0,1157,3,1154,846,308,inf,0.25929127052722556,99.74070872947277,73.12013828867762,26.62057044079516
067E,06,7E,0,891,7,884,642,242,inf,0.7856341189674524,99.21436588103255,72.05387205387206,27.160493827160494
067F,06,7F,0,908,5,903,629,274,inf,0.5506607929515419,99.44933920704845,69.27312775330397,30.176211453744493
067G,06,7G,0,1181,1,1180,875,305,inf,0.0846740050804403,99.91532599491956,74.08975444538527,25.825571549534292
067H,06,7H,0,1270,10,1260,900,360,inf,0.7874015748031495,99.21259842519686,70.86614173228347,28.346456692913385
067I,06,7I,0,1067,8,1059,788,271,inf,0.7497656982193065,99.2502343017807,73.85192127460168,25.398313027179007
071A,07,1A,0,860,4,856,620,236,inf,0.46511627906976744,99.53488372093024,72.09302325581395,27.44186046511628
071B,07,1B,0,630,7,623,364,259,inf,1.1111111111111112,98.88888888888889,57.77777777777777,41.11111111111111
071C,07,1C,0,762,12,750,378,372,inf,1.574803149606299,98.4251968503937,49.60629921259843,48.818897637795274
071D,07,1D,0,781,3,778,428,350,inf,0.3841229193341869,99.61587708066581,54.80153649167734,44.81434058898848
071E,07,1E,0,1173,1,1172,719,453,inf,0.08525149190110827,99.9147485080989,61.29582267689685,38.61892583120204
071F,07,1F,0,1055,1,1054,700,354,inf,0.09478672985781991,99.90521327014218,66.35071090047393,33.55450236966825
071G,07,1G,0,1068,11,1057,650,407,inf,1.0299625468164793,98.97003745318352,60.86142322097379,38.10861423220974
071H,07,1H,0,989,3,986,666,320,inf,0.3033367037411527,99.69666329625885,67.3407482305359,32.355915065722954
071I,07,1I,0,883,8,875,515,360,inf,0.9060022650056626,99.09399773499433,58.323895809739525,40.770101925254814
072A,07,2A,0,1110,13,1097,668,429,inf,1.1711711711711712,98.82882882882883,60.18018018018017,38.648648648648646
072B,07,2B,0,1103,20,1083,901,182,inf,1.813236627379873,98.18676337262012,81.68631006346328,16.500453309156846
072C,07,2C,0,791,6,785,398,387,inf,0.7585335018963337,99.24146649810368,50.316055625790135,48.92541087231353
072D,07,2D,0,732,7,725,403,322,inf,0.9562841530054645,99.04371584699454,55.05464480874317,43.98907103825137
072E,07,2E,0,803,16,787,385,402,inf,1.9925280199252802,98.00747198007473,47.94520547945205,50.06226650062266
072F,07,2F,0,821,9,812,334,478,inf,1.0962241169305724,98.90377588306943,40.68209500609014,58.2216808769793
072G,07,2G,0,956,10,946,574,372,inf,1.0460251046025104,98.9539748953975,60.04184100418411,38.912133891213394
072H,07,2H,0,950,6,944,466,478,inf,0.631578947368421,99.36842105263159,49.05263157894737,50.31578947368421
072I,07,2I,0,604,5,599,268,331,inf,0.8278145695364238,99.17218543046357,44.370860927152314,54.80132450331126
073A,07,3A,0,1005,11,994,565,429,inf,1.0945273631840797,98.90547263681592,56.21890547263681,42.68656716417911
073B,07,3B,0,885,7,878,488,390,inf,0.7909604519774011,99.2090395480226,55.14124293785311,44.06779661016949
073C,07,3C,0,1077,6,1071,584,487,inf,0.5571030640668524,99.44289693593315,54.22469823584029,45.21819870009285
073D,07,3D,0,1043,5,1038,552,486,inf,0.4793863854266539,99.52061361457335,52.92425695110259,46.59635666347076
073E,07,3E,0,1139,5,1134,623,511,inf,0.4389815627743635,99.56101843722564,54.69710272168569,44.863915715539946
073F,07,3F,0,900,4,896,545,351,inf,0.4444444444444444,99.55555555555556,60.55555555555555,39.0
073G,07,3G,0,1164,5,1159,696,463,inf,0.429553264604811,99.5704467353952,59.79381443298969,39.776632302405496
073H,07,3H,0,620,6,614,306,308,inf,0.967741935483871,99.03225806451613,49.354838709677416,49.67741935483871
073I,07,3I,0,635,9,626,380,246,inf,1.4173228346456692,98.58267716535433,59.84251968503938,38.74015748031496
073K,07,3K,0,702,3,699,519,180,inf,0.4273504273504274,99.57264957264957,73.93162393162393,25.64102564102564
074A,07,4A,0,938,7,931,476,455,inf,0.7462686567164178,99.25373134328358,50.74626865671642,48.507462686567166
074B,07,4B,0,843,7,836,462,374,inf,0.8303677342823249,99.16963226571768,54.804270462633454,44.36536180308423
074C,07,4C,0,855,16,839,558,281,inf,1.8713450292397662,98.12865497076024,65.26315789473685,32.865497076023395
074D,07,4D,0,1055,9,1046,749,297,inf,0.8530805687203791,99.14691943127963,70.99526066350711,28.151658767772513
074E,07,4E,0,1069,7,1062,703,359,inf,0.6548175865294669,99.34518241347054,65.7623947614593,33.58278765201123
074F,07,4F,0,819,6,813,506,307,inf,0.7326007326007326,99.26739926739927,61.78266178266178,37.48473748473749
074G,07,4G,0,1018,15,1003,574,429,inf,1.4734774066797642,98.52652259332024,56.385068762278976,42.14145383104126
074H,07,4H,0,1010,8,1002,620,382,inf,0.7920792079207921,99.20792079207921,61.386138613861384,37.82178217821782
074I,07,4I,0,326,2,324,198,126,inf,0.6134969325153374,99.38650306748467,60.73619631901841,38.65030674846626
075A,07,5A,0,824,4,820,581,239,inf,0.48543689320388345,99.51456310679612,70.50970873786407,29.004854368932037
075B,07,5B,0,756,9,747,504,243,inf,1.1904761904761905,98.80952380952381,66.66666666666666,32.142857142857146
075C,07,5C,0,741,4,737,495,242,inf,0.5398110661268556,99.46018893387314,66.80161943319838,32.65856950067476
075D,07,5D,0,875,8,867,629,238,inf,0.9142857142857144,99.08571428571429,71.88571428571429,27.200000000000003
075E,07,5E,0,993,5,988,724,264,inf,0.5035246727089627,99.49647532729104,72.9103726082578,26.586102719033235
075F,07,5F,0,681,3,678,489,189,inf,0.4405286343612335,99.55947136563876,71.80616740088107,27.75330396475771
075G,07,5G,0,853,6,847,661,186,inf,0.7033997655334115,99.2966002344666,77.49120750293083,21.805392731535754
075H,07,5H,0,915,6,909,636,273,inf,0.6557377049180327,99.34426229508196,69.50819672131148,29.836065573770494
075I,07,5I,0,519,3,516,361,155,inf,0.5780346820809248,99.42196531791907,69.55684007707129,29.865125240847785
076A,07,6A,0,877,12,865,622,243,inf,1.3683010262257698,98.63169897377423,70.92360319270239,27.708095781071833
076B,07,6B,0,1202,10,1192,844,348,inf,0.8319467554076538,99.16805324459234,70.21630615640599,28.95174708818636
076C,07,6C,0,813,10,803,582,221,inf,1.2300123001230012,98.76998769987699,71.58671586715867,27.183271832718326
076D,07,6D,0,655,1,654,460,194,inf,0.15267175572519084,99.84732824427482,70.22900763358778,29.61832061068702
076E,07,6E,0,834,1,833,664,169,inf,0.1199040767386091,99.8800959232614,79.61630695443645,20.26378896882494
076F,07,6F,0,568,6,562,424,138,inf,1.056338028169014,98.94366197183099,74.64788732394366,24.295774647887324
076G,07,6G,0,644,1,643,492,151,inf,0.15527950310559005,99.84472049689441,76.3975155279503,23.4472049689441
076H,07,6H,0,1059,2,1057,804,253,inf,0.18885741265344666,99.81114258734655,75.92067988668555,23.890462700661
076I,07,6I,0,572,0,572,428,144,inf,0.0,100.0,74.82517482517483,25.174825174825177
077A,07,7A,0,984,8,976,740,236,inf,0.8130081300813009,99.1869918699187,75.20325203252033,23.983739837398375
077B,07,7B,0,1018,4,1014,763,251,inf,0.3929273084479371,99.60707269155206,74.950884086444,24.656188605108053
077C,07,7C,0,857,4,853,642,211,inf,0.4667444574095682,99.53325554259042,74.9124854142357,24.620770128354728
077D,07,7D,0,1008,7,1001,781,220,inf,0.6944444444444444,99.30555555555556,77.48015873015873,21.825396825396826
077E,07,7E,0,706,7,699,539,160,inf,0.9915014164305949,99.0084985835694,76.34560906515581,22.6628895184136
077F,07,7F,0,683,7,676,551,125,inf,1.0248901903367496,98.97510980966325,80.67349926793558,18.301610541727673
077G,07,7G,0,804,6,798,624,174,inf,0.7462686567164178,99.25373134328358,77.61194029850746,21.641791044776117
077H,07,7H,0,877,11,866,724,142,inf,1.2542759407069555,98.74572405929305,82.55416191562144,16.191562143671607
077I,07,7I,0,874,5,869,626,243,inf,0.5720823798627002,99.4279176201373,71.62471395881008,27.80320366132723
081A,08,1A,0,1114,16,1098,462,636,inf,1.436265709156194,98.56373429084381,41.4721723518851,57.09156193895871
081B,08,1B,0,1054,20,1034,415,619,inf,1.8975332068311195,98.10246679316889,39.37381404174573,58.72865275142315
081C,08,1C,0,941,12,929,419,510,inf,1.2752391073326248,98.72476089266738,44.52709883103082,54.19766206163656
081D,08,1D,0,1034,21,1013,478,535,inf,2.0309477756286265,97.96905222437138,46.22823984526112,51.74081237911026
081E,08,1E,0,909,14,895,452,443,inf,1.54015401540154,98.45984598459846,49.72497249724972,48.734873487348736
081F,08,1F,0,886,15,871,437,434,inf,1.6930022573363432,98.30699774266365,49.32279909706546,48.98419864559819
082A,08,2A,0,469,13,456,286,170,inf,2.771855010660981,97.22814498933901,60.98081023454158,36.247334754797436
082B,08,2B,0,1247,16,1231,547,684,inf,1.2830793905372895,98.7169206094627,43.86527666399358,54.85164394546913
082C,08,2C,0,1197,19,1178,470,708,inf,1.5873015873015872,98.4126984126984,39.264828738512946,59.14786967418546
082D,08,2D,0,1222,13,1209,552,657,inf,1.0638297872340425,98.93617021276596,45.171849427168574,53.764320785597384
082E,08,2E,0,1373,21,1352,612,740,inf,1.529497450837582,98.47050254916242,44.57392571012382,53.8965768390386
083A,08,3A,0,967,15,952,352,600,inf,1.5511892450879008,98.4488107549121,36.40124095139607,62.04756980351603
083B,08,3B,0,937,14,923,361,562,inf,1.4941302027748131,98.50586979722519,38.52721451440768,59.978655282817506
083C,08,3C,0,1181,115,1066,451,615,inf,9.737510584250634,90.26248941574937,38.187976291278574,52.07451312447079
083D,08,3D,0,1005,11,994,520,474,inf,1.0945273631840797,98.90547263681592,51.741293532338304,47.16417910447761
083E,08,3E,0,1003,15,988,663,325,inf,1.4955134596211366,98.50448654037886,66.10169491525424,32.40279162512463
084A,08,4A,0,1121,13,1108,613,495,inf,1.159678858162355,98.84032114183765,54.68331846565566,44.157002676181975
084B,08,4B,0,1035,11,1024,696,328,inf,1.0628019323671498,98.93719806763285,67.2463768115942,31.69082125603865
084C,08,4C,0,1198,11,1187,809,378,inf,0.9181969949916527,99.08180300500835,67.52921535893155,31.552587646076795
084D,08,4D,0,847,5,842,582,260,inf,0.5903187721369539,99.40968122786305,68.71310507674144,30.696576151121608
084E,08,4E,0,1215,4,1211,889,322,inf,0.3292181069958848,99.67078189300412,73.1687242798354,26.502057613168724
084F,08,4F,0,986,4,982,732,250,inf,0.4056795131845842,99.59432048681542,74.2393509127789,25.354969574036513
085A,08,5A,0,1060,110,950,709,241,inf,10.377358490566039,89.62264150943396,66.88679245283019,22.735849056603776
085B,08,5B,0,944,2,942,663,279,inf,0.211864406779661,99.78813559322035,70.23305084745762,29.55508474576271
085C,08,5C,0,1049,4,1045,767,278,inf,0.3813155386081983,99.61868446139181,73.11725452812202,26.501429933269783
085D,08,5D,0,932,3,929,712,217,inf,0.3218884120171674,99.67811158798283,76.39484978540773,23.283261802575105
085E,08,5E,0,1114,5,1109,820,289,inf,0.4488330341113106,99.5511669658887,73.60861759425494,25.94254937163375
085F,08,5F,0,810,62,748,544,204,inf,7.654320987654321,92.34567901234568,67.1604938271605,25.185185185185183
086A,08,6A,0,826,4,822,595,227,inf,0.48426150121065376,99.51573849878935,72.03389830508475,27.4818401937046
086B,08,6B,0,709,1,708,534,174,inf,0.14104372355430184,99.8589562764457,75.31734837799718,24.541607898448518
086C,08,6C,0,870,5,865,636,229,inf,0.5747126436781609,99.42528735632183,73.10344827586206,26.321839080459768
086D,08,6D,0,756,4,752,564,188,inf,0.5291005291005291,99.47089947089947,74.60317460317461,24.867724867724867
086E,08,6E,0,875,11,864,629,235,inf,1.2571428571428571,98.74285714285715,71.88571428571429,26.857142857142858
086F,08,6F,0,716,6,710,523,187,inf,0.8379888268156425,99.16201117318437,73.04469273743017,26.11731843575419
087A,08,7A,0,1161,9,1152,830,322,inf,0.7751937984496124,99.2248062015504,71.49009474590869,27.734711455641687
087B,08,7B,0,1012,106,906,676,230,inf,10.474308300395258,89.52569169960475,66.79841897233202,22.727272727272727
087C,08,7C,0,1062,10,1052,744,308,inf,0.9416195856873822,99.05838041431262,70.05649717514125,29.001883239171374
087D,08,7D,0,860,3,857,636,221,inf,0.3488372093023256,99.65116279069768,73.95348837209302,25.69767441860465
087E,08,7E,0,1026,2,1024,737,287,inf,0.1949317738791423,99.80506822612085,71.83235867446393,27.972709551656923
087F,08,7F,0,803,2,801,579,222,inf,0.24906600249066002,99.75093399750934,72.10460772104608,27.646326276463263
091A,09,1A,0,1319,15,1304,542,762,inf,1.1372251705837757,98.86277482941622,41.09173616376042,57.77103866565581
091B,09,1B,0,1858,19,1839,820,1019,inf,1.022604951560818,98.97739504843919,44.13347685683531,54.843918191603876
091C,09,1C,0,1032,0,1032,514,518,inf,0.0,100.0,49.8062015503876,50.1937984496124
091D,09,1D,0,1036,9,1027,485,542,inf,0.8687258687258688,99.13127413127413,46.81467181467182,52.316602316602314
091E,09,1E,0,1442,14,1428,719,709,inf,0.9708737864077669,99.02912621359224,49.86130374479889,49.16782246879335
092A,09,2A,0,1405,11,1394,743,651,inf,0.7829181494661922,99.2170818505338,52.88256227758007,46.33451957295374
092B,09,2B,0,1198,0,1198,636,562,inf,0.0,100.0,53.08848080133556,46.91151919866444
092C,09,2C,0,802,3,799,425,374,inf,0.3740648379052369,99.62593516209476,52.9925187032419,46.633416458852864
092D,09,2D,0,788,7,781,409,372,inf,0.8883248730964468,99.11167512690355,51.90355329949239,47.20812182741117
092E,09,2E,0,1016,14,1002,503,499,inf,1.3779527559055118,98.62204724409449,49.50787401574803,49.11417322834646
092F,09,2F,0,1218,18,1200,620,580,inf,1.477832512315271,98.52216748768473,50.90311986863711,47.61904761904761
093A,09,3A,0,1334,16,1318,642,676,inf,1.199400299850075,98.80059970014993,48.125937031484256,50.67466266866567
093B,09,3B,0,1348,14,1334,706,628,inf,1.0385756676557862,98.96142433234422,52.37388724035609,46.58753709198813
093C,09,3C,0,1328,5,1323,810,513,inf,0.37650602409638556,99.62349397590361,60.99397590361446,38.62951807228915
093D,09,3D,0,1128,5,1123,668,455,inf,0.44326241134751776,99.55673758865248,59.21985815602837,40.33687943262411
093E,09,3E,0,824,4,820,488,332,inf,0.48543689320388345,99.51456310679612,59.22330097087378,40.29126213592233
094A,09,4A,0,1391,11,1380,1328,52,inf,0.7907979870596693,99.20920201294034,95.47088425593098,3.7383177570093453
094B,09,4B,0,1139,12,1127,672,455,inf,1.0535557506584723,98.94644424934152,58.999122036874454,39.94732221246708
094C,09,4C,0,1347,9,1338,687,651,inf,0.6681514476614699,99.33184855233853,51.00222717149221,48.329621380846326
094D,09,4D,0,1172,20,1152,614,538,inf,1.7064846416382253,98.29351535836177,52.389078498293514,45.90443686006826
094E,09,4E,0,1429,4,1425,1179,246,inf,0.27991602519244224,99.72008397480757,82.50524842547236,17.2148355493352
095A,09,5A,0,1068,10,1058,591,467,inf,0.9363295880149813,99.06367041198502,55.33707865168539,43.72659176029963
095B,09,5B,0,1126,11,1115,616,499,inf,0.9769094138543518,99.02309058614564,54.70692717584369,44.316163410301954
095C,09,5C,0,897,11,886,524,362,inf,1.2263099219620959,98.7736900780379,58.41694537346711,40.356744704570794
095D,09,5D,0,1281,34,1247,758,489,inf,2.6541764246682282,97.34582357533176,59.17252146760343,38.17330210772833
095E,09,5E,0,1109,4,1105,966,139,inf,0.36068530207394045,99.63931469792607,87.10550045085664,12.533814247069433
096A,09,6A,0,1339,9,1330,837,493,inf,0.6721433905899925,99.32785660941,62.50933532486931,36.8185212845407
096B,09,6B,0,1376,13,1363,851,512,inf,0.944767441860465,99.05523255813954,61.845930232558146,37.2093023255814
096C,09,6C,0,1148,1,1147,640,507,inf,0.08710801393728224,99.91289198606272,55.749128919860624,44.16376306620209
096D,09,6D,0,1193,15,1178,622,556,inf,1.2573344509639564,98.74266554903605,52.137468566638724,46.60519698239732
096E,09,6E,0,1502,5,1497,1129,368,inf,0.3328894806924101,99.66711051930758,75.16644474034621,24.500665778961384
101A,10,1A,0,386,2,384,190,194,inf,0.5181347150259068,99.48186528497409,49.22279792746114,50.259067357512954
101B,10,1B,0,321,0,321,177,144,inf,0.0,100.0,55.140186915887845,44.85981308411215
101C,10,1C,0,454,3,451,240,211,inf,0.6607929515418502,99.33920704845815,52.863436123348016,46.47577092511013
101D,10,1D,0,438,1,437,216,221,inf,0.228310502283105,99.77168949771689,49.31506849315068,50.456621004566216
101E,10,1E,0,640,11,629,321,308,inf,1.7187500000000002,98.28125,50.15625,48.125
101F,10,1F,0,570,1,569,286,283,inf,0.17543859649122806,99.82456140350877,50.175438596491226,49.64912280701754
101G,10,1G,0,315,0,315,151,164,inf,0.0,100.0,47.93650793650794,52.06349206349207
101H,10,1H,0,396,3,393,221,172,inf,0.7575757575757576,99.24242424242425,55.80808080808081,43.43434343434344
102A,10,2A,0,515,0,515,281,234,inf,0.0,100.0,54.5631067961165,45.43689320388349
102B,10,2B,0,495,6,489,236,253,inf,1.2121212121212122,98.7878787878788,47.67676767676768,51.11111111111111
102C,10,2C,0,400,2,398,202,196,inf,0.5,99.5,50.5,49.0
102D,10,2D,0,513,3,510,239,271,inf,0.5847953216374269,99.41520467836257,46.588693957115005,52.826510721247566
102E,10,2E,0,372,4,368,193,175,inf,1.0752688172043012,98.9247311827957,51.88172043010753,47.043010752688176
102F,10,2F,0,412,3,409,186,223,inf,0.7281553398058253,99.27184466019418,45.14563106796117,54.12621359223301
102G,10,2G,0,501,3,498,230,268,inf,0.5988023952095809,99.40119760479041,45.90818363273453,53.49301397205589
102H,10,2H,0,277,2,275,101,174,inf,0.7220216606498195,99.27797833935018,36.462093862815884,62.8158844765343
102J,10,2J,0,295,2,293,153,140,inf,0.6779661016949152,99.32203389830508,51.864406779661024,47.45762711864407
102K,10,2K,0,325,4,321,149,172,inf,1.2307692307692308,98.76923076923076,45.84615384615385,52.92307692307693
102L,10,2L,0,426,0,426,218,208,inf,0.0,100.0,51.173708920187785,48.82629107981221
102M,10,2M,0,343,1,342,183,159,inf,0.2915451895043732,99.70845481049562,53.352769679300295,46.35568513119534
103A,10,3A,0,360,1,359,188,171,inf,0.2777777777777778,99.72222222222223,52.22222222222223,47.5
103B,10,3B,0,306,3,303,186,117,inf,0.9803921568627451,99.01960784313727,60.78431372549019,38.23529411764706
103C,10,3C,0,448,0,448,233,215,inf,0.0,100.0,52.00892857142857,47.99107142857143
103D,10,3D,0,390,3,387,216,171,inf,0.7692307692307693,99.23076923076923,55.38461538461539,43.84615384615385
103E,10,3E,0,473,0,473,275,198,inf,0.0,100.0,58.139534883720934,41.86046511627907
103F,10,3F,0,482,2,480,260,220,inf,0.4149377593360996,99.5850622406639,53.941908713692946,45.643153526970956
103G,10,3G,0,515,9,506,263,243,inf,1.7475728155339807,98.25242718446601,51.067961165048544,47.18446601941748
103H,10,3H,0,556,2,554,310,244,inf,0.3597122302158274,99.64028776978418,55.75539568345324,43.884892086330936
104A,10,4A,0,276,3,273,122,151,inf,1.0869565217391304,98.91304347826086,44.20289855072464,54.710144927536234
104B,10,4B,0,576,9,567,300,267,inf,1.5625,98.4375,52.083333333333336,46.35416666666667
104C,10,4C,0,323,2,321,151,170,inf,0.6191950464396285,99.38080495356037,46.749226006191954,52.63157894736842
104D,10,4D,0,513,7,506,223,283,inf,1.364522417153996,98.635477582846,43.46978557504873,55.165692007797276
104E,10,4E,0,337,2,335,126,209,inf,0.5934718100890208,99.40652818991099,37.388724035608305,62.01780415430267
104F,10,4F,0,406,2,404,167,237,inf,0.49261083743842365,99.50738916256158,41.13300492610838,58.3743842364532
104G,10,4G,0,529,2,527,246,281,inf,0.3780718336483932,99.62192816635161,46.502835538752365,53.119092627599244
104H,10,4H,0,448,0,448,190,258,inf,0.0,100.0,42.410714285714285,57.58928571428571
104J,10,4J,0,443,8,435,215,220,inf,1.805869074492099,98.1941309255079,48.53273137697517,49.66139954853273
104K,10,4K,0,574,10,564,288,276,inf,1.7421602787456445,98.25783972125436,50.174216027874564,48.08362369337979
104L,10,4L,0,458,4,454,193,261,inf,0.8733624454148471,99.12663755458514,42.13973799126637,56.98689956331878
104M,10,4M,0,441,4,437,191,246,inf,0.9070294784580499,99.09297052154194,43.31065759637188,55.78231292517006
104N,10,4N,0,425,3,422,182,240,inf,0.7058823529411765,99.29411764705883,42.8235294117647,56.470588235294116
104P,10,4P,0,537,1,536,260,276,inf,0.186219739292365,99.81378026070763,48.4171322160149,51.39664804469274
105A,10,5A,0,443,6,437,213,224,inf,1.3544018058690745,98.64559819413093,48.081264108352144,50.56433408577878
105B,10,5B,0,480,2,478,204,274,inf,0.4166666666666667,99.58333333333333,42.5,57.08333333333333
105C,10,5C,0,407,3,404,194,210,inf,0.7371007371007371,99.26289926289927,47.665847665847664,51.5970515970516
105D,10,5D,0,453,0,453,191,262,inf,0.0,100.0,42.16335540838852,57.836644591611474
105E,10,5E,0,399,1,398,191,207,inf,0.2506265664160401,99.74937343358395,47.86967418546366,51.8796992481203
105F,10,5F,0,410,7,403,179,224,inf,1.707317073170732,98.29268292682927,43.65853658536585,54.63414634146342
105G,10,5G,0,335,5,330,159,171,inf,1.4925373134328357,98.50746268656717,47.462686567164184,51.04477611940299
105H,10,5H,0,333,0,333,157,176,inf,0.0,100.0,47.147147147147145,52.85285285285285
105J,10,5J,0,349,3,346,186,160,inf,0.8595988538681949,99.14040114613181,53.29512893982808,45.845272206303726
105K,10,5K,0,399,1,398,182,216,inf,0.2506265664160401,99.74937343358395,45.614035087719294,54.13533834586466
105L,10,5L,0,443,1,442,212,230,inf,0.2257336343115124,99.77426636568849,47.855530474040634,51.91873589164786
105M,10,5M,0,319,2,317,135,182,inf,0.6269592476489028,99.37304075235109,42.31974921630094,57.05329153605015
105N,10,5N,0,423,4,419,175,244,inf,0.9456264775413712,99.05437352245863,41.371158392434985,57.68321513002365
105P,10,5P,0,516,5,511,279,232,inf,0.9689922480620154,99.03100775193798,54.06976744186046,44.96124031007752
105Q,10,5Q,0,461,1,460,216,244,inf,0.21691973969631237,99.78308026030369,46.85466377440347,52.92841648590022
105R,10,5R,0,425,3,422,186,236,inf,0.7058823529411765,99.29411764705883,43.76470588235294,55.529411764705884
105S,10,5S,0,507,4,503,202,301,inf,0.7889546351084813,99.21104536489152,39.8422090729783,59.36883629191322
106A,10,6A,0,360,5,355,204,151,inf,1.3888888888888888,98.61111111111111,56.666666666666664,41.94444444444444
106B,10,6B,0,547,7,540,318,222,inf,1.2797074954296161,98.72029250457038,58.13528336380256,40.58500914076782
106C,10,6C,0,320,5,315,153,162,inf,1.5625,98.4375,47.8125,50.625
106D,10,6D,0,636,0,636,315,321,inf,0.0,100.0,49.528301886792455,50.47169811320755
106E,10,6E,0,405,2,403,199,204,inf,0.49382716049382713,99.50617283950616,49.135802469135804,50.37037037037037
106F,10,6F,0,296,6,290,140,150,inf,2.027027027027027,97.97297297297297,47.2972972972973,50.67567567567568
106G,10,6G,0,655,6,649,307,342,inf,0.9160305343511451,99.08396946564886,46.87022900763359,52.213740458015266
106H,10,6H,0,482,2,480,192,288,inf,0.4149377593360996,99.5850622406639,39.83402489626556,59.75103734439834
106J,10,6J,0,420,6,414,231,183,inf,1.4285714285714286,98.57142857142858,55.00000000000001,43.57142857142857
106K,10,6K,0,396,5,391,222,169,inf,1.2626262626262625,98.73737373737373,56.060606060606055,42.676767676767675
111A,11,1A,0,394,2,392,136,256,inf,0.5076142131979695,99.49238578680203,34.51776649746193,64.9746192893401
111B,11,1B,0,774,0,774,192,582,inf,0.0,100.0,24.8062015503876,75.1937984496124
111C,11,1C,0,474,2,472,181,291,inf,0.42194092827004215,99.57805907172997,38.18565400843882,61.39240506329114
111D,11,1D,0,582,5,577,247,330,inf,0.859106529209622,99.14089347079039,42.439862542955325,56.70103092783505
111E,11,1E,0,538,2,536,239,297,inf,0.37174721189591076,99.62825278810409,44.42379182156134,55.20446096654275
111F,11,1F,0,489,1,488,201,287,inf,0.2044989775051125,99.79550102249489,41.104294478527606,58.691206543967276
111G,11,1G,0,473,2,471,220,251,inf,0.42283298097251587,99.57716701902748,46.51162790697674,53.06553911205074
111H,11,1H,0,579,8,571,260,311,inf,1.381692573402418,98.61830742659758,44.90500863557859,53.71329879101899
112A,11,2A,0,514,1,513,165,348,inf,0.19455252918287938,99.80544747081711,32.1011673151751,67.70428015564202
112B,11,2B,0,430,0,430,186,244,inf,0.0,100.0,43.25581395348837,56.74418604651162
112C,11,2C,0,323,0,323,152,171,inf,0.0,100.0,47.05882352941176,52.94117647058824
112D,11,2D,0,550,1,549,273,276,inf,0.18181818181818182,99.81818181818181,49.63636363636363,50.18181818181818
112E,11,2E,0,761,5,756,230,526,inf,0.657030223390276,99.34296977660972,30.223390275952696,69.11957950065704
112F,11,2F,0,604,7,597,268,329,inf,1.1589403973509933,98.84105960264901,44.370860927152314,54.47019867549668
112G,11,2G,0,696,6,690,274,416,inf,0.8620689655172413,99.13793103448276,39.36781609195402,59.77011494252874
112H,11,2H,0,483,1,482,209,273,inf,0.2070393374741201,99.79296066252587,43.2712215320911,56.52173913043478
112I,11,2I,0,369,4,365,184,181,inf,1.084010840108401,98.91598915989161,49.86449864498645,49.05149051490515
112J,11,2J,0,473,2,471,253,218,inf,0.42283298097251587,99.57716701902748,53.48837209302325,46.088794926004226
113A,11,3A,0,536,22,514,294,220,inf,4.104477611940299,95.8955223880597,54.850746268656714,41.04477611940299
113B,11,3B,0,542,4,538,266,272,inf,0.7380073800738007,99.2619926199262,49.07749077490775,50.184501845018445
113C,11,3C,0,382,1,381,203,178,inf,0.2617801047120419,99.73821989528795,53.141361256544506,46.596858638743456
113D,11,3D,0,346,3,343,175,168,inf,0.8670520231213872,99.13294797687861,50.57803468208093,48.554913294797686
113E,11,3E,0,462,1,461,231,230,inf,0.21645021645021645,99.78354978354979,50.0,49.78354978354979
113F,11,3F,0,505,2,503,235,268,inf,0.39603960396039606,99.60396039603961,46.53465346534654,53.069306930693074
113G,11,3G,0,511,6,505,236,269,inf,1.1741682974559686,98.82583170254404,46.1839530332681,52.64187866927593
113H,11,3H,0,579,2,577,293,284,inf,0.3454231433506045,99.65457685664938,50.604490500863555,49.05008635578584
113I,11,3I,0,478,0,478,249,229,inf,0.0,100.0,52.09205020920502,47.90794979079498
113J,11,3J,0,390,6,384,208,176,inf,1.5384615384615385,98.46153846153847,53.333333333333336,45.12820512820513
113K,11,3K,0,520,1,519,250,269,inf,0.19230769230769232,99.8076923076923,48.07692307692308,51.73076923076923
114A,11,4A,0,654,5,649,320,329,inf,0.764525993883792,99.2354740061162,48.92966360856269,50.30581039755352
114B,11,4B,0,606,0,606,265,341,inf,0.0,100.0,43.72937293729373,56.27062706270627
114C,11,4C,0,613,5,608,318,290,inf,0.8156606851549755,99.18433931484503,51.876019575856446,47.30831973898858
114D,11,4D,0,722,7,715,354,361,inf,0.9695290858725761,99.03047091412742,49.03047091412742,50.0
114E,11,4E,0,663,9,654,295,359,inf,1.3574660633484164,98.64253393665159,44.4947209653092,54.14781297134238
114F,11,4F,0,712,9,703,370,333,inf,1.2640449438202246,98.73595505617978,51.96629213483146,46.76966292134831
114G,11,4G,0,722,7,715,337,378,inf,0.9695290858725761,99.03047091412742,46.67590027700831,52.35457063711911
114H,11,4H,0,670,6,664,342,322,inf,0.8955223880597015,99.1044776119403,51.04477611940299,48.059701492537314
114I,11,4I,0,481,4,477,234,243,inf,0.8316008316008316,99.16839916839916,48.64864864864865,50.51975051975052
114J,11,4J,0,517,5,512,244,268,inf,0.9671179883945842,99.03288201160542,47.195357833655706,51.83752417794971
115A,11,5A,0,363,5,358,193,165,inf,1.3774104683195594,98.62258953168043,53.168044077134994,45.45454545454545
115B,11,5B,0,390,2,388,207,181,inf,0.5128205128205128,99.48717948717949,53.07692307692308,46.41025641025641
115C,11,5C,0,593,4,589,293,296,inf,0.6745362563237773,99.32546374367622,49.4097807757167,49.915682967959526
115D,11,5D,0,458,4,454,231,223,inf,0.8733624454148471,99.12663755458514,50.43668122270743,48.68995633187773
115E,11,5E,0,680,4,676,324,352,inf,0.5882352941176471,99.41176470588235,47.647058823529406,51.76470588235295
115F,11,5F,0,598,3,595,321,274,inf,0.5016722408026756,99.49832775919732,53.67892976588629,45.819397993311036
115G,11,5G,0,620,6,614,290,324,inf,0.967741935483871,99.03225806451613,46.774193548387096,52.25806451612903
115H,11,5H,0,662,6,656,313,343,inf,0.906344410876133,99.09365558912387,47.2809667673716,51.81268882175226
115I,11,5I,0,800,7,793,327,466,inf,0.8750000000000001,99.125,40.875,58.25
115J,11,5J,0,666,4,662,324,338,inf,0.6006006006006006,99.3993993993994,48.64864864864865,50.750750750750754
116A,11,6A,0,418,4,414,189,225,inf,0.9569377990430622,99.04306220095694,45.21531100478469,53.827751196172244
116B,11,6B,0,446,4,442,176,266,inf,0.8968609865470852,99.10313901345292,39.46188340807175,59.64125560538116
116C,11,6C,0,350,4,346,155,191,inf,1.1428571428571428,98.85714285714286,44.285714285714285,54.57142857142857
116D,11,6D,0,518,4,514,213,301,inf,0.7722007722007722,99.22779922779922,41.11969111969112,58.108108108108105
116E,11,6E,0,454,4,450,200,250,inf,0.881057268722467,99.11894273127754,44.052863436123346,55.06607929515418
116F,11,6F,0,350,5,345,165,180,inf,1.4285714285714286,98.57142857142858,47.14285714285714,51.42857142857142
116G,11,6G,0,498,2,496,209,287,inf,0.4016064257028112,99.59839357429718,41.967871485943775,57.63052208835341
116H,11,6H,0,505,5,500,267,233,inf,0.9900990099009901,99.00990099009901,52.87128712871287,46.13861386138614
116I,11,6I,0,421,0,421,186,235,inf,0.0,100.0,44.180522565320665,55.819477434679335
116J,11,6J,0,498,4,494,204,290,inf,0.8032128514056224,99.19678714859438,40.963855421686745,58.23293172690763
116K,11,6K,0,736,5,731,298,433,inf,0.6793478260869565,99.32065217391305,40.48913043478261,58.83152173913043
116L,11,6L,0,407,4,403,163,240,inf,0.9828009828009828,99.01719901719902,40.04914004914005,58.96805896805897
116M,11,6M,0,533,8,525,194,331,inf,1.5009380863039399,98.49906191369607,36.39774859287054,62.10131332082551
116N,11,6N,0,753,8,745,281,464,inf,1.0624169986719787,98.93758300132802,37.31739707835325,61.62018592297477
121A,12,1A,0,795,7,788,441,347,inf,0.8805031446540881,99.11949685534591,55.471698113207545,43.64779874213836
121B,12,1B,0,907,5,902,480,422,inf,0.5512679162072767,99.44873208379272,52.921719955898574,46.52701212789416
121C,12,1C,0,748,3,745,412,333,inf,0.4010695187165776,99.59893048128342,55.080213903743314,44.518716577540104
121D,12,1D,0,800,3,797,398,399,inf,0.375,99.625,49.75,49.875
121E,12,1E,0,777,6,771,366,405,inf,0.7722007722007722,99.22779922779922,47.10424710424711,52.123552123552116
121F,12,1F,0,848,0,848,461,387,inf,0.0,100.0,54.363207547169814,45.636792452830186
122A,12,2A,0,793,17,776,455,321,inf,2.1437578814627996,97.8562421185372,57.377049180327866,40.47919293820933
122B,12,2B,0,693,2,691,316,375,inf,0.2886002886002886,99.71139971139971,45.5988455988456,54.112554112554115
122C,12,2C,0,750,5,745,453,292,inf,0.6666666666666667,99.33333333333333,60.4,38.93333333333333
122D,12,2D,0,667,2,665,345,320,inf,0.29985007496251875,99.70014992503748,51.724137931034484,47.976011994002995
122E,12,2E,0,574,2,572,331,241,inf,0.34843205574912894,99.65156794425087,57.66550522648084,41.98606271777003
122F,12,2F,0,697,0,697,370,327,inf,0.0,100.0,53.08464849354376,46.91535150645624
122G,12,2G,0,579,1,578,293,285,inf,0.17271157167530224,99.8272884283247,50.604490500863555,49.22279792746114
122H,12,2H,0,798,0,798,426,372,inf,0.0,100.0,53.383458646616546,46.616541353383454
123A,12,3A,0,843,2,841,612,229,inf,0.2372479240806643,99.76275207591934,72.59786476868328,27.164887307236064
123B,12,3B,0,718,5,713,487,226,inf,0.6963788300835655,99.30362116991644,67.82729805013928,31.47632311977716
123C,12,3C,0,715,3,712,491,221,inf,0.4195804195804196,99.58041958041957,68.67132867132867,30.909090909090907
123D,12,3D,0,1144,0,1144,741,403,inf,0.0,100.0,64.77272727272727,35.22727272727273
123E,12,3E,0,696,6,690,405,285,inf,0.8620689655172413,99.13793103448276,58.189655172413794,40.94827586206897
123F,12,3F,0,1084,5,1079,675,404,inf,0.46125461254612543,99.53874538745387,62.26937269372693,37.269372693726936
123G,12,3G,0,583,4,579,405,174,inf,0.6861063464837049,99.31389365351629,69.46826758147513,29.845626072041163
123H,12,3H,0,587,1,586,398,188,inf,0.17035775127768313,99.82964224872232,67.80238500851789,32.027257240204435
123I,12,3I,0,1090,3,1087,555,532,inf,0.27522935779816515,99.72477064220183,50.917431192660544,48.80733944954129
124A,12,4A,0,612,1,611,388,223,inf,0.16339869281045752,99.83660130718954,63.39869281045751,36.43790849673202
124B,12,4B,0,829,4,825,583,242,inf,0.48250904704463204,99.51749095295537,70.32569360675512,29.191797346200243
124C,12,4C,0,637,0,637,429,208,inf,0.0,100.0,67.3469387755102,32.6530612244898
124D,12,4D,0,798,5,793,565,228,inf,0.6265664160401002,99.37343358395991,70.80200501253134,28.57142857142857
124E,12,4E,0,931,1,930,609,321,inf,0.10741138560687433,99.89258861439313,65.41353383458647,34.47905477980666
124F,12,4F,0,863,6,857,536,321,inf,0.6952491309385863,99.30475086906141,62.10892236384704,37.195828505214365
124G,12,4G,0,718,0,718,476,242,inf,0.0,100.0,66.29526462395543,33.70473537604457
124H,12,4H,0,953,3,950,609,341,inf,0.3147953830010493,99.68520461699894,63.90346274921301,35.78174186778594
124I,12,4I,0,719,3,716,472,244,inf,0.4172461752433936,99.58275382475661,65.64673157162726,33.936022253129345
125A,12,5A,0,760,6,754,548,206,inf,0.7894736842105263,99.21052631578947,72.10526315789474,27.105263157894736
125B,12,5B,0,789,3,786,565,221,inf,0.38022813688212925,99.61977186311786,71.60963244613436,28.010139416983527
125C,12,5C,0,772,4,768,606,162,inf,0.5181347150259068,99.48186528497409,78.49740932642487,20.984455958549223
125D,12,5D,0,886,4,882,664,218,inf,0.4514672686230248,99.54853273137697,74.94356659142211,24.604966139954854
125E,12,5E,0,698,2,696,524,172,inf,0.28653295128939826,99.7134670487106,75.07163323782235,24.641833810888254
126A,12,6A,0,723,2,721,505,216,inf,0.2766251728907331,99.72337482710927,69.84785615491009,29.87551867219917
126B,12,6B,0,929,5,924,666,258,inf,0.5382131324004306,99.46178686759957,71.68998923573736,27.771797631862217
126C,12,6C,0,643,3,640,428,212,inf,0.46656298600311047,99.53343701399689,66.56298600311042,32.97045101088647
126D,12,6D,0,759,2,757,567,190,inf,0.2635046113306983,99.7364953886693,74.70355731225297,25.03293807641634
126E,12,6E,0,597,0,597,441,156,inf,0.0,100.0,73.86934673366834,26.13065326633166
126F,12,6F,0,779,7,772,526,246,inf,0.8985879332477535,99.10141206675225,67.52246469833119,31.57894736842105
126G,12,6G,0,1025,3,1022,751,271,inf,0.2926829268292683,99.70731707317073,73.26829268292683,26.439024390243905
126H,12,6H,0,853,8,845,579,266,inf,0.9378663540445485,99.06213364595546,67.87807737397421,31.18405627198124
126I,12,6I,0,931,2,929,642,287,inf,0.21482277121374865,99.78517722878625,68.95810955961332,30.82706766917293
126J,12,6J,0,815,4,811,539,272,inf,0.49079754601227,99.50920245398774,66.13496932515336,33.374233128834355
