id,district_id,electoral_district_id,eligible_voters,voters,invalid_votes,valid_votes,vote_yes,vote_no,voter_turnout,invalid_votes_percentage,valid_votes_percentage,vote_yes_percentage,vote_no_percentage
01100,01,100,1269,572,13,559,358,201,0.4507486209613869,0.022727272727272728,0.9772727272727273,0.6258741258741258,0.3513986013986014
01101,01,101,1490,757,3,754,413,341,0.5080536912751678,0.003963011889035667,0.9960369881109643,0.5455746367239102,0.45046235138705415
01102,01,102,1306,603,10,593,357,236,0.46171516079632463,0.01658374792703151,0.9834162520729685,0.5920398009950248,0.3913764510779436
01103,01,103,1555,772,13,759,466,293,0.4964630225080386,0.01683937823834197,0.9831606217616581,0.6036269430051814,0.3795336787564767
01104,01,104,1241,611,16,595,336,259,0.492344883158743,0.02618657937806874,0.9738134206219312,0.5499181669394435,0.4238952536824877
01105,01,105,1049,509,15,494,273,221,0.4852240228789323,0.029469548133595286,0.9705304518664047,0.5363457760314342,0.43418467583497056
01106,01,106,1407,662,8,654,408,246,0.4705046197583511,0.012084592145015106,0.9879154078549849,0.6163141993957704,0.3716012084592145
01107,01,107,1111,612,8,604,341,263,0.5508550855085509,0.013071895424836602,0.9869281045751634,0.5571895424836601,0.4297385620915033
01108,01,108,1004,483,7,476,270,206,0.4810756972111554,0.014492753623188406,0.9855072463768116,0.5590062111801242,0.42650103519668736
01109,01,109,1133,536,16,520,352,168,0.4730803177405119,0.029850746268656716,0.9701492537313433,0.6567164179104478,0.31343283582089554
01110,01,110,1552,841,13,828,424,404,0.541881443298969,0.015457788347205707,0.9845422116527943,0.5041617122473246,0.4803804994054697
01111,01,111,1010,549,6,543,300,243,0.5435643564356436,0.01092896174863388,0.9890710382513661,0.546448087431694,0.4426229508196721
01112,01,112,1194,599,16,583,299,284,0.501675041876047,0.02671118530884808,0.9732888146911519,0.4991652754590985,0.4741235392320534
01113,01,113,1172,673,19,654,320,334,0.5742320819112628,0.02823179791976226,0.9717682020802377,0.475482912332838,0.4962852897473997
01114,01,114,1447,740,18,722,400,322,0.5114029025570145,0.024324324324324326,0.9756756756756757,0.5405405405405406,0.43513513513513513
01115,01,115,866,481,6,475,293,182,0.5554272517321016,0.012474012474012475,0.9875259875259875,0.6091476091476091,0.3783783783783784
01116,01,116,697,378,10,368,214,154,0.5423242467718795,0.026455026455026454,0.9735449735449735,0.5661375661375662,0.4074074074074074
01117,01,117,1486,861,22,839,415,424,0.5794078061911171,0.025551684088269456,0.9744483159117305,0.4819976771196283,0.4924506387921022
01118,01,118,1148,664,20,644,316,328,0.578397212543554,0.030120481927710843,0.9698795180722891,0.4759036144578313,0.4939759036144578
01119,01,119,877,506,7,499,211,288,0.5769669327251995,0.01383399209486166,0.9861660079051383,0.41699604743083,0.5691699604743083
01120,01,120,1066,544,13,531,262,269,0.5103189493433395,0.02389705882352941,0.9761029411764706,0.48161764705882354,0.4944852941176471
01121,01,121,1089,554,16,538,286,252,0.5087235996326905,0.02888086642599278,0.9711191335740073,0.516245487364621,0.4548736462093863
01122,01,122,1204,643,13,630,313,317,0.5340531561461794,0.02021772939346812,0.9797822706065319,0.4867807153965785,0.49300155520995337
01123,01,123,1006,520,13,507,261,246,0.5168986083499006,0.025,0.975,0.5019230769230769,0.47307692307692306
01200,01,200,896,448,9,439,265,174,0.5,0.020089285714285716,0.9799107142857143,0.5915178571428571,0.38839285714285715
01201,01,201,1114,532,3,529,357,172,0.47755834829443444,0.005639097744360902,0.9943609022556391,0.6710526315789473,0.3233082706766917
01202,01,202,1131,470,8,462,289,173,0.4155614500442087,0.01702127659574468,0.9829787234042553,0.6148936170212767,0.3680851063829787
01203,01,203,1071,392,8,384,210,174,0.3660130718954248,0.02040816326530612,0.9795918367346939,0.5357142857142857,0.44387755102040816
01204,01,204,1931,832,12,820,514,306,0.430864836872087,0.014423076923076924,0.9855769230769231,0.6177884615384616,0.36778846153846156
01205,01,205,1222,563,11,552,297,255,0.4607201309328969,0.019538188277087035,0.9804618117229129,0.5275310834813499,0.45293072824156305
01206,01,206,1355,561,23,538,298,240,0.4140221402214022,0.040998217468805706,0.9590017825311943,0.5311942959001783,0.42780748663101603
01207,01,207,1138,531,19,512,263,249,0.46660808435852374,0.035781544256120526,0.9642184557438794,0.4952919020715631,0.4689265536723164
01208,01,208,894,432,8,424,222,202,0.48322147651006714,0.018518518518518517,0.9814814814814815,0.5138888888888888,0.4675925925925926
01209,01,209,1235,640,21,619,316,303,0.5182186234817814,0.0328125,0.9671875,0.49375,0.4734375
01210,01,210,1135,585,16,569,303,266,0.5154185022026432,0.02735042735042735,0.9726495726495726,0.517948717948718,0.4547008547008547
01211,01,211,880,465,13,452,226,226,0.5284090909090909,0.02795698924731183,0.9720430107526882,0.4860215053763441,0.4860215053763441
01212,01,212,866,480,19,461,266,195,0.5542725173210161,0.03958333333333333,0.9604166666666667,0.5541666666666667,0.40625
01213,01,213,640,295,8,287,168,119,0.4609375,0.02711864406779661,0.9728813559322034,0.5694915254237288,0.4033898305084746
01214,01,214,830,354,8,346,168,178,0.42650602409638555,0.022598870056497175,0.9774011299435028,0.4745762711864407,0.5028248587570622
01215,01,215,1016,526,5,521,268,253,0.5177165354330708,0.009505703422053232,0.9904942965779467,0.5095057034220533,0.48098859315589354
01216,01,216,945,491,15,476,237,239,0.5195767195767196,0.03054989816700611,0.9694501018329938,0.48268839103869654,0.48676171079429736
01217,01,217,1072,449,11,438,224,214,0.41884328358208955,0.024498886414253896,0.9755011135857461,0.49888641425389757,0.4766146993318486
01218,01,218,1525,801,24,777,403,374,0.5252459016393443,0.0299625468164794,0.9700374531835206,0.5031210986267166,0.46691635455680397
01219,01,219,342,172,8,164,99,65,0.5029239766081871,0.046511627906976744,0.9534883720930233,0.5755813953488372,0.37790697674418605
01220,01,220,785,345,12,333,163,170,0.4394904458598726,0.034782608695652174,0.9652173913043478,0.47246376811594204,0.4927536231884058
01221,01,221,1491,717,17,700,384,316,0.48088531187122735,0.023709902370990237,0.9762900976290098,0.5355648535564853,0.4407252440725244
01222,01,222,903,425,5,420,214,206,0.4706533776301218,0.011764705882352941,0.9882352941176471,0.5035294117647059,0.48470588235294115
01223,01,223,1499,771,16,755,327,428,0.514342895263509,0.020752269779507133,0.9792477302204928,0.42412451361867703,0.5551232166018158
01224,01,224,837,402,17,385,201,184,0.48028673835125446,0.04228855721393035,0.9577114427860697,0.5,0.4577114427860697
01225,01,225,1367,677,16,661,327,334,0.4952450621799561,0.023633677991137372,0.9763663220088626,0.48301329394387,0.4933530280649926
01226,01,226,758,393,18,375,173,202,0.5184696569920845,0.04580152671755725,0.9541984732824428,0.4402035623409669,0.5139949109414759
01227,01,227,1362,711,10,701,292,409,0.5220264317180616,0.014064697609001406,0.9859353023909986,0.41068917018284107,0.5752461322081576
01228,01,228,2280,1095,21,1074,534,540,0.48026315789473684,0.019178082191780823,0.9808219178082191,0.4876712328767123,0.4931506849315068
01300,01,300,1302,608,12,596,373,223,0.46697388632872505,0.019736842105263157,0.9802631578947368,0.6134868421052632,0.3667763157894737
01301,01,301,871,438,7,431,241,190,0.5028702640642939,0.01598173515981735,0.9840182648401826,0.5502283105022832,0.4337899543378995
01302,01,302,1187,577,11,566,364,202,0.4860994102780118,0.019064124783362217,0.9809358752166378,0.6308492201039861,0.35008665511265163
01303,01,303,888,427,17,410,275,135,0.48085585585585583,0.03981264637002342,0.9601873536299765,0.6440281030444965,0.3161592505854801
01304,01,304,942,527,5,522,305,217,0.559447983014862,0.009487666034155597,0.9905123339658444,0.5787476280834914,0.4117647058823529
01305,01,305,1043,558,17,541,320,221,0.5349952061361457,0.03046594982078853,0.9695340501792115,0.5734767025089605,0.3960573476702509
01306,01,306,1356,707,9,698,378,320,0.5213864306784661,0.01272984441301273,0.9872701555869873,0.5346534653465347,0.4526166902404526
01307,01,307,1137,657,19,638,383,255,0.5778364116094987,0.0289193302891933,0.9710806697108066,0.5829528158295282,0.3881278538812785
01308,01,308,1145,629,8,621,339,282,0.5493449781659389,0.012718600953895072,0.9872813990461049,0.5389507154213037,0.4483306836248013
01309,01,309,1268,731,17,714,399,315,0.5764984227129337,0.023255813953488372,0.9767441860465116,0.5458276333789329,0.43091655266757867
01310,01,310,900,487,10,477,285,192,0.5411111111111111,0.02053388090349076,0.9794661190965093,0.5852156057494866,0.3942505133470226
01311,01,311,1037,478,11,467,272,195,0.4609450337512054,0.02301255230125523,0.9769874476987448,0.5690376569037657,0.40794979079497906
01312,01,312,783,380,8,372,220,152,0.48531289910600256,0.021052631578947368,0.9789473684210527,0.5789473684210527,0.4
01313,01,313,825,407,6,401,245,156,0.49333333333333335,0.014742014742014743,0.9852579852579852,0.601965601965602,0.3832923832923833
01314,01,314,1085,559,11,548,358,190,0.5152073732718894,0.01967799642218247,0.9803220035778175,0.6404293381037567,0.33989266547406083
01315,01,315,831,386,10,376,233,143,0.4645006016847172,0.025906735751295335,0.9740932642487047,0.6036269430051814,0.3704663212435233
01316,01,316,1215,634,12,622,448,174,0.5218106995884774,0.01892744479495268,0.9810725552050473,0.7066246056782335,0.2744479495268139
01317,01,317,745,387,2,385,225,160,0.5194630872483221,0.00516795865633075,0.9948320413436692,0.5813953488372093,0.4134366925064599
01318,01,318,1116,545,12,533,340,193,0.4883512544802867,0.022018348623853212,0.9779816513761468,0.6238532110091743,0.3541284403669725
01319,01,319,998,471,6,465,293,172,0.47194388777555113,0.012738853503184714,0.9872611464968153,0.6220806794055201,0.3651804670912951
01320,01,320,591,322,7,315,168,147,0.544839255499154,0.021739130434782608,0.9782608695652174,0.5217391304347826,0.45652173913043476
01321,01,321,997,465,10,455,300,155,0.4663991975927783,0.021505376344086023,0.978494623655914,0.6451612903225806,0.3333333333333333
01322,01,322,1127,487,6,481,354,127,0.4321206743566992,0.012320328542094456,0.9876796714579056,0.7268993839835729,0.26078028747433263
01323,01,323,1153,597,17,580,371,209,0.5177797051170858,0.02847571189279732,0.9715242881072027,0.6214405360134003,0.3500837520938023
01324,01,324,1583,630,13,617,423,194,0.3979785217940619,0.020634920634920634,0.9793650793650793,0.6714285714285714,0.30793650793650795
01325,01,325,998,403,13,390,251,139,0.40380761523046094,0.03225806451612903,0.967741935483871,0.6228287841191067,0.34491315136476425
01326,01,326,1174,593,10,583,342,241,0.5051107325383305,0.016863406408094434,0.9831365935919055,0.5767284991568297,0.40640809443507586
01327,01,327,1471,691,11,680,357,323,0.4697484704282801,0.015918958031837915,0.984081041968162,0.516642547033285,0.467438494934877
01400,01,400,1351,629,14,615,404,211,0.4655810510732791,0.022257551669316374,0.9777424483306836,0.6422893481717011,0.3354531001589825
01401,01,401,924,456,6,450,278,172,0.4935064935064935,0.013157894736842105,0.9868421052631579,0.6096491228070176,0.37719298245614036
01402,01,402,1308,617,14,603,399,204,0.4717125382262997,0.022690437601296597,0.9773095623987034,0.646677471636953,0.33063209076175043
01403,01,403,1010,506,18,488,259,229,0.500990099009901,0.03557312252964427,0.9644268774703557,0.5118577075098815,0.4525691699604743
01404,01,404,704,350,10,340,208,132,0.4971590909090909,0.02857142857142857,0.9714285714285714,0.5942857142857143,0.37714285714285717
01405,01,405,790,407,8,399,257,142,0.5151898734177215,0.019656019656019656,0.9803439803439803,0.6314496314496314,0.3488943488943489
01406,01,406,847,449,22,427,231,196,0.5301062573789846,0.04899777282850779,0.9510022271714922,0.5144766146993318,0.4365256124721604
01407,01,407,1191,642,11,631,393,238,0.5390428211586902,0.017133956386292833,0.9828660436137072,0.6121495327102804,0.3707165109034268
01408,01,408,995,543,16,527,273,254,0.5457286432160804,0.029465930018416207,0.9705340699815838,0.5027624309392266,0.4677716390423573
01409,01,409,960,494,8,486,303,183,0.5145833333333333,0.016194331983805668,0.9838056680161943,0.6133603238866396,0.37044534412955465
01410,01,410,1274,686,11,675,394,281,0.5384615384615384,0.016034985422740525,0.9839650145772595,0.5743440233236151,0.4096209912536443
01411,01,411,1076,522,5,517,333,184,0.4851301115241636,0.009578544061302681,0.9904214559386973,0.6379310344827587,0.3524904214559387
01412,01,412,894,460,17,443,252,191,0.5145413870246085,0.03695652173913044,0.9630434782608696,0.5478260869565217,0.4152173913043478
01413,01,413,863,444,10,434,263,171,0.5144843568945539,0.02252252252252252,0.9774774774774775,0.5923423423423423,0.38513513513513514
01414,01,414,838,420,2,418,231,187,0.5011933174224343,0.004761904761904762,0.9952380952380953,0.55,0.4452380952380952
01415,01,415,861,464,13,451,245,206,0.5389082462253194,0.028017241379310345,0.9719827586206896,0.5280172413793104,0.44396551724137934
01416,01,416,1075,550,16,534,339,195,0.5116279069767442,0.02909090909090909,0.9709090909090909,0.6163636363636363,0.35454545454545455
01417,01,417,1168,540,8,532,310,222,0.4623287671232877,0.014814814814814815,0.9851851851851852,0.5740740740740741,0.4111111111111111
01418,01,418,1119,501,7,494,321,173,0.4477211796246649,0.013972055888223553,0.9860279441117764,0.6407185628742516,0.34530938123752497
01419,01,419,1268,672,11,661,382,279,0.5299684542586751,0.01636904761904762,0.9836309523809523,0.5684523809523809,0.41517857142857145
01420,01,420,983,541,13,528,305,223,0.5503560528992879,0.024029574861367836,0.9759704251386322,0.5637707948243993,0.4121996303142329
01421,01,421,813,434,5,429,271,158,0.5338253382533825,0.01152073732718894,0.988479262672811,0.6244239631336406,0.3640552995391705
01422,01,422,1008,447,9,438,238,200,0.44345238095238093,0.020134228187919462,0.9798657718120806,0.5324384787472036,0.44742729306487694
01423,01,423,876,413,12,401,245,156,0.4714611872146119,0.029055690072639227,0.9709443099273608,0.5932203389830508,0.37772397094430993
01424,01,424,1229,627,17,610,337,273,0.5101708706265257,0.02711323763955343,0.9728867623604466,0.5374800637958532,0.4354066985645933
01425,01,425,1316,685,11,674,335,339,0.520516717325228,0.016058394160583942,0.983941605839416,0.48905109489051096,0.4948905109489051
01426,01,426,1268,596,13,583,313,270,0.47003154574132494,0.02181208053691275,0.9781879194630873,0.5251677852348994,0.45302013422818793
01427,01,427,866,400,4,396,207,189,0.4618937644341801,0.01,0.99,0.5175,0.4725
01428,01,428,819,360,9,351,205,146,0.43956043956043955,0.025,0.975,0.5694444444444444,0.40555555555555556
01500,01,500,1017,464,6,458,281,177,0.45624385447394294,0.01293103448275862,0.9870689655172413,0.6056034482758621,0.38146551724137934
01501,01,501,834,417,7,410,218,192,0.5,0.016786570743405275,0.9832134292565947,0.5227817745803357,0.460431654676259
01502,01,502,547,232,3,229,128,101,0.42413162705667273,0.01293103448275862,0.9870689655172413,0.5517241379310345,0.4353448275862069
01503,01,503,1064,558,5,553,199,354,0.5244360902255639,0.008960573476702509,0.9910394265232975,0.35663082437275984,0.6344086021505376
01504,01,504,667,308,4,304,204,100,0.4617691154422789,0.012987012987012988,0.987012987012987,0.6623376623376623,0.3246753246753247
01505,01,505,956,434,5,429,251,178,0.45397489539748953,0.01152073732718894,0.988479262672811,0.5783410138248848,0.41013824884792627
01506,01,506,983,496,3,493,226,267,0.5045778229908443,0.006048387096774193,0.9939516129032258,0.45564516129032256,0.5383064516129032
01507,01,507,1480,748,8,740,324,416,0.5054054054054054,0.0106951871657754,0.9893048128342246,0.43315508021390375,0.5561497326203209
01508,01,508,1211,654,3,651,315,336,0.5400495458298926,0.0045871559633027525,0.9954128440366973,0.481651376146789,0.5137614678899083
01509,01,509,1125,534,4,530,299,231,0.4746666666666667,0.00749063670411985,0.9925093632958801,0.5599250936329588,0.43258426966292135
01510,01,510,1057,544,10,534,312,222,0.5146641438032167,0.01838235294117647,0.9816176470588235,0.5735294117647058,0.40808823529411764
01511,01,511,1118,495,6,489,289,200,0.44275491949910556,0.012121212121212121,0.9878787878787879,0.5838383838383838,0.40404040404040403
01512,01,512,1027,399,9,390,235,155,0.3885102239532619,0.022556390977443608,0.9774436090225563,0.5889724310776943,0.38847117794486213
01513,01,513,1357,698,8,690,346,344,0.5143699336772292,0.011461318051575931,0.9885386819484241,0.49570200573065903,0.49283667621776506
01514,01,514,1035,487,10,477,270,207,0.47053140096618357,0.02053388090349076,0.9794661190965093,0.5544147843942505,0.42505133470225875
01515,01,515,1324,676,10,666,386,280,0.5105740181268882,0.014792899408284023,0.985207100591716,0.5710059171597633,0.41420118343195267
01516,01,516,985,457,5,452,272,180,0.4639593908629442,0.010940919037199124,0.9890590809628009,0.5951859956236324,0.3938730853391685
01517,01,517,1364,592,7,585,305,280,0.4340175953079179,0.011824324324324325,0.9881756756756757,0.5152027027027027,0.47297297297297297
01518,01,518,1292,562,6,556,316,240,0.43498452012383904,0.010676156583629894,0.9893238434163701,0.5622775800711743,0.42704626334519574
01519,01,519,1314,674,26,648,333,315,0.512937595129376,0.03857566765578635,0.9614243323442137,0.4940652818991098,0.46735905044510384
01520,01,520,1371,672,11,661,329,332,0.49015317286652077,0.01636904761904762,0.9836309523809523,0.4895833333333333,0.49404761904761907
01521,01,521,1287,475,6,469,301,168,0.3690753690753691,0.01263157894736842,0.9873684210526316,0.6336842105263157,0.35368421052631577
01522,01,522,889,423,0,423,207,216,0.47581552305961755,0.0,1.0,0.48936170212765956,0.5106382978723404
01523,01,523,649,369,5,364,214,150,0.5685670261941448,0.013550135501355014,0.986449864498645,0.5799457994579946,0.4065040650406504
01524,01,524,853,409,12,397,218,179,0.4794841735052755,0.029339853300733496,0.9706601466992665,0.5330073349633252,0.43765281173594134
01525,01,525,859,432,12,420,201,219,0.5029103608847497,0.027777777777777776,0.9722222222222222,0.4652777777777778,0.5069444444444444
01526,01,526,1481,703,10,693,342,351,0.474679270762998,0.01422475106685633,0.9857752489331437,0.4864864864864865,0.4992887624466572
01600,01,600,1457,619,12,607,288,319,0.4248455730954015,0.01938610662358643,0.9806138933764136,0.46526655896607433,0.5153473344103393
01601,01,601,792,420,10,410,191,219,0.5303030303030303,0.023809523809523808,0.9761904761904762,0.45476190476190476,0.5214285714285715
01602,01,602,1040,577,1,576,203,373,0.5548076923076923,0.0017331022530329288,0.9982668977469671,0.35181975736568455,0.6464471403812825
01603,01,603,907,432,7,425,191,234,0.4762954796030871,0.016203703703703703,0.9837962962962963,0.44212962962962965,0.5416666666666666
01604,01,604,849,353,4,349,196,153,0.41578327444051827,0.0113314447592068,0.9886685552407932,0.5552407932011332,0.43342776203966005
01605,01,605,1090,497,9,488,249,239,0.4559633027522936,0.018108651911468814,0.9818913480885312,0.5010060362173038,0.48088531187122735
01606,01,606,835,405,13,392,174,218,0.48502994011976047,0.03209876543209877,0.9679012345679012,0.42962962962962964,0.5382716049382716
01607,01,607,861,304,9,295,131,164,0.3530778164924506,0.029605263157894735,0.9703947368421053,0.4309210526315789,0.5394736842105263
01608,01,608,1017,431,16,415,189,226,0.42379547689282204,0.037122969837587005,0.962877030162413,0.4385150812064965,0.5243619489559165
01609,01,609,1094,552,6,546,264,282,0.5045703839122486,0.010869565217391304,0.9891304347826086,0.4782608695652174,0.5108695652173914
01610,01,610,1122,524,5,519,266,253,0.46702317290552586,0.009541984732824428,0.9904580152671756,0.5076335877862596,0.48282442748091603
01611,01,611,1363,664,9,655,356,299,0.4871606749816581,0.01355421686746988,0.9864457831325302,0.536144578313253,0.4503012048192771
01612,01,612,975,441,4,437,218,219,0.4523076923076923,0.009070294784580499,0.9909297052154195,0.4943310657596372,0.4965986394557823
01613,01,613,1435,687,12,675,343,332,0.47874564459930313,0.017467248908296942,0.982532751091703,0.4992721979621543,0.48326055312954874
01614,01,614,1180,615,12,603,330,273,0.5211864406779662,0.01951219512195122,0.9804878048780488,0.5365853658536586,0.44390243902439025
01615,01,615,896,389,6,383,212,171,0.4341517857142857,0.015424164524421594,0.9845758354755784,0.5449871465295629,0.43958868894601544
01616,01,616,1123,537,7,530,228,302,0.4781834372217275,0.01303538175046555,0.9869646182495344,0.4245810055865922,0.5623836126629422
01617,01,617,1031,493,18,475,262,213,0.478176527643065,0.036511156186612576,0.9634888438133874,0.5314401622718052,0.43204868154158216
01618,01,618,1402,646,18,628,323,305,0.4607703281027104,0.02786377708978328,0.9721362229102167,0.5,0.47213622291021673
01619,01,619,1221,611,20,591,305,286,0.5004095004095004,0.03273322422258593,0.967266775777414,0.49918166939443537,0.46808510638297873
01620,01,620,976,445,9,436,256,180,0.45594262295081966,0.020224719101123594,0.9797752808988764,0.5752808988764045,0.4044943820224719
01621,01,621,980,419,18,401,252,149,0.4275510204081633,0.04295942720763723,0.9570405727923628,0.6014319809069213,0.3556085918854415
01622,01,622,662,263,8,255,146,109,0.3972809667673716,0.030418250950570342,0.9695817490494296,0.5551330798479087,0.4144486692015209
01623,01,623,901,353,6,347,164,183,0.39178690344062156,0.0169971671388102,0.9830028328611898,0.46458923512747874,0.5184135977337111
01624,01,624,1248,501,23,478,273,205,0.4014423076923077,0.04590818363273453,0.9540918163672655,0.5449101796407185,0.4091816367265469
01625,01,625,1017,488,12,476,295,181,0.47984267453294,0.02459016393442623,0.9754098360655737,0.6045081967213115,0.3709016393442623
01700,01,700,804,355,4,351,233,118,0.44154228855721395,0.011267605633802818,0.9887323943661972,0.6563380281690141,0.3323943661971831
01701,01,701,1306,611,20,591,267,324,0.4678407350689127,0.03273322422258593,0.967266775777414,0.4369885433715221,0.530278232405892
01702,01,702,1076,481,13,468,281,187,0.44702602230483274,0.02702702702702703,0.972972972972973,0.5841995841995842,0.3887733887733888
01703,01,703,841,406,10,396,234,162,0.4827586206896552,0.024630541871921183,0.9753694581280788,0.5763546798029556,0.39901477832512317
01704,01,704,849,381,11,370,192,178,0.44876325088339225,0.028871391076115485,0.9711286089238845,0.5039370078740157,0.4671916010498688
01705,01,705,968,484,14,470,221,249,0.5,0.028925619834710745,0.9710743801652892,0.45661157024793386,0.5144628099173554
01706,01,706,1203,578,9,569,283,286,0.48046550290939316,0.015570934256055362,0.9844290657439446,0.48961937716262977,0.49480968858131485
01707,01,707,1209,650,16,634,340,294,0.5376344086021505,0.024615384615384615,0.9753846153846154,0.5230769230769231,0.4523076923076923
01708,01,708,1141,554,5,549,303,246,0.4855390008764242,0.009025270758122744,0.9909747292418772,0.5469314079422383,0.44404332129963897
01709,01,709,1087,533,12,521,272,249,0.49034038638454464,0.0225140712945591,0.9774859287054409,0.5103189493433395,0.46716697936210133
01710,01,710,1300,587,15,572,346,226,0.45153846153846156,0.02555366269165247,0.9744463373083475,0.5894378194207837,0.3850085178875639
01711,01,711,1056,529,9,520,298,222,0.5009469696969697,0.017013232514177693,0.9829867674858223,0.5633270321361059,0.41965973534971646
01712,01,712,1255,576,10,566,330,236,0.4589641434262948,0.017361111111111112,0.9826388888888888,0.5729166666666666,0.4097222222222222
01713,01,713,919,372,5,367,237,130,0.4047878128400435,0.013440860215053764,0.9865591397849462,0.6370967741935484,0.34946236559139787
01714,01,714,1091,480,14,466,273,193,0.4399633363886343,0.029166666666666667,0.9708333333333333,0.56875,0.40208333333333335
01715,01,715,1182,569,11,558,374,184,0.4813874788494078,0.019332161687170474,0.9806678383128296,0.6572934973637962,0.3233743409490334
01716,01,716,913,446,9,437,299,138,0.488499452354874,0.020179372197309416,0.9798206278026906,0.6704035874439462,0.3094170403587444
01717,01,717,1127,534,8,526,356,170,0.4738243123336291,0.0149812734082397,0.9850187265917603,0.6666666666666666,0.31835205992509363
01718,01,718,844,366,11,355,223,132,0.43364928909952605,0.030054644808743168,0.9699453551912568,0.6092896174863388,0.36065573770491804
01719,01,719,985,456,19,437,307,130,0.46294416243654823,0.041666666666666664,0.9583333333333334,0.6732456140350878,0.2850877192982456
01720,01,720,1198,595,18,577,349,228,0.496661101836394,0.030252100840336135,0.9697478991596639,0.5865546218487395,0.3831932773109244
01721,01,721,1116,500,16,484,339,145,0.44802867383512546,0.032,0.968,0.678,0.29
01722,01,722,1023,530,17,513,308,205,0.5180840664711632,0.03207547169811321,0.9679245283018868,0.5811320754716981,0.3867924528301887
01723,01,723,1044,537,6,531,307,224,0.514367816091954,0.0111731843575419,0.9888268156424581,0.5716945996275605,0.4171322160148976
01724,01,724,895,451,10,441,292,149,0.5039106145251396,0.022172949002217297,0.9778270509977827,0.647450110864745,0.3303769401330377
01725,01,725,1029,473,12,461,322,139,0.45966958211856174,0.02536997885835095,0.9746300211416491,0.6807610993657506,0.2938689217758985
02101,02,101,1095,504,12,492,260,232,0.4602739726027397,0.023809523809523808,0.9761904761904762,0.5158730158730159,0.4603174603174603
02102,02,102,1760,918,24,894,406,488,0.5215909090909091,0.026143790849673203,0.9738562091503268,0.4422657952069717,0.5315904139433552
02103,02,103,1704,864,33,831,380,451,0.5070422535211268,0.03819444444444445,0.9618055555555556,0.4398148148148148,0.5219907407407407
02104,02,104,1533,821,24,797,400,397,0.5355512067840835,0.029232643118148598,0.9707673568818515,0.48721071863581,0.4835566382460414
02105,02,105,1743,859,22,837,478,359,0.49282845668387837,0.025611175785797437,0.9743888242142026,0.5564610011641443,0.4179278230500582
02106,02,106,1851,973,33,940,452,488,0.5256618044300378,0.03391572456320658,0.9660842754367934,0.4645426515930113,0.5015416238437821
02107,02,107,1500,697,19,678,323,355,0.4646666666666667,0.027259684361549498,0.9727403156384505,0.4634146341463415,0.509325681492109
02108,02,108,1814,938,18,920,444,476,0.5170893054024256,0.019189765458422176,0.9808102345415778,0.47334754797441364,0.5074626865671642
02109,02,109,1502,812,26,786,333,453,0.5406125166444741,0.03201970443349754,0.9679802955665024,0.4100985221674877,0.5578817733990148
02110,02,110,1414,735,24,711,308,403,0.5198019801980198,0.0326530612244898,0.9673469387755103,0.41904761904761906,0.5482993197278911
02111,02,111,1597,835,26,809,333,476,0.5228553537883531,0.031137724550898204,0.9688622754491018,0.39880239520958083,0.5700598802395209
02112,02,112,1748,906,5,901,383,518,0.5183066361556065,0.005518763796909493,0.9944812362030905,0.4227373068432671,0.5717439293598234
02113,02,113,1518,805,33,772,290,482,0.5303030303030303,0.040993788819875775,0.9590062111801242,0.36024844720496896,0.5987577639751552
02114,02,114,1152,631,15,616,230,386,0.5477430555555556,0.02377179080824089,0.9762282091917591,0.36450079239302696,0.6117274167987322
02115,02,115,1329,697,4,693,293,400,0.5244544770504138,0.005738880918220947,0.994261119081779,0.42037302725968434,0.5738880918220947
02116,02,116,1678,889,36,853,361,492,0.5297973778307509,0.04049493813273341,0.9595050618672666,0.40607424071991,0.5534308211473565
02117,02,117,1534,761,19,742,366,376,0.49608865710560623,0.024967148488830485,0.9750328515111695,0.480946123521682,0.4940867279894875
02118,02,118,1453,696,33,663,257,406,0.47900894700619406,0.04741379310344827,0.9525862068965517,0.3692528735632184,0.5833333333333334
02119,02,119,1579,837,36,801,305,496,0.5300823305889804,0.043010752688172046,0.956989247311828,0.3643966547192354,0.5925925925925926
02120,02,120,1798,920,31,889,387,502,0.5116796440489433,0.03369565217391304,0.966304347826087,0.4206521739130435,0.5456521739130434
02121,02,121,1618,879,25,854,323,531,0.5432632880098888,0.02844141069397042,0.9715585893060296,0.36746302616609783,0.6040955631399317
02122,02,122,1426,696,23,673,301,372,0.48807854137447404,0.033045977011494254,0.9669540229885057,0.4324712643678161,0.5344827586206896
02201,02,201,1059,565,18,547,190,357,0.5335221907459868,0.03185840707964602,0.968141592920354,0.336283185840708,0.631858407079646
02202,02,202,1351,613,19,594,333,261,0.4537379718726869,0.03099510603588907,0.9690048939641109,0.5432300163132137,0.4257748776508972
02203,02,203,1150,579,14,565,268,297,0.5034782608695653,0.024179620034542316,0.9758203799654577,0.46286701208981,0.5129533678756477
02204,02,204,869,476,14,462,202,260,0.5477560414269275,0.029411764705882353,0.9705882352941176,0.42436974789915966,0.5462184873949579
02205,02,205,1356,738,14,724,270,454,0.5442477876106194,0.018970189701897018,0.981029810298103,0.36585365853658536,0.6151761517615176
02206,02,206,1374,686,30,656,256,400,0.4992721979621543,0.043731778425655975,0.956268221574344,0.37317784256559766,0.5830903790087464
02207,02,207,1319,710,22,688,252,436,0.5382865807429871,0.030985915492957747,0.9690140845070423,0.35492957746478876,0.6140845070422535
02208,02,208,1084,595,19,576,263,313,0.5488929889298892,0.031932773109243695,0.9680672268907563,0.44201680672268906,0.5260504201680672
02209,02,209,1171,595,33,562,256,306,0.5081127241673783,0.05546218487394958,0.9445378151260504,0.43025210084033616,0.5142857142857142
02210,02,210,1166,573,32,541,199,342,0.4914236706689537,0.055846422338568937,0.944153577661431,0.3472949389179756,0.5968586387434555
02211,02,211,1126,588,20,568,223,345,0.522202486678508,0.034013605442176874,0.9659863945578231,0.3792517006802721,0.5867346938775511
02212,02,212,1207,722,23,699,234,465,0.5981772990886496,0.03185595567867036,0.9681440443213296,0.32409972299168976,0.6440443213296398
02213,02,213,1053,567,21,546,254,292,0.5384615384615384,0.037037037037037035,0.9629629629629629,0.4479717813051146,0.5149911816578483
02214,02,214,1427,815,24,791,321,470,0.5711282410651717,0.029447852760736196,0.9705521472392638,0.39386503067484663,0.5766871165644172
02215,02,215,1702,924,24,900,387,513,0.5428907168037603,0.025974025974025976,0.974025974025974,0.41883116883116883,0.5551948051948052
02216,02,216,1302,680,38,642,274,368,0.522273425499232,0.05588235294117647,0.9441176470588235,0.40294117647058825,0.5411764705882353
02217,02,217,1660,938,29,909,349,560,0.5650602409638554,0.03091684434968017,0.9690831556503199,0.3720682302771855,0.5970149253731343
02218,02,218,1711,901,37,864,364,500,0.5265926358854471,0.041065482796892344,0.9589345172031076,0.4039955604883463,0.5549389567147613
02219,02,219,974,517,20,497,195,302,0.5308008213552361,0.03868471953578337,0.9613152804642167,0.3771760154738878,0.5841392649903289
02220,02,220,1497,832,23,809,338,471,0.5557782231128925,0.027644230769230768,0.9723557692307693,0.40625,0.5661057692307693
02221,02,221,1438,760,30,730,330,400,0.5285118219749653,0.039473684210526314,0.9605263157894737,0.4342105263157895,0.5263157894736842
02222,02,222,1350,724,17,707,279,428,0.5362962962962963,0.023480662983425413,0.9765193370165746,0.38535911602209943,0.5911602209944752
02223,02,223,1697,868,19,849,462,387,0.5114908662345315,0.021889400921658985,0.978110599078341,0.532258064516129,0.44585253456221197
02224,02,224,1423,775,20,755,331,424,0.5446240337315531,0.025806451612903226,0.9741935483870968,0.4270967741935484,0.5470967741935484
02225,02,225,1445,768,24,744,308,436,0.5314878892733564,0.03125,0.96875,0.4010416666666667,0.5677083333333334
02226,02,226,1474,887,15,872,404,468,0.601763907734057,0.016910935738444193,0.9830890642615558,0.455467869222097,0.5276211950394588
02301,02,301,1199,603,10,593,360,233,0.5029190992493745,0.01658374792703151,0.9834162520729685,0.5970149253731343,0.3864013266998342
02302,02,302,1577,724,37,687,437,250,0.4590995561192137,0.05110497237569061,0.9488950276243094,0.6035911602209945,0.3453038674033149
02303,02,303,557,251,6,245,155,90,0.4506283662477558,0.02390438247011952,0.9760956175298805,0.6175298804780877,0.35856573705179284
02304,02,304,1378,654,21,633,334,299,0.4746008708272859,0.03211009174311927,0.9678899082568807,0.5107033639143731,0.45718654434250766
02305,02,305,1294,607,10,597,387,210,0.46908809891808345,0.016474464579901153,0.9835255354200988,0.6375617792421746,0.34596375617792424
02306,02,306,1380,665,6,659,434,225,0.48188405797101447,0.009022556390977444,0.9909774436090225,0.6526315789473685,0.3383458646616541
02307,02,307,1557,739,22,717,420,297,0.4746307000642261,0.029769959404600813,0.9702300405953992,0.5683355886332883,0.401894451962111
02308,02,308,1048,461,12,449,264,185,0.4398854961832061,0.026030368763557483,0.9739696312364425,0.5726681127982647,0.40130151843817785
02309,02,309,1302,641,15,626,414,212,0.4923195084485407,0.0234009360374415,0.9765990639625585,0.6458658346333853,0.33073322932917315
02310,02,310,1282,663,21,642,344,298,0.517160686427457,0.03167420814479638,0.9683257918552036,0.5188536953242836,0.4494720965309201
02311,02,311,1208,643,23,620,242,378,0.5322847682119205,0.03576982892690513,0.9642301710730948,0.37636080870917576,0.5878693623639192
02312,02,312,1647,863,29,834,347,487,0.5239829993928354,0.03360370799536501,0.966396292004635,0.4020857473928158,0.5643105446118193
02313,02,313,1247,556,13,543,378,165,0.4458700882117081,0.023381294964028777,0.9766187050359713,0.6798561151079137,0.29676258992805754
02314,02,314,1467,588,6,582,387,195,0.40081799591002043,0.01020408163265306,0.9897959183673469,0.6581632653061225,0.33163265306122447
02315,02,315,1458,623,15,608,309,299,0.4272976680384088,0.024077046548956663,0.9759229534510433,0.4959871589085072,0.4799357945425361
02316,02,316,1220,520,16,504,319,185,0.4262295081967213,0.03076923076923077,0.9692307692307692,0.6134615384615385,0.3557692307692308
02317,02,317,903,382,13,369,218,151,0.4230343300110742,0.034031413612565446,0.9659685863874345,0.5706806282722513,0.39528795811518325
02318,02,318,1190,590,27,563,282,281,0.4957983193277311,0.04576271186440678,0.9542372881355933,0.47796610169491527,0.47627118644067795
02319,02,319,1251,664,22,642,243,399,0.530775379696243,0.03313253012048193,0.9668674698795181,0.36596385542168675,0.6009036144578314
02320,02,320,1559,829,31,798,351,447,0.5317511225144324,0.03739445114595899,0.962605548854041,0.4234016887816647,0.5392038600723763
02321,02,321,1460,652,31,621,286,335,0.4465753424657534,0.04754601226993865,0.9524539877300614,0.4386503067484663,0.5138036809815951
02322,02,322,1362,736,24,712,289,423,0.540381791483113,0.03260869565217391,0.967391304347826,0.39266304347826086,0.5747282608695652
02323,02,323,1351,696,29,667,271,396,0.5151739452257587,0.041666666666666664,0.9583333333333334,0.38936781609195403,0.5689655172413793
02324,02,324,1258,624,25,599,306,293,0.4960254372019078,0.04006410256410257,0.9599358974358975,0.49038461538461536,0.46955128205128205
02325,02,325,1023,521,22,499,197,302,0.509286412512219,0.04222648752399232,0.9577735124760077,0.3781190019193858,0.5796545105566219
02401,02,401,1181,591,12,579,292,287,0.5004233700254022,0.02030456852791878,0.9796954314720813,0.494077834179357,0.4856175972927242
02402,02,402,1118,522,12,510,257,253,0.4669051878354204,0.022988505747126436,0.9770114942528736,0.49233716475095785,0.4846743295019157
02403,02,403,1320,681,18,663,343,320,0.5159090909090909,0.02643171806167401,0.973568281938326,0.5036710719530103,0.4698972099853157
02404,02,404,1544,739,20,719,356,363,0.4786269430051813,0.02706359945872801,0.972936400541272,0.4817320703653586,0.4912043301759134
02405,02,405,1435,745,23,722,360,362,0.519163763066202,0.03087248322147651,0.9691275167785235,0.48322147651006714,0.48590604026845635
02406,02,406,831,426,13,413,211,202,0.5126353790613718,0.03051643192488263,0.9694835680751174,0.4953051643192488,0.47417840375586856
02407,02,407,959,563,11,552,243,309,0.5870698644421272,0.019538188277087035,0.9804618117229129,0.43161634103019536,0.5488454706927176
02408,02,408,1362,696,22,674,330,344,0.5110132158590308,0.031609195402298854,0.9683908045977011,0.47413793103448276,0.4942528735632184
02409,02,409,1018,528,10,518,252,266,0.518664047151277,0.01893939393939394,0.9810606060606061,0.4772727272727273,0.5037878787878788
02410,02,410,1312,752,31,721,332,389,0.573170731707317,0.041223404255319146,0.9587765957446809,0.44148936170212766,0.5172872340425532
02411,02,411,1355,777,21,756,319,437,0.5734317343173432,0.02702702702702703,0.972972972972973,0.41055341055341055,0.5624195624195624
02412,02,412,1358,678,26,652,313,339,0.4992636229749632,0.038348082595870206,0.9616519174041298,0.4616519174041298,0.5
02413,02,413,1599,853,17,836,351,485,0.533458411507192,0.01992966002344666,0.9800703399765534,0.4114888628370457,0.5685814771395076
02414,02,414,1425,703,21,682,296,386,0.49333333333333335,0.029871977240398292,0.9701280227596017,0.42105263157894735,0.5490753911806543
02415,02,415,1851,911,13,898,438,460,0.4921663965424095,0.014270032930845226,0.9857299670691547,0.4807903402854007,0.5049396267837541
02416,02,416,1483,653,12,641,314,327,0.4403236682400539,0.018376722817764167,0.9816232771822359,0.48085758039816234,0.5007656967840735
02417,02,417,1699,815,21,794,378,416,0.47969393761035906,0.025766871165644172,0.9742331288343559,0.4638036809815951,0.5104294478527608
02418,02,418,1140,582,17,565,278,287,0.5105263157894737,0.029209621993127148,0.9707903780068728,0.47766323024054985,0.49312714776632305
02419,02,419,1653,910,17,893,422,471,0.5505142165759226,0.01868131868131868,0.9813186813186813,0.46373626373626375,0.5175824175824176
02420,02,420,1401,786,11,775,361,414,0.5610278372591007,0.013994910941475827,0.9860050890585241,0.4592875318066158,0.5267175572519084
02421,02,421,1251,667,22,645,251,394,0.5331734612310152,0.03298350824587706,0.967016491754123,0.37631184407796103,0.5907046476761619
02422,02,422,1456,822,30,792,328,464,0.5645604395604396,0.0364963503649635,0.9635036496350365,0.39902676399026765,0.5644768856447688
02423,02,423,948,448,8,440,223,217,0.47257383966244726,0.017857142857142856,0.9821428571428571,0.49776785714285715,0.484375
02424,02,424,1221,555,21,534,272,262,0.45454545454545453,0.03783783783783784,0.9621621621621622,0.4900900900900901,0.4720720720720721
02425,02,425,1652,859,15,844,440,404,0.5199757869249395,0.017462165308498253,0.9825378346915018,0.5122235157159488,0.470314318975553
02426,02,426,872,441,16,425,241,184,0.5057339449541285,0.036281179138321996,0.963718820861678,0.546485260770975,0.41723356009070295
02501,02,501,1621,862,28,834,376,458,0.5317705120296113,0.03248259860788863,0.9675174013921114,0.4361948955916473,0.531322505800464
02502,02,502,1776,972,25,947,444,503,0.5472972972972973,0.0257201646090535,0.9742798353909465,0.4567901234567901,0.5174897119341564
02503,02,503,966,565,16,549,239,310,0.5848861283643892,0.02831858407079646,0.9716814159292035,0.4230088495575221,0.5486725663716814
02504,02,504,1512,779,24,755,344,411,0.5152116402116402,0.03080872913992298,0.9691912708600771,0.441591784338896,0.527599486521181
02505,02,505,1656,836,26,810,344,466,0.5048309178743962,0.03110047846889952,0.9688995215311005,0.41148325358851673,0.5574162679425837
02506,02,506,1838,933,35,898,380,518,0.5076169749727966,0.03751339764201501,0.962486602357985,0.40728831725616294,0.5551982851018221
02507,02,507,1568,865,22,843,368,475,0.5516581632653061,0.025433526011560695,0.9745664739884393,0.4254335260115607,0.5491329479768786
02508,02,508,1807,993,14,979,446,533,0.5495296070835639,0.014098690835850957,0.9859013091641491,0.44914400805639476,0.5367573011077543
02509,02,509,1471,804,25,779,312,467,0.5465669612508498,0.03109452736318408,0.9689054726368159,0.3880597014925373,0.5808457711442786
02510,02,510,2064,1142,25,1117,482,635,0.5532945736434108,0.021891418563922942,0.978108581436077,0.4220665499124343,0.5560420315236427
02511,02,511,1202,598,17,581,255,326,0.49750415973377704,0.028428093645484948,0.9715719063545151,0.42642140468227424,0.5451505016722408
02512,02,512,1307,661,24,637,285,352,0.5057383320581484,0.036308623298033284,0.9636913767019667,0.43116490166414523,0.5325264750378215
02513,02,513,1271,711,26,685,338,347,0.5594020456333596,0.03656821378340366,0.9634317862165963,0.47538677918424754,0.4880450070323488
02514,02,514,1430,780,29,751,324,427,0.5454545454545454,0.03717948717948718,0.9628205128205128,0.4153846153846154,0.5474358974358975
02515,02,515,1547,806,25,781,371,410,0.5210084033613446,0.031017369727047148,0.9689826302729528,0.46029776674937967,0.5086848635235732
02516,02,516,1259,661,28,633,291,342,0.5250198570293884,0.04236006051437216,0.9576399394856279,0.4402420574886536,0.5173978819969742
02517,02,517,1236,666,12,654,270,384,0.5388349514563107,0.018018018018018018,0.9819819819819819,0.40540540540540543,0.5765765765765766
02518,02,518,962,512,22,490,195,295,0.5322245322245323,0.04296875,0.95703125,0.380859375,0.576171875
02519,02,519,1429,793,30,763,313,450,0.5549335199440167,0.03783102143757881,0.9621689785624212,0.39470365699873894,0.5674653215636822
02520,02,520,1657,807,30,777,300,477,0.48702474351237174,0.03717472118959108,0.9628252788104089,0.37174721189591076,0.5910780669144982
02521,02,521,1521,785,29,756,298,458,0.5161078238001315,0.03694267515923567,0.9630573248407643,0.3796178343949045,0.5834394904458599
02522,02,522,1398,730,12,718,329,389,0.5221745350500715,0.01643835616438356,0.9835616438356164,0.4506849315068493,0.5328767123287671
02523,02,523,961,481,16,465,203,262,0.5005202913631633,0.033264033264033266,0.9667359667359667,0.42203742203742206,0.5446985446985447
02524,02,524,1323,676,19,657,270,387,0.5109599395313681,0.028106508875739646,0.9718934911242604,0.3994082840236686,0.5724852071005917
03101,03,101,2133,1121,27,1094,545,549,0.5255508673230193,0.02408563782337199,0.975914362176628,0.48617305976806424,0.4897413024085638
03102,03,102,1850,875,13,862,454,408,0.47297297297297297,0.014857142857142857,0.9851428571428571,0.5188571428571429,0.4662857142857143
03103,03,103,1447,644,20,624,327,297,0.44505874222529374,0.031055900621118012,0.968944099378882,0.5077639751552795,0.4611801242236025
03104,03,104,1508,672,19,653,371,282,0.44562334217506633,0.028273809523809524,0.9717261904761905,0.5520833333333334,0.41964285714285715
03105,03,105,1104,598,10,588,309,279,0.5416666666666666,0.016722408026755852,0.9832775919732442,0.5167224080267558,0.4665551839464883
03106,03,106,1408,635,4,631,414,217,0.4509943181818182,0.006299212598425197,0.9937007874015747,0.6519685039370079,0.3417322834645669
03107,03,107,916,457,2,455,299,156,0.49890829694323147,0.00437636761487965,0.9956236323851203,0.6542669584245077,0.3413566739606127
03108,03,108,1419,756,24,732,441,291,0.53276955602537,0.031746031746031744,0.9682539682539683,0.5833333333333334,0.38492063492063494
03109,03,109,1529,897,17,880,504,376,0.5866579463701765,0.0189520624303233,0.9810479375696767,0.5618729096989966,0.41917502787068006
03110,03,110,1488,823,17,806,476,330,0.5530913978494624,0.020656136087484813,0.9793438639125152,0.5783718104495748,0.40097205346294046
03111,03,111,1285,765,6,759,406,353,0.5953307392996109,0.00784313725490196,0.9921568627450981,0.530718954248366,0.46143790849673205
03112,03,112,1323,734,15,719,376,343,0.5547996976568406,0.020435967302452316,0.9795640326975477,0.5122615803814714,0.4673024523160763
03113,03,113,1538,985,19,966,465,501,0.6404421326397919,0.019289340101522844,0.9807106598984772,0.4720812182741117,0.5086294416243655
03114,03,114,1333,775,5,770,350,420,0.5813953488372093,0.0064516129032258064,0.9935483870967742,0.45161290322580644,0.5419354838709678
03115,03,115,1533,898,14,884,449,435,0.5857795172863666,0.015590200445434299,0.9844097995545658,0.5,0.4844097995545657
03116,03,116,1595,933,13,920,540,380,0.5849529780564263,0.013933547695605574,0.9860664523043944,0.5787781350482315,0.40728831725616294
03117,03,117,1504,793,16,777,501,276,0.5272606382978723,0.0201765447667087,0.9798234552332913,0.6317780580075663,0.3480453972257251
03118,03,118,1536,883,12,871,405,466,0.5748697916666666,0.013590033975084938,0.986409966024915,0.45866364665911663,0.5277463193657984
03119,03,119,1858,1055,7,1048,543,505,0.5678148546824543,0.006635071090047393,0.9933649289099526,0.5146919431279621,0.4786729857819905
03120,03,120,1869,1040,15,1025,488,537,0.5564472980203318,0.014423076923076924,0.9855769230769231,0.46923076923076923,0.5163461538461539
03121,03,121,1881,1028,13,1015,515,500,0.5465178096757044,0.01264591439688716,0.9873540856031129,0.5009727626459144,0.48638132295719844
03122,03,122,1610,897,7,890,456,434,0.5571428571428572,0.007803790412486065,0.992196209587514,0.5083612040133779,0.483835005574136
03123,03,123,1525,946,8,938,556,382,0.620327868852459,0.008456659619450317,0.9915433403805497,0.587737843551797,0.40380549682875266
03201,03,201,643,454,7,447,284,163,0.7060653188180405,0.015418502202643172,0.9845814977973568,0.6255506607929515,0.3590308370044053
03202,03,202,861,543,11,532,299,233,0.6306620209059234,0.020257826887661142,0.9797421731123389,0.5506445672191529,0.429097605893186
03203,03,203,1529,882,6,876,530,346,0.5768476128188358,0.006802721088435374,0.9931972789115646,0.6009070294784581,0.3922902494331066
03204,03,204,1578,866,11,855,516,339,0.5487959442332065,0.012702078521939953,0.9872979214780601,0.5958429561200924,0.39145496535796764
03205,03,205,1428,755,12,743,407,336,0.5287114845938375,0.015894039735099338,0.9841059602649007,0.5390728476821192,0.44503311258278144
03206,03,206,1667,955,20,935,502,433,0.5728854229154169,0.020942408376963352,0.9790575916230366,0.5256544502617801,0.45340314136125653
03207,03,207,1518,898,13,885,489,396,0.5915678524374176,0.014476614699331848,0.9855233853006682,0.544543429844098,0.44097995545657015
03208,03,208,1666,881,7,874,463,411,0.5288115246098439,0.007945516458569807,0.9920544835414302,0.5255391600454029,0.46651532349602726
03209,03,209,1696,921,7,914,450,464,0.5430424528301887,0.00760043431053203,0.992399565689468,0.48859934853420195,0.503800217155266
03210,03,210,1751,1035,13,1022,435,587,0.5910908052541405,0.012560386473429951,0.9874396135265701,0.42028985507246375,0.5671497584541063
03211,03,211,1537,898,5,893,398,495,0.5842550422901757,0.005567928730512249,0.9944320712694877,0.44320712694877507,0.5512249443207127
03212,03,212,1425,795,12,783,364,419,0.5578947368421052,0.01509433962264151,0.9849056603773585,0.4578616352201258,0.5270440251572327
03213,03,213,1685,915,9,906,346,560,0.543026706231454,0.009836065573770493,0.9901639344262295,0.37814207650273224,0.6120218579234973
03214,03,214,1588,812,6,806,364,442,0.5113350125944585,0.007389162561576354,0.9926108374384236,0.4482758620689655,0.5443349753694581
03215,03,215,1503,763,7,756,430,326,0.5076513639387891,0.009174311926605505,0.9908256880733946,0.563564875491481,0.4272608125819135
03216,03,216,1624,818,5,813,433,380,0.5036945812807881,0.006112469437652812,0.9938875305623472,0.5293398533007335,0.46454767726161367
03217,03,217,1388,804,16,788,356,432,0.579250720461095,0.01990049751243781,0.9800995024875622,0.4427860696517413,0.5373134328358209
03218,03,218,2007,1068,20,1048,542,506,0.5321375186846039,0.018726591760299626,0.9812734082397003,0.5074906367041199,0.4737827715355805
03219,03,219,1571,911,11,900,496,404,0.5798854232972629,0.012074643249176729,0.9879253567508233,0.544456641053787,0.4434687156970362
03220,03,220,1626,888,8,880,290,590,0.5461254612546126,0.009009009009009009,0.990990990990991,0.32657657657657657,0.6644144144144144
03221,03,221,1654,786,6,780,253,527,0.4752116082224909,0.007633587786259542,0.9923664122137404,0.32188295165394404,0.6704834605597965
03222,03,222,965,535,13,522,308,214,0.5544041450777202,0.024299065420560748,0.9757009345794393,0.5757009345794393,0.4
03301,03,301,1665,872,8,864,378,486,0.5237237237237238,0.009174311926605505,0.9908256880733946,0.4334862385321101,0.5573394495412844
03302,03,302,1677,777,9,768,325,443,0.46332737030411447,0.011583011583011582,0.9884169884169884,0.41827541827541825,0.5701415701415702
03303,03,303,1672,854,9,845,385,460,0.5107655502392344,0.01053864168618267,0.9894613583138173,0.45081967213114754,0.5386416861826698
03304,03,304,1710,921,7,914,331,583,0.5385964912280702,0.00760043431053203,0.992399565689468,0.35939196525515743,0.6330076004343105
03305,03,305,1658,868,12,856,351,505,0.5235223160434258,0.013824884792626729,0.9861751152073732,0.4043778801843318,0.5817972350230415
03306,03,306,1737,890,8,882,293,589,0.51237766263673,0.008988764044943821,0.9910112359550561,0.3292134831460674,0.6617977528089888
03307,03,307,1416,848,11,837,280,557,0.5988700564971752,0.012971698113207548,0.9870283018867925,0.330188679245283,0.6568396226415094
03308,03,308,1328,641,8,633,194,439,0.48268072289156627,0.0124804992199688,0.9875195007800313,0.30265210608424337,0.6848673946957878
03309,03,309,1442,804,3,801,247,554,0.5575589459084604,0.0037313432835820895,0.996268656716418,0.3072139303482587,0.6890547263681592
03310,03,310,1589,886,11,875,262,613,0.5575833857772183,0.012415349887133182,0.9875846501128668,0.29571106094808125,0.6918735891647856
03311,03,311,1064,552,6,546,119,427,0.518796992481203,0.010869565217391304,0.9891304347826086,0.21557971014492755,0.7735507246376812
03312,03,312,1556,847,3,844,175,669,0.544344473007712,0.0035419126328217238,0.9964580873671782,0.2066115702479339,0.7898465171192444
03313,03,313,1455,833,10,823,205,618,0.5725085910652921,0.012004801920768308,0.9879951980792316,0.2460984393757503,0.7418967587034814
03314,03,314,1552,711,7,704,126,578,0.4581185567010309,0.009845288326300985,0.9901547116736991,0.17721518987341772,0.8129395218002813
03315,03,315,1526,871,8,863,202,661,0.5707732634338138,0.009184845005740528,0.9908151549942594,0.23191733639494833,0.7588978185993112
03316,03,316,1745,1022,10,1012,254,758,0.5856733524355301,0.009784735812133072,0.9902152641878669,0.24853228962818003,0.7416829745596869
03317,03,317,1697,928,4,924,231,693,0.5468473777253977,0.004310344827586207,0.9956896551724138,0.24892241379310345,0.7467672413793104
03318,03,318,1568,786,10,776,233,543,0.5012755102040817,0.01272264631043257,0.9872773536895675,0.2964376590330789,0.6908396946564885
03319,03,319,1753,901,14,887,368,519,0.5139760410724472,0.01553829078801332,0.9844617092119867,0.40843507214206437,0.5760266370699223
03320,03,320,1557,790,14,776,140,636,0.5073859987154785,0.017721518987341773,0.9822784810126582,0.17721518987341772,0.8050632911392405
03321,03,321,1588,888,8,880,218,662,0.5591939546599496,0.009009009009009009,0.990990990990991,0.24549549549549549,0.7454954954954955
03401,03,401,1860,988,14,974,429,545,0.5311827956989247,0.01417004048582996,0.9858299595141701,0.4342105263157895,0.5516194331983806
03402,03,402,1754,961,11,950,359,591,0.5478905359179019,0.011446409989594173,0.9885535900104059,0.37356919875130074,0.6149843912591051
03403,03,403,1928,996,24,972,403,569,0.516597510373444,0.024096385542168676,0.9759036144578314,0.4046184738955823,0.571285140562249
03404,03,404,1528,702,24,678,268,410,0.4594240837696335,0.03418803418803419,0.9658119658119658,0.3817663817663818,0.584045584045584
03405,03,405,1622,843,30,813,410,403,0.5197287299630087,0.03558718861209965,0.9644128113879004,0.4863582443653618,0.47805456702253857
03406,03,406,1747,892,18,874,426,448,0.5105895821408128,0.020179372197309416,0.9798206278026906,0.47757847533632286,0.5022421524663677
03407,03,407,1672,865,12,853,458,395,0.5173444976076556,0.013872832369942197,0.9861271676300578,0.5294797687861271,0.45664739884393063
03408,03,408,1845,879,28,851,425,426,0.4764227642276423,0.03185437997724687,0.9681456200227532,0.48350398179749715,0.48464163822525597
03409,03,409,1330,636,9,627,267,360,0.4781954887218045,0.014150943396226415,0.9858490566037735,0.419811320754717,0.5660377358490566
03410,03,410,1351,721,24,697,350,347,0.533678756476684,0.033287101248266296,0.9667128987517337,0.4854368932038835,0.4812760055478502
03411,03,411,1694,941,8,933,239,694,0.5554899645808736,0.008501594048884165,0.9914984059511158,0.25398512221041447,0.7375132837407014
03412,03,412,1563,836,6,830,180,650,0.5348688419705694,0.007177033492822967,0.992822966507177,0.215311004784689,0.777511961722488
03413,03,413,1522,793,9,784,238,546,0.5210249671484888,0.011349306431273645,0.9886506935687264,0.30012610340479196,0.6885245901639344
03414,03,414,2148,1132,18,1114,416,698,0.527001862197393,0.015901060070671377,0.9840989399293286,0.3674911660777385,0.6166077738515902
03415,03,415,1242,712,12,700,325,375,0.573268921095008,0.016853932584269662,0.9831460674157303,0.45646067415730335,0.526685393258427
03416,03,416,1749,908,12,896,364,532,0.51915380217267,0.013215859030837005,0.986784140969163,0.4008810572687225,0.5859030837004405
03417,03,417,1741,844,20,824,398,426,0.48477886272257326,0.023696682464454975,0.976303317535545,0.471563981042654,0.504739336492891
03418,03,418,1010,389,6,383,189,194,0.38514851485148516,0.015424164524421594,0.9845758354755784,0.48586118251928023,0.4987146529562982
03501,03,501,1691,928,13,915,339,576,0.5487876995860438,0.014008620689655173,0.9859913793103449,0.36530172413793105,0.6206896551724138
03502,03,502,1326,703,15,688,225,463,0.5301659125188537,0.021337126600284494,0.9786628733997155,0.3200568990042674,0.6586059743954481
03503,03,503,1609,896,15,881,281,600,0.5568676196395277,0.016741071428571428,0.9832589285714286,0.31361607142857145,0.6696428571428571
03504,03,504,1380,775,10,765,262,503,0.5615942028985508,0.012903225806451613,0.9870967741935484,0.33806451612903227,0.6490322580645161
03505,03,505,1287,657,15,642,275,367,0.5104895104895105,0.0228310502283105,0.9771689497716894,0.4185692541856925,0.558599695585997
03506,03,506,1482,757,16,741,332,409,0.5107962213225371,0.021136063408190225,0.9788639365918098,0.4385733157199472,0.5402906208718626
03507,03,507,1588,801,12,789,337,452,0.5044080604534005,0.0149812734082397,0.9850187265917603,0.4207240948813982,0.5642946317103621
03508,03,508,1463,760,11,749,311,438,0.5194805194805194,0.014473684210526316,0.9855263157894737,0.40921052631578947,0.5763157894736842
03509,03,509,1779,914,17,897,327,570,0.5137717818999438,0.018599562363238512,0.9814004376367614,0.35776805251641136,0.6236323851203501
03510,03,510,1474,788,7,781,276,505,0.5345997286295794,0.008883248730964468,0.9911167512690355,0.350253807106599,0.6408629441624365
03511,03,511,1628,918,9,909,245,664,0.5638820638820639,0.00980392156862745,0.9901960784313726,0.2668845315904139,0.7233115468409586
03512,03,512,1580,763,14,749,439,310,0.4829113924050633,0.01834862385321101,0.981651376146789,0.5753604193971167,0.40629095674967236
03513,03,513,1703,898,11,887,279,608,0.5273047563123899,0.012249443207126948,0.987750556792873,0.3106904231625835,0.6770601336302895
03514,03,514,1569,853,7,846,354,492,0.5436583811344805,0.008206330597889801,0.9917936694021102,0.41500586166471276,0.5767878077373975
03515,03,515,1294,755,5,750,180,570,0.5834621329211747,0.006622516556291391,0.9933774834437086,0.23841059602649006,0.7549668874172185
03516,03,516,1802,939,11,928,218,710,0.521087680355161,0.011714589989350373,0.9882854100106496,0.2321618743343983,0.7561235356762513
03517,03,517,1229,729,4,725,138,587,0.5931651749389748,0.0054869684499314125,0.9945130315500685,0.18930041152263374,0.8052126200274349
03518,03,518,1427,730,9,721,232,489,0.51156271899089,0.012328767123287671,0.9876712328767123,0.3178082191780822,0.6698630136986301
03519,03,519,1314,654,8,646,261,385,0.4977168949771689,0.012232415902140673,0.9877675840978594,0.39908256880733944,0.5886850152905199
03520,03,520,1544,835,12,823,334,489,0.5408031088082902,0.01437125748502994,0.98562874251497,0.4,0.5856287425149701
03600,03,600,1501,780,23,757,281,476,0.519653564290473,0.029487179487179487,0.9705128205128205,0.36025641025641025,0.6102564102564103
03601,03,601,1554,829,16,813,346,467,0.5334620334620335,0.019300361881785282,0.9806996381182147,0.41737032569360677,0.5633293124246079
03602,03,602,1544,811,14,797,318,479,0.5252590673575129,0.01726263871763255,0.9827373612823674,0.3921085080147966,0.5906288532675709
03603,03,603,1197,648,14,634,268,366,0.5413533834586466,0.021604938271604937,0.9783950617283951,0.41358024691358025,0.5648148148148148
03604,03,604,1376,774,13,761,288,473,0.5625,0.016795865633074936,0.9832041343669251,0.37209302325581395,0.6111111111111112
03605,03,605,1452,841,22,819,316,503,0.5792011019283747,0.026159334126040427,0.9738406658739596,0.375743162901308,0.5980975029726516
03606,03,606,1646,899,22,877,327,550,0.5461725394896719,0.024471635150166853,0.9755283648498332,0.36373748609566187,0.6117908787541713
03607,03,607,1614,902,10,892,359,533,0.5588599752168525,0.011086474501108648,0.9889135254988913,0.39800443458980045,0.5909090909090909
03608,03,608,1585,888,19,869,372,497,0.5602523659305993,0.021396396396396396,0.9786036036036037,0.4189189189189189,0.5596846846846847
03609,03,609,1588,872,15,857,378,479,0.5491183879093199,0.017201834862385322,0.9827981651376146,0.4334862385321101,0.5493119266055045
03610,03,610,1613,948,17,931,417,514,0.587724736515809,0.017932489451476793,0.9820675105485233,0.439873417721519,0.5421940928270043
03611,03,611,1534,752,13,739,336,403,0.49022164276401564,0.017287234042553192,0.9827127659574468,0.44680851063829785,0.535904255319149
03612,03,612,1517,786,11,775,314,461,0.5181278839815425,0.013994910941475827,0.9860050890585241,0.3994910941475827,0.5865139949109415
03613,03,613,1444,769,15,754,326,428,0.5325484764542936,0.01950585175552666,0.9804941482444733,0.42392717815344605,0.5565669700910273
03614,03,614,1732,950,26,924,352,572,0.5484988452655889,0.02736842105263158,0.9726315789473684,0.3705263157894737,0.6021052631578947
03615,03,615,923,518,11,507,242,265,0.5612134344528711,0.021235521235521235,0.9787644787644788,0.4671814671814672,0.5115830115830116
03616,03,616,816,438,7,431,168,263,0.5367647058823529,0.01598173515981735,0.9840182648401826,0.3835616438356164,0.6004566210045662
03617,03,617,1626,926,28,898,415,483,0.5694956949569495,0.03023758099352052,0.9697624190064795,0.4481641468682505,0.521598272138229
03618,03,618,1699,903,14,889,394,495,0.531489111241907,0.015503875968992248,0.9844961240310077,0.4363233665559247,0.5481727574750831
03619,03,619,1427,754,21,733,294,439,0.5283812193412754,0.027851458885941646,0.9721485411140584,0.38992042440318303,0.5822281167108754
03620,03,620,1752,950,14,936,439,497,0.5422374429223744,0.014736842105263158,0.9852631578947368,0.46210526315789474,0.5231578947368422
03701,03,701,1521,843,15,828,409,419,0.5542406311637081,0.017793594306049824,0.9822064056939501,0.4851720047449585,0.4970344009489917
03702,03,702,1456,798,0,798,364,434,0.5480769230769231,0.0,1.0,0.45614035087719296,0.543859649122807
03703,03,703,1652,859,11,848,428,420,0.5199757869249395,0.012805587892898719,0.9871944121071012,0.49825378346915017,0.4889406286379511
03704,03,704,1337,670,10,660,363,297,0.5011219147344802,0.014925373134328358,0.9850746268656716,0.5417910447761194,0.44328358208955226
03705,03,705,1639,860,24,836,380,456,0.5247101891397193,0.027906976744186046,0.9720930232558139,0.4418604651162791,0.5302325581395348
03706,03,706,1634,745,19,726,361,365,0.4559363525091799,0.025503355704697986,0.974496644295302,0.48456375838926175,0.4899328859060403
03707,03,707,1917,869,27,842,441,401,0.45331246739697445,0.031070195627157654,0.9689298043728424,0.5074798619102416,0.4614499424626007
03708,03,708,1608,792,0,792,360,432,0.4925373134328358,0.0,1.0,0.45454545454545453,0.5454545454545454
03709,03,709,1645,898,18,880,429,451,0.5458966565349544,0.0200445434298441,0.9799554565701559,0.477728285077951,0.5022271714922049
03710,03,710,1802,952,30,922,432,490,0.5283018867924528,0.031512605042016806,0.9684873949579832,0.453781512605042,0.5147058823529411
03711,03,711,1548,720,14,706,333,373,0.46511627906976744,0.019444444444444445,0.9805555555555555,0.4625,0.5180555555555556
03712,03,712,1534,808,13,795,389,406,0.5267275097783573,0.01608910891089109,0.9839108910891089,0.4814356435643564,0.5024752475247525
03713,03,713,1486,785,5,780,349,431,0.528263795423957,0.006369426751592357,0.9936305732484076,0.4445859872611465,0.5490445859872611
03714,03,714,1297,653,19,634,257,377,0.5034695451040864,0.02909647779479326,0.9709035222052067,0.39356814701378257,0.5773353751914242
03715,03,715,1672,851,10,841,356,485,0.5089712918660287,0.011750881316098707,0.9882491186839013,0.418331374853114,0.5699177438307873
03716,03,716,1506,763,11,752,328,424,0.5066401062416999,0.014416775884665793,0.9855832241153342,0.42988204456094364,0.5557011795543906
03717,03,717,1345,678,7,671,284,387,0.504089219330855,0.01032448377581121,0.9896755162241888,0.41887905604719766,0.5707964601769911
03718,03,718,1081,624,14,610,279,331,0.5772432932469935,0.022435897435897436,0.9775641025641025,0.44711538461538464,0.530448717948718
03719,03,719,1358,733,7,726,364,362,0.5397643593519882,0.009549795361527967,0.990450204638472,0.4965893587994543,0.49386084583901774
03720,03,720,1440,805,18,787,327,460,0.5590277777777778,0.02236024844720497,0.977639751552795,0.4062111801242236,0.5714285714285714
03801,03,801,1945,985,16,969,541,428,0.506426735218509,0.016243654822335026,0.983756345177665,0.5492385786802031,0.43451776649746193
03802,03,802,1499,824,27,797,367,430,0.5496997998665777,0.032766990291262135,0.9672330097087378,0.44538834951456313,0.5218446601941747
03803,03,803,1491,780,27,753,332,421,0.5231388329979879,0.03461538461538462,0.9653846153846154,0.4256410256410256,0.5397435897435897
03804,03,804,1472,852,15,837,356,481,0.5788043478260869,0.017605633802816902,0.9823943661971831,0.41784037558685444,0.5645539906103286
03805,03,805,1786,951,17,934,413,521,0.5324748040313549,0.017875920084121977,0.982124079915878,0.434279705573081,0.5478443743427971
03806,03,806,1655,871,27,844,392,452,0.5262839879154079,0.030998851894374284,0.9690011481056258,0.4500574052812859,0.5189437428243399
03807,03,807,1520,788,14,774,317,457,0.5184210526315789,0.017766497461928935,0.9822335025380711,0.4022842639593909,0.5799492385786802
03808,03,808,1731,811,22,789,472,317,0.4685153090699018,0.027127003699136867,0.9728729963008631,0.5819975339087546,0.3908754623921085
03809,03,809,1588,812,20,792,339,453,0.5113350125944585,0.024630541871921183,0.9753694581280788,0.41748768472906406,0.5578817733990148
03810,03,810,1453,806,17,789,374,415,0.5547143840330351,0.02109181141439206,0.9789081885856079,0.4640198511166253,0.5148883374689827
03811,03,811,1471,795,22,773,348,425,0.540448674371176,0.027672955974842768,0.9723270440251572,0.4377358490566038,0.5345911949685535
03812,03,812,1675,877,20,857,393,464,0.5235820895522388,0.02280501710376283,0.9771949828962372,0.44811858608893956,0.5290763968072976
03813,03,813,1797,997,18,979,477,502,0.5548135781858653,0.01805416248746239,0.9819458375125376,0.47843530591775324,0.5035105315947843
03814,03,814,1402,753,13,740,330,410,0.5370898716119828,0.017264276228419653,0.9827357237715804,0.43824701195219123,0.5444887118193891
03815,03,815,1522,843,25,818,366,452,0.5538764783180026,0.02965599051008304,0.970344009489917,0.43416370106761565,0.5361803084223014
03816,03,816,1475,822,19,803,385,418,0.5572881355932203,0.023114355231143552,0.9768856447688564,0.4683698296836983,0.5085158150851582
03817,03,817,1295,652,16,636,295,341,0.5034749034749034,0.024539877300613498,0.9754601226993865,0.45245398773006135,0.5230061349693251
03818,03,818,1274,631,15,616,304,312,0.49529042386185246,0.02377179080824089,0.9762282091917591,0.48177496038034867,0.49445324881141045
03819,03,819,944,510,14,496,213,283,0.5402542372881356,0.027450980392156862,0.9725490196078431,0.4176470588235294,0.5549019607843138
03901,03,901,1648,876,15,861,369,492,0.5315533980582524,0.017123287671232876,0.9828767123287672,0.4212328767123288,0.5616438356164384
03902,03,902,1567,875,14,861,416,445,0.5583918315252074,0.016,0.984,0.4754285714285714,0.5085714285714286
03903,03,903,1816,1077,25,1052,404,648,0.5930616740088106,0.02321262766945218,0.9767873723305478,0.3751160631383473,0.6016713091922006
03904,03,904,1698,954,19,935,420,515,0.5618374558303887,0.019916142557651992,0.980083857442348,0.44025157232704404,0.539832285115304
03905,03,905,1374,716,15,701,359,342,0.5211062590975255,0.02094972067039106,0.979050279329609,0.5013966480446927,0.4776536312849162
03906,03,906,1141,600,19,581,270,311,0.5258545135845749,0.03166666666666667,0.9683333333333334,0.45,0.5183333333333333
03907,03,907,1176,615,16,599,345,254,0.5229591836734694,0.026016260162601626,0.9739837398373984,0.5609756097560976,0.41300813008130083
03908,03,908,1572,721,25,696,397,299,0.4586513994910941,0.03467406380027739,0.9653259361997226,0.550624133148405,0.4147018030513176
03909,03,909,1049,580,23,557,264,293,0.5529075309818875,0.039655172413793106,0.9603448275862069,0.45517241379310347,0.5051724137931034
03910,03,910,1236,536,19,517,248,269,0.4336569579288026,0.03544776119402985,0.9645522388059702,0.4626865671641791,0.5018656716417911
03911,03,911,1369,693,17,676,332,344,0.506208911614317,0.024531024531024532,0.9754689754689755,0.4790764790764791,0.4963924963924964
03912,03,912,1351,699,15,684,351,333,0.5173945225758697,0.02145922746781116,0.9785407725321889,0.5021459227467812,0.47639484978540775
03913,03,913,1511,799,25,774,354,420,0.528788881535407,0.03128911138923655,0.9687108886107635,0.4430538172715895,0.5256570713391739
03914,03,914,975,528,14,514,236,278,0.5415384615384615,0.026515151515151516,0.9734848484848485,0.44696969696969696,0.5265151515151515
03915,03,915,1904,966,37,929,433,496,0.5073529411764706,0.038302277432712216,0.9616977225672878,0.44824016563146996,0.5134575569358178
03916,03,916,1611,912,18,894,351,543,0.5661080074487895,0.019736842105263157,0.9802631578947368,0.3848684210526316,0.5953947368421053
03917,03,917,1505,829,15,814,325,489,0.5508305647840531,0.018094089264173704,0.9819059107358263,0.39203860072376356,0.5898673100120627
03918,03,918,1446,823,18,805,364,441,0.5691562932226832,0.02187120291616039,0.9781287970838396,0.4422843256379101,0.5358444714459295
03919,03,919,1639,889,18,871,403,468,0.5424039048200122,0.020247469066366704,0.9797525309336333,0.453318335208099,0.5264341957255343
03920,03,920,1141,553,12,541,297,244,0.48466257668711654,0.0216998191681736,0.9783001808318263,0.5370705244122965,0.4412296564195298
03921,03,921,1181,613,18,595,301,294,0.519051651143099,0.02936378466557912,0.9706362153344209,0.4910277324632953,0.4796084828711256
03922,03,922,1476,911,17,894,361,533,0.6172086720867209,0.018660812294182216,0.9813391877058177,0.39626783754116357,0.5850713501646543
03923,03,923,646,219,13,206,104,102,0.33900928792569657,0.0593607305936073,0.9406392694063926,0.4748858447488584,0.4657534246575342
03924,03,924,1852,974,29,945,396,549,0.5259179265658748,0.029774127310061602,0.9702258726899384,0.406570841889117,0.5636550308008214
04101,04,101,1060,457,3,454,333,121,0.43113207547169813,0.006564551422319475,0.9934354485776805,0.7286652078774617,0.2647702407002188
04102,04,102,1090,502,17,485,335,150,0.46055045871559636,0.03386454183266932,0.9661354581673307,0.6673306772908366,0.29880478087649404
04103,04,103,1107,520,12,508,333,175,0.46973803071364045,0.023076923076923078,0.9769230769230769,0.6403846153846153,0.33653846153846156
04104,04,104,958,441,7,434,295,139,0.4603340292275574,0.015873015873015872,0.9841269841269841,0.6689342403628118,0.31519274376417233
04105,04,105,995,405,10,395,276,119,0.40703517587939697,0.024691358024691357,0.9753086419753086,0.6814814814814815,0.2938271604938272
04106,04,106,1406,695,10,685,510,175,0.49431009957325744,0.014388489208633094,0.9856115107913669,0.7338129496402878,0.2517985611510791
04107,04,107,1315,618,11,607,409,198,0.4699619771863118,0.01779935275080906,0.982200647249191,0.6618122977346278,0.32038834951456313
04108,04,108,811,382,2,380,289,91,0.47102342786683105,0.005235602094240838,0.9947643979057592,0.756544502617801,0.23821989528795812
04109,04,109,891,386,6,380,277,103,0.4332210998877666,0.015544041450777202,0.9844559585492227,0.7176165803108808,0.266839378238342
04110,04,110,1181,582,12,570,415,155,0.4928027095681626,0.020618556701030927,0.979381443298969,0.7130584192439863,0.2663230240549828
04111,04,111,1032,488,1,487,378,109,0.4728682170542636,0.0020491803278688526,0.9979508196721312,0.7745901639344263,0.22336065573770492
04112,04,112,1256,640,15,625,444,181,0.5095541401273885,0.0234375,0.9765625,0.69375,0.2828125
04113,04,113,1359,722,14,708,482,226,0.5312729948491538,0.019390581717451522,0.9806094182825484,0.667590027700831,0.31301939058171746
04114,04,114,1247,557,6,551,390,161,0.4466720128307939,0.010771992818671455,0.9892280071813285,0.7001795332136446,0.289048473967684
04115,04,115,1402,738,2,736,468,268,0.5263908701854494,0.0027100271002710027,0.997289972899729,0.6341463414634146,0.36314363143631434
04116,04,116,1260,635,15,620,417,203,0.503968253968254,0.023622047244094488,0.9763779527559056,0.6566929133858268,0.31968503937007875
04117,04,117,1624,823,17,806,565,241,0.5067733990147784,0.020656136087484813,0.9793438639125152,0.6865127582017011,0.2928311057108141
04118,04,118,1493,681,10,671,471,200,0.45612860013395845,0.014684287812041116,0.9853157121879589,0.6916299559471366,0.2936857562408223
04201,04,201,949,447,5,442,282,160,0.47102212855637515,0.011185682326621925,0.9888143176733781,0.6308724832214765,0.3579418344519016
04202,04,202,1137,530,8,522,347,175,0.46613896218117856,0.01509433962264151,0.9849056603773585,0.6547169811320754,0.330188679245283
04203,04,203,1588,800,12,788,526,262,0.5037783375314862,0.015,0.985,0.6575,0.3275
04204,04,204,1517,749,20,729,602,127,0.4937376400791035,0.0267022696929239,0.9732977303070761,0.8037383177570093,0.16955941255006676
04205,04,205,1373,699,10,689,520,169,0.5091041514930809,0.01430615164520744,0.9856938483547926,0.7439198855507868,0.24177396280400573
04206,04,206,1196,598,8,590,435,155,0.5,0.013377926421404682,0.9866220735785953,0.7274247491638796,0.2591973244147157
04207,04,207,1157,563,9,554,373,181,0.48660328435609335,0.015985790408525755,0.9840142095914742,0.6625222024866785,0.32149200710479575
04208,04,208,1712,774,21,753,524,229,0.45210280373831774,0.027131782945736434,0.9728682170542635,0.6770025839793282,0.2958656330749354
04209,04,209,1056,524,8,516,347,169,0.4962121212121212,0.015267175572519083,0.9847328244274809,0.6622137404580153,0.32251908396946566
04210,04,210,1215,603,11,592,406,186,0.4962962962962963,0.01824212271973466,0.9817578772802653,0.6733001658374793,0.30845771144278605
04211,04,211,1445,737,2,735,507,228,0.5100346020761246,0.0027137042062415195,0.9972862957937585,0.6879240162822252,0.3093622795115332
04212,04,212,1134,513,3,510,353,157,0.4523809523809524,0.005847953216374269,0.9941520467836257,0.6881091617933723,0.3060428849902534
04213,04,213,1628,795,9,786,557,229,0.4883292383292383,0.011320754716981131,0.9886792452830189,0.70062893081761,0.2880503144654088
04214,04,214,1180,566,18,548,353,195,0.47966101694915253,0.03180212014134275,0.9681978798586572,0.6236749116607774,0.34452296819787986
04215,04,215,1646,836,19,817,562,255,0.5078979343863913,0.022727272727272728,0.9772727272727273,0.6722488038277512,0.3050239234449761
04216,04,216,1064,526,4,522,373,149,0.4943609022556391,0.0076045627376425855,0.9923954372623575,0.7091254752851711,0.2832699619771863
04217,04,217,1441,723,15,708,494,214,0.501734906315059,0.02074688796680498,0.979253112033195,0.6832641770401107,0.2959889349930844
04218,04,218,1432,733,5,728,536,192,0.5118715083798883,0.0068212824010914054,0.9931787175989086,0.7312414733969986,0.26193724420190995
04219,04,219,1195,552,10,542,398,144,0.4619246861924686,0.018115942028985508,0.9818840579710145,0.7210144927536232,0.2608695652173913
04220,04,220,1222,616,14,602,396,206,0.5040916530278232,0.022727272727272728,0.9772727272727273,0.6428571428571429,0.3344155844155844
04221,04,221,1227,539,6,533,393,140,0.4392828035859821,0.011131725417439703,0.9888682745825603,0.7291280148423006,0.2597402597402597
04222,04,222,817,449,5,444,309,135,0.5495716034271726,0.011135857461024499,0.9888641425389755,0.688195991091314,0.30066815144766146
04223,04,223,1550,764,5,759,540,219,0.49290322580645163,0.006544502617801047,0.993455497382199,0.7068062827225131,0.28664921465968585
04224,04,224,1097,603,17,586,357,229,0.5496809480401094,0.028192371475953566,0.9718076285240465,0.5920398009950248,0.37976782752902155
04301,04,301,1270,596,22,574,366,208,0.4692913385826772,0.03691275167785235,0.9630872483221476,0.6140939597315436,0.348993288590604
04302,04,302,1108,573,6,567,389,178,0.5171480144404332,0.010471204188481676,0.9895287958115183,0.6788830715532286,0.3106457242582897
04303,04,303,1328,712,14,698,469,229,0.536144578313253,0.019662921348314606,0.9803370786516854,0.6587078651685393,0.32162921348314605
04304,04,304,1318,687,3,684,461,223,0.5212443095599393,0.004366812227074236,0.9956331877729258,0.6710334788937409,0.3245997088791849
04305,04,305,1519,764,11,753,488,265,0.5029624753127058,0.014397905759162303,0.9856020942408377,0.6387434554973822,0.3468586387434555
04306,04,306,1079,614,8,606,352,254,0.5690454124189064,0.013029315960912053,0.9869706840390879,0.5732899022801303,0.41368078175895767
04307,04,307,1394,765,26,739,426,313,0.5487804878048781,0.03398692810457516,0.9660130718954248,0.5568627450980392,0.4091503267973856
04308,04,308,1530,781,10,771,514,257,0.5104575163398692,0.012804097311139564,0.9871959026888605,0.6581306017925737,0.3290653008962868
04309,04,309,1563,777,6,771,544,227,0.4971209213051823,0.007722007722007722,0.9922779922779923,0.7001287001287001,0.29214929214929214
04310,04,310,1054,551,14,537,353,184,0.5227703984819735,0.025408348457350273,0.9745916515426497,0.6406533575317604,0.3339382940108893
04311,04,311,1414,808,15,793,483,310,0.5714285714285714,0.018564356435643563,0.9814356435643564,0.5977722772277227,0.38366336633663367
04312,04,312,1225,605,7,598,402,196,0.49387755102040815,0.011570247933884297,0.9884297520661157,0.6644628099173554,0.3239669421487603
04313,04,313,1496,686,18,668,409,259,0.4585561497326203,0.026239067055393587,0.9737609329446064,0.5962099125364432,0.37755102040816324
04314,04,314,1419,739,12,727,429,298,0.5207892882311487,0.016238159675236806,0.9837618403247632,0.5805142083897158,0.40324763193504737
04315,04,315,1451,800,8,792,479,313,0.5513439007580979,0.01,0.99,0.59875,0.39125
04316,04,316,1230,623,4,619,412,207,0.5065040650406504,0.006420545746388443,0.9935794542536116,0.6613162118780096,0.33226324237560195
04317,04,317,1010,501,4,497,329,168,0.49603960396039604,0.007984031936127744,0.9920159680638723,0.656686626746507,0.33532934131736525
04318,04,318,1132,612,10,602,348,254,0.5406360424028268,0.016339869281045753,0.9836601307189542,0.5686274509803921,0.4150326797385621
04319,04,319,908,481,12,469,282,187,0.5297356828193832,0.02494802494802495,0.975051975051975,0.5862785862785863,0.3887733887733888
04320,04,320,1569,745,11,734,496,238,0.4748247291268324,0.01476510067114094,0.9852348993288591,0.6657718120805369,0.3194630872483222
04321,04,321,1292,586,9,577,400,177,0.4535603715170279,0.015358361774744027,0.984641638225256,0.6825938566552902,0.30204778156996587
04322,04,322,1187,599,8,591,360,231,0.5046335299073293,0.01335559265442404,0.986644407345576,0.6010016694490818,0.38564273789649417
04323,04,323,1541,784,35,749,519,230,0.508760545100584,0.044642857142857144,0.9553571428571429,0.6619897959183674,0.29336734693877553
04324,04,324,1000,505,13,492,356,136,0.505,0.02574257425742574,0.9742574257425742,0.7049504950495049,0.2693069306930693
04401,04,401,1464,680,14,666,452,214,0.4644808743169399,0.020588235294117647,0.9794117647058823,0.6647058823529411,0.31470588235294117
04402,04,402,1107,517,16,501,374,127,0.4670280036133695,0.030947775628626693,0.9690522243713733,0.723404255319149,0.24564796905222436
04403,04,403,1577,597,8,589,429,160,0.37856689917564995,0.01340033500837521,0.9865996649916248,0.7185929648241206,0.26800670016750416
04404,04,404,1052,601,2,599,413,186,0.5712927756653993,0.0033277870216306157,0.9966722129783694,0.6871880199667221,0.30948419301164726
04405,04,405,1101,564,15,549,371,178,0.5122615803814714,0.026595744680851064,0.973404255319149,0.6578014184397163,0.31560283687943264
04406,04,406,1081,509,3,506,387,119,0.4708603145235893,0.005893909626719057,0.9941060903732809,0.7603143418467584,0.2337917485265226
04407,04,407,1481,737,15,722,490,232,0.49763673193787983,0.0203527815468114,0.9796472184531886,0.6648575305291723,0.3147896879240163
04408,04,408,1362,637,15,622,440,182,0.46769456681350957,0.023547880690737835,0.9764521193092621,0.6907378335949764,0.2857142857142857
04409,04,409,1268,631,18,613,405,208,0.49763406940063093,0.028526148969889066,0.971473851030111,0.6418383518225039,0.329635499207607
04410,04,410,1294,615,18,597,463,134,0.4752704791344668,0.02926829268292683,0.9707317073170731,0.7528455284552845,0.21788617886178863
04411,04,411,1407,757,12,745,477,268,0.5380241648898365,0.015852047556142668,0.9841479524438573,0.6301188903566711,0.35402906208718626
04412,04,412,1413,731,17,714,512,202,0.5173389950460014,0.023255813953488372,0.9767441860465116,0.7004103967168263,0.2763337893296854
04413,04,413,1182,569,9,560,379,181,0.4813874788494078,0.015817223198594025,0.984182776801406,0.6660808435852372,0.3181019332161687
04414,04,414,1395,678,6,672,467,205,0.4860215053763441,0.008849557522123894,0.9911504424778761,0.6887905604719764,0.3023598820058997
04415,04,415,1540,705,10,695,494,201,0.4577922077922078,0.014184397163120567,0.9858156028368794,0.700709219858156,0.2851063829787234
04416,04,416,1446,662,12,650,457,193,0.4578146611341632,0.01812688821752266,0.9818731117824774,0.6903323262839879,0.29154078549848944
04417,04,417,1113,557,8,549,386,163,0.5004492362982929,0.01436265709156194,0.9856373429084381,0.6929982046678635,0.2926391382405745
04418,04,418,1363,646,13,633,461,172,0.4739545121056493,0.020123839009287926,0.9798761609907121,0.7136222910216719,0.26625386996904027
04419,04,419,1270,626,9,617,440,177,0.49291338582677163,0.01437699680511182,0.9856230031948882,0.7028753993610224,0.2827476038338658
04420,04,420,1186,553,15,538,401,137,0.4662731871838111,0.027124773960216998,0.972875226039783,0.7251356238698011,0.24773960216998192
04421,04,421,1096,465,4,461,333,128,0.42427007299270075,0.008602150537634409,0.9913978494623656,0.7161290322580646,0.2752688172043011
04422,04,422,918,418,3,415,307,108,0.4553376906318083,0.007177033492822967,0.992822966507177,0.7344497607655502,0.2583732057416268
04423,04,423,1182,509,18,491,396,95,0.4306260575296108,0.03536345776031434,0.9646365422396856,0.7779960707269156,0.18664047151277013
04424,04,424,1213,634,10,624,489,135,0.5226710634789777,0.015772870662460567,0.9842271293375394,0.7712933753943217,0.21293375394321767
04425,04,425,1511,734,14,720,523,197,0.485771012574454,0.01907356948228883,0.9809264305177112,0.7125340599455041,0.2683923705722071
04501,04,501,947,463,5,458,338,120,0.48891235480464623,0.01079913606911447,0.9892008639308856,0.7300215982721382,0.2591792656587473
04502,04,502,1145,505,10,495,398,97,0.4410480349344978,0.019801980198019802,0.9801980198019802,0.7881188118811882,0.19207920792079208
04503,04,503,919,426,11,415,321,94,0.46354733405875953,0.025821596244131457,0.9741784037558685,0.7535211267605634,0.22065727699530516
04504,04,504,1310,512,5,507,394,113,0.39083969465648855,0.009765625,0.990234375,0.76953125,0.220703125
04505,04,505,1134,600,12,588,435,153,0.5291005291005291,0.02,0.98,0.725,0.255
04506,04,506,1453,744,6,738,541,197,0.5120440467997247,0.008064516129032258,0.9919354838709677,0.7271505376344086,0.2647849462365591
04507,04,507,993,480,6,474,344,130,0.48338368580060426,0.0125,0.9875,0.7166666666666667,0.2708333333333333
04508,04,508,1184,632,10,622,440,182,0.5337837837837838,0.015822784810126583,0.9841772151898734,0.6962025316455697,0.2879746835443038
04509,04,509,1378,727,19,708,474,234,0.5275761973875182,0.026134800550206328,0.9738651994497937,0.6519944979367263,0.3218707015130674
04510,04,510,1475,786,22,764,538,226,0.5328813559322034,0.027989821882951654,0.9720101781170484,0.6844783715012722,0.2875318066157761
04511,04,511,1218,561,10,551,427,124,0.4605911330049261,0.017825311942959002,0.982174688057041,0.7611408199643493,0.22103386809269163
04512,04,512,1083,539,18,521,394,127,0.4976915974145891,0.03339517625231911,0.9666048237476809,0.7309833024118738,0.23562152133580705
04513,04,513,1444,644,12,632,438,194,0.44598337950138506,0.018633540372670808,0.9813664596273292,0.6801242236024845,0.30124223602484473
04514,04,514,1150,504,7,497,351,146,0.43826086956521737,0.013888888888888888,0.9861111111111112,0.6964285714285714,0.2896825396825397
04515,04,515,1183,552,8,544,381,163,0.46661031276415893,0.014492753623188406,0.9855072463768116,0.6902173913043478,0.29528985507246375
04516,04,516,956,485,8,477,328,149,0.5073221757322176,0.016494845360824743,0.9835051546391752,0.6762886597938145,0.30721649484536084
04517,04,517,1579,806,20,786,585,201,0.5104496516782774,0.02481389578163772,0.9751861042183623,0.7258064516129032,0.24937965260545905
04518,04,518,1384,669,31,638,461,177,0.4833815028901734,0.04633781763826607,0.953662182361734,0.6890881913303438,0.2645739910313901
04519,04,519,1280,676,20,656,459,197,0.528125,0.029585798816568046,0.9704142011834319,0.6789940828402367,0.29142011834319526
04520,04,520,1350,716,19,697,505,192,0.5303703703703704,0.02653631284916201,0.973463687150838,0.7053072625698324,0.2681564245810056
04521,04,521,1005,465,9,456,346,110,0.4626865671641791,0.01935483870967742,0.9806451612903225,0.7440860215053764,0.23655913978494625
04522,04,522,1276,551,5,546,442,104,0.4318181818181818,0.009074410163339383,0.9909255898366606,0.8021778584392014,0.18874773139745918
04523,04,523,1073,525,5,520,396,124,0.48928238583411,0.009523809523809525,0.9904761904761905,0.7542857142857143,0.2361904761904762
04524,04,524,1360,578,7,571,456,115,0.425,0.012110726643598616,0.9878892733564014,0.7889273356401384,0.19896193771626297
04525,04,525,1128,491,12,479,366,113,0.4352836879432624,0.024439918533604887,0.9755600814663951,0.745417515274949,0.23014256619144602
04601,04,601,1052,510,13,497,340,157,0.4847908745247148,0.025490196078431372,0.9745098039215686,0.6666666666666666,0.307843137254902
04602,04,602,1065,517,6,511,360,151,0.48544600938967136,0.01160541586073501,0.988394584139265,0.6963249516441006,0.29206963249516443
04603,04,603,1140,461,3,458,307,151,0.4043859649122807,0.006507592190889371,0.9934924078091106,0.665943600867679,0.3275488069414317
04604,04,604,1085,473,10,463,315,148,0.4359447004608295,0.021141649048625793,0.9788583509513742,0.6659619450317125,0.3128964059196617
04605,04,605,1046,515,5,510,339,171,0.49235181644359466,0.009708737864077669,0.9902912621359223,0.658252427184466,0.3320388349514563
04606,04,606,1281,667,29,638,434,204,0.5206869633099142,0.043478260869565216,0.9565217391304348,0.6506746626686657,0.3058470764617691
04607,04,607,1163,535,15,520,348,172,0.46001719690455717,0.028037383177570093,0.9719626168224299,0.6504672897196262,0.32149532710280376
04608,04,608,1241,555,6,549,387,162,0.44721998388396456,0.010810810810810811,0.9891891891891892,0.6972972972972973,0.2918918918918919
04609,04,609,1173,571,8,563,387,176,0.48678601875532823,0.014010507880910683,0.9859894921190894,0.6777583187390543,0.30823117338003503
04610,04,610,1124,549,18,531,341,190,0.4884341637010676,0.03278688524590164,0.9672131147540983,0.6211293260473588,0.3460837887067395
04611,04,611,1004,556,18,538,351,187,0.5537848605577689,0.03237410071942446,0.9676258992805755,0.6312949640287769,0.3363309352517986
04612,04,612,1383,723,21,702,469,233,0.5227765726681128,0.029045643153526972,0.970954356846473,0.648686030428769,0.32226832641770403
04613,04,613,1311,614,13,601,370,231,0.4683447749809306,0.021172638436482084,0.9788273615635179,0.6026058631921825,0.3762214983713355
04614,04,614,1135,603,13,590,372,218,0.5312775330396475,0.02155887230514096,0.978441127694859,0.6169154228855721,0.3615257048092869
04615,04,615,1131,603,5,598,410,188,0.53315649867374,0.008291873963515755,0.9917081260364843,0.6799336650082919,0.3117744610281924
04616,04,616,1025,489,9,480,275,205,0.4770731707317073,0.018404907975460124,0.9815950920245399,0.5623721881390593,0.41922290388548056
04617,04,617,1320,679,6,673,444,229,0.5143939393939394,0.008836524300441826,0.9911634756995582,0.6539027982326951,0.33726067746686306
04618,04,618,1179,603,13,590,368,222,0.5114503816793893,0.02155887230514096,0.978441127694859,0.6102819237147595,0.3681592039800995
04619,04,619,1137,563,6,557,333,224,0.4951627088830255,0.010657193605683837,0.9893428063943162,0.5914742451154529,0.3978685612788632
04620,04,620,1519,653,16,637,413,224,0.4298880842659645,0.02450229709035222,0.9754977029096478,0.6324655436447167,0.3430321592649311
04621,04,621,1536,827,12,815,497,318,0.5384114583333334,0.014510278113663845,0.9854897218863361,0.6009673518742442,0.3845223700120919
04622,04,622,1545,773,16,757,476,281,0.5003236245954693,0.02069857697283312,0.9793014230271668,0.6157826649417852,0.36351875808538164
04623,04,623,1088,571,14,557,344,213,0.5248161764705882,0.024518388791593695,0.9754816112084063,0.6024518388791593,0.37302977232924694
04624,04,624,1228,722,8,714,407,307,0.5879478827361564,0.0110803324099723,0.9889196675900277,0.5637119113573407,0.425207756232687
04625,04,625,1225,665,11,654,384,270,0.5428571428571428,0.016541353383458645,0.9834586466165414,0.5774436090225564,0.40601503759398494
04626,04,626,1388,749,15,734,480,254,0.5396253602305475,0.020026702269692925,0.9799732977303071,0.6408544726301736,0.3391188251001335
04701,04,701,1258,595,4,591,387,204,0.47297297297297297,0.0067226890756302525,0.9932773109243698,0.6504201680672269,0.34285714285714286
04702,04,702,1139,540,7,533,387,146,0.4741000877963126,0.012962962962962963,0.987037037037037,0.7166666666666667,0.27037037037037037
04703,04,703,1174,566,16,550,350,200,0.48211243611584326,0.028268551236749116,0.9717314487632509,0.6183745583038869,0.35335689045936397
04704,04,704,1420,703,9,694,489,205,0.4950704225352113,0.012802275960170697,0.9871977240398293,0.6955903271692745,0.29160739687055476
04705,04,705,1401,700,16,684,432,252,0.49964311206281226,0.022857142857142857,0.9771428571428571,0.6171428571428571,0.36
04706,04,706,1596,915,13,902,535,367,0.5733082706766918,0.014207650273224045,0.985792349726776,0.5846994535519126,0.4010928961748634
04707,04,707,1419,768,25,743,448,295,0.5412262156448203,0.032552083333333336,0.9674479166666666,0.5833333333333334,0.3841145833333333
04708,04,708,1348,735,22,713,481,232,0.5452522255192879,0.029931972789115645,0.9700680272108844,0.654421768707483,0.31564625850340133
04709,04,709,1449,691,18,673,470,203,0.47688060731538995,0.02604920405209841,0.9739507959479016,0.6801736613603473,0.2937771345875543
04710,04,710,1555,854,21,833,505,328,0.5491961414790997,0.02459016393442623,0.9754098360655737,0.5913348946135831,0.3840749414519906
04711,04,711,1438,666,12,654,406,248,0.4631432545201669,0.018018018018018018,0.9819819819819819,0.6096096096096096,0.37237237237237236
04712,04,712,1432,740,12,728,449,279,0.5167597765363129,0.016216216216216217,0.9837837837837838,0.6067567567567568,0.377027027027027
04713,04,713,1301,669,6,663,413,250,0.5142198308993082,0.008968609865470852,0.9910313901345291,0.617339312406577,0.37369207772795215
04714,04,714,1388,741,10,731,476,255,0.5338616714697406,0.01349527665317139,0.9865047233468286,0.6423751686909581,0.3441295546558704
04715,04,715,1652,802,6,796,532,264,0.4854721549636804,0.007481296758104738,0.9925187032418953,0.6633416458852868,0.32917705735660846
04716,04,716,1459,737,16,721,454,267,0.5051405071967101,0.021709633649932156,0.9782903663500678,0.6160108548168249,0.3622795115332429
04717,04,717,1505,822,14,808,428,380,0.5461794019933555,0.0170316301703163,0.9829683698296837,0.5206812652068127,0.46228710462287104
04718,04,718,1424,716,14,702,499,203,0.5028089887640449,0.019553072625698324,0.9804469273743017,0.696927374301676,0.2835195530726257
04719,04,719,1016,494,6,488,345,143,0.4862204724409449,0.012145748987854251,0.9878542510121457,0.6983805668016194,0.2894736842105263
04720,04,720,1248,547,5,542,380,162,0.43830128205128205,0.009140767824497258,0.9908592321755028,0.6946983546617916,0.2961608775137112
04721,04,721,1247,708,13,695,452,243,0.5677626303127506,0.018361581920903956,0.981638418079096,0.6384180790960452,0.3432203389830508
04722,04,722,919,452,13,439,307,132,0.49183895538628947,0.028761061946902654,0.9712389380530974,0.6792035398230089,0.2920353982300885
04723,04,723,1205,633,10,623,435,188,0.5253112033195021,0.01579778830963665,0.9842022116903634,0.6872037914691943,0.296998420221169
04724,04,724,1527,754,14,740,477,263,0.49377865094957435,0.01856763925729443,0.9814323607427056,0.6326259946949602,0.34880636604774534
04801,04,801,1352,617,10,607,386,221,0.45636094674556216,0.01620745542949757,0.9837925445705025,0.6256077795786061,0.3581847649918963
04802,04,802,1182,549,5,544,385,159,0.46446700507614214,0.009107468123861567,0.9908925318761385,0.7012750455373407,0.2896174863387978
04803,04,803,1169,601,21,580,415,165,0.514114627887083,0.03494176372712146,0.9650582362728786,0.6905158069883528,0.27454242928452577
04804,04,804,1607,790,13,777,509,268,0.4915992532669571,0.016455696202531647,0.9835443037974684,0.6443037974683544,0.3392405063291139
04805,04,805,1337,658,10,648,460,188,0.49214659685863876,0.015197568389057751,0.9848024316109423,0.6990881458966566,0.2857142857142857
04806,04,806,1312,560,7,553,351,202,0.4268292682926829,0.0125,0.9875,0.6267857142857143,0.3607142857142857
05101,05,101,855,311,4,307,159,148,0.36374269005847953,0.012861736334405145,0.9871382636655949,0.5112540192926045,0.4758842443729904
05102,05,102,921,452,4,448,275,173,0.49077090119435396,0.008849557522123894,0.9911504424778761,0.6084070796460177,0.3827433628318584
05103,05,103,1085,608,19,589,218,371,0.56036866359447,0.03125,0.96875,0.35855263157894735,0.6101973684210527
05104,05,104,934,474,6,468,271,197,0.5074946466809421,0.012658227848101266,0.9873417721518988,0.5717299578059072,0.41561181434599154
05105,05,105,1067,611,4,607,191,416,0.5726335520149953,0.006546644844517185,0.9934533551554828,0.31260229132569556,0.6808510638297872
05106,05,106,1133,528,7,521,159,362,0.46601941747572817,0.013257575757575758,0.9867424242424242,0.30113636363636365,0.6856060606060606
05107,05,107,898,463,4,459,258,201,0.5155902004454342,0.008639308855291577,0.9913606911447084,0.5572354211663066,0.43412526997840173
05108,05,108,1148,509,5,504,287,217,0.44337979094076657,0.009823182711198428,0.9901768172888016,0.5638506876227898,0.4263261296660118
05109,05,109,746,294,13,281,90,191,0.3941018766756032,0.04421768707482993,0.95578231292517,0.30612244897959184,0.6496598639455783
05110,05,110,922,466,2,464,217,247,0.5054229934924078,0.004291845493562232,0.9957081545064378,0.4656652360515021,0.5300429184549357
05111,05,111,1240,632,12,620,338,282,0.5096774193548387,0.0189873417721519,0.9810126582278481,0.5348101265822784,0.4462025316455696
05112,05,112,1055,529,4,525,248,277,0.5014218009478673,0.007561436672967864,0.9924385633270322,0.46880907372400754,0.5236294896030246
05113,05,113,1051,559,7,552,186,366,0.5318744053282588,0.012522361359570662,0.9874776386404294,0.33273703041144903,0.6547406082289803
05114,05,114,913,468,7,461,207,254,0.5125958378970427,0.014957264957264958,0.9850427350427351,0.4423076923076923,0.5427350427350427
05115,05,115,1064,584,11,573,289,284,0.5488721804511278,0.018835616438356163,0.9811643835616438,0.4948630136986301,0.4863013698630137
05116,05,116,822,421,0,421,197,224,0.5121654501216545,0.0,1.0,0.4679334916864608,0.5320665083135392
05117,05,117,979,496,2,494,286,208,0.5066394279877426,0.004032258064516129,0.9959677419354839,0.5766129032258065,0.41935483870967744
05118,05,118,1233,575,12,563,322,241,0.46634225466342255,0.020869565217391306,0.9791304347826087,0.56,0.4191304347826087
05119,05,119,1285,586,9,577,360,217,0.45603112840466925,0.015358361774744027,0.984641638225256,0.6143344709897611,0.3703071672354949
05120,05,120,1199,664,13,651,368,283,0.5537948290241869,0.01957831325301205,0.9804216867469879,0.5542168674698795,0.42620481927710846
05121,05,121,1087,623,5,618,359,259,0.5731370745170193,0.008025682182985553,0.9919743178170144,0.5762439807383628,0.4157303370786517
05122,05,122,993,428,1,427,250,177,0.4310171198388721,0.002336448598130841,0.9976635514018691,0.5841121495327103,0.4135514018691589
05123,05,123,860,430,2,428,212,216,0.5,0.004651162790697674,0.9953488372093023,0.4930232558139535,0.5023255813953489
05124,05,124,1364,702,7,695,349,346,0.5146627565982405,0.009971509971509971,0.99002849002849,0.49715099715099714,0.4928774928774929
05125,05,125,1001,487,4,483,278,205,0.4865134865134865,0.008213552361396304,0.9917864476386037,0.5708418891170431,0.4209445585215606
05126,05,126,1180,515,5,510,302,208,0.4364406779661017,0.009708737864077669,0.9902912621359223,0.5864077669902913,0.40388349514563104
05127,05,127,957,496,10,486,298,188,0.5182863113897597,0.020161290322580645,0.9798387096774194,0.6008064516129032,0.3790322580645161
05128,05,128,905,318,12,306,166,140,0.35138121546961326,0.03773584905660377,0.9622641509433962,0.5220125786163522,0.44025157232704404
05129,05,129,1017,537,12,525,293,232,0.528023598820059,0.0223463687150838,0.9776536312849162,0.5456238361266295,0.43202979515828677
05130,05,130,1064,533,7,526,284,242,0.5009398496240601,0.013133208255159476,0.9868667917448405,0.5328330206378987,0.4540337711069418
05131,05,131,1239,607,13,594,298,296,0.48991121872477805,0.0214168039538715,0.9785831960461285,0.49093904448105435,0.4876441515650741
05132,05,132,1324,550,10,540,268,272,0.41540785498489424,0.01818181818181818,0.9818181818181818,0.48727272727272725,0.49454545454545457
05201,05,201,1327,692,4,688,382,306,0.5214770158251696,0.005780346820809248,0.9942196531791907,0.5520231213872833,0.4421965317919075
05202,05,202,1482,779,11,768,404,364,0.5256410256410257,0.014120667522464698,0.9858793324775353,0.5186136071887034,0.4672657252888318
05203,05,203,1245,584,7,577,360,217,0.46907630522088356,0.011986301369863013,0.988013698630137,0.6164383561643836,0.3715753424657534
05204,05,204,958,445,5,440,298,142,0.46450939457202506,0.011235955056179775,0.9887640449438202,0.6696629213483146,0.31910112359550563
05205,05,205,1021,474,6,468,284,184,0.4642507345739471,0.012658227848101266,0.9873417721518988,0.5991561181434599,0.3881856540084388
05206,05,206,1371,648,4,644,396,248,0.4726477024070022,0.006172839506172839,0.9938271604938271,0.6111111111111112,0.38271604938271603
05207,05,207,1075,413,4,409,245,164,0.3841860465116279,0.009685230024213076,0.9903147699757869,0.5932203389830508,0.39709443099273606
05208,05,208,1134,546,13,533,290,243,0.48148148148148145,0.023809523809523808,0.9761904761904762,0.5311355311355311,0.44505494505494503
05209,05,209,1052,482,2,480,215,265,0.45817490494296575,0.004149377593360996,0.995850622406639,0.4460580912863071,0.549792531120332
05210,05,210,1220,544,7,537,308,229,0.4459016393442623,0.012867647058823529,0.9871323529411765,0.5661764705882353,0.4209558823529412
05211,05,211,1543,837,13,824,434,390,0.542449773169151,0.015531660692951015,0.984468339307049,0.5185185185185185,0.4659498207885305
05212,05,212,909,478,9,469,298,171,0.5258525852585259,0.01882845188284519,0.9811715481171548,0.6234309623430963,0.3577405857740586
05213,05,213,1033,603,0,603,218,385,0.5837366892545982,0.0,1.0,0.3615257048092869,0.6384742951907131
05214,05,214,808,343,11,332,195,137,0.4245049504950495,0.03206997084548105,0.967930029154519,0.5685131195335277,0.39941690962099125
05215,05,215,1601,673,12,661,389,272,0.4203622735790131,0.017830609212481426,0.9821693907875185,0.5780089153046062,0.40416047548291234
05216,05,216,1588,752,14,738,407,331,0.473551637279597,0.018617021276595744,0.9813829787234043,0.5412234042553191,0.4401595744680851
05217,05,217,881,458,10,448,291,157,0.5198637911464246,0.021834061135371178,0.9781659388646288,0.6353711790393013,0.34279475982532753
05218,05,218,1011,555,9,546,285,261,0.5489614243323442,0.016216216216216217,0.9837837837837838,0.5135135135135135,0.4702702702702703
05219,05,219,1250,659,3,656,355,301,0.5272,0.004552352048558422,0.9954476479514416,0.5386949924127465,0.456752655538695
05220,05,220,1061,473,10,463,311,152,0.4458058435438266,0.021141649048625793,0.9788583509513742,0.6575052854122622,0.321353065539112
05221,05,221,849,464,14,450,275,175,0.5465253239104829,0.03017241379310345,0.9698275862068966,0.5926724137931034,0.3771551724137931
05222,05,222,865,436,3,433,248,185,0.5040462427745664,0.006880733944954129,0.9931192660550459,0.5688073394495413,0.4243119266055046
05223,05,223,1125,566,6,560,342,218,0.5031111111111111,0.01060070671378092,0.9893992932862191,0.6042402826855123,0.38515901060070673
05224,05,224,958,415,5,410,247,163,0.4331941544885177,0.012048192771084338,0.9879518072289156,0.5951807228915663,0.3927710843373494
05225,05,225,999,491,8,483,233,250,0.4914914914914915,0.016293279022403257,0.9837067209775967,0.4745417515274949,0.5091649694501018
05226,05,226,906,530,4,526,393,133,0.5849889624724062,0.007547169811320755,0.9924528301886792,0.7415094339622641,0.2509433962264151
05227,05,227,1298,502,4,498,276,222,0.386748844375963,0.00796812749003984,0.9920318725099602,0.549800796812749,0.44223107569721115
05301,05,301,1015,498,10,488,300,188,0.49064039408866994,0.020080321285140562,0.9799196787148594,0.6024096385542169,0.37751004016064255
05302,05,302,929,451,11,440,332,108,0.48546824542518835,0.024390243902439025,0.975609756097561,0.7361419068736141,0.2394678492239468
05303,05,303,970,435,4,431,281,150,0.4484536082474227,0.009195402298850575,0.9908045977011494,0.6459770114942529,0.3448275862068966
05304,05,304,1556,822,11,811,175,636,0.5282776349614395,0.01338199513381995,0.98661800486618,0.21289537712895376,0.7737226277372263
05305,05,305,1044,614,4,610,367,243,0.5881226053639846,0.006514657980456026,0.993485342019544,0.5977198697068404,0.3957654723127036
05306,05,306,901,406,2,404,277,127,0.4506104328523862,0.0049261083743842365,0.9950738916256158,0.6822660098522167,0.312807881773399
05307,05,307,1345,631,12,619,352,267,0.4691449814126394,0.01901743264659271,0.9809825673534073,0.5578446909667195,0.4231378763866878
05308,05,308,1228,614,11,603,321,282,0.5,0.017915309446254073,0.9820846905537459,0.5228013029315961,0.4592833876221498
05309,05,309,1364,654,2,652,421,231,0.47947214076246336,0.0030581039755351682,0.9969418960244648,0.6437308868501529,0.3532110091743119
05310,05,310,1270,638,12,626,438,188,0.5023622047244094,0.018808777429467086,0.9811912225705329,0.6865203761755486,0.2946708463949843
05311,05,311,1201,621,5,616,417,199,0.5170691090757702,0.008051529790660225,0.9919484702093397,0.6714975845410628,0.32045088566827695
05312,05,312,970,480,9,471,323,148,0.4948453608247423,0.01875,0.98125,0.6729166666666667,0.30833333333333335
05313,05,313,1390,662,6,656,434,222,0.4762589928057554,0.00906344410876133,0.9909365558912386,0.6555891238670695,0.33534743202416917
05314,05,314,1225,633,5,628,412,216,0.516734693877551,0.007898894154818325,0.9921011058451816,0.65086887835703,0.3412322274881517
05315,05,315,1128,636,6,630,302,328,0.5638297872340425,0.009433962264150943,0.9905660377358491,0.4748427672955975,0.5157232704402516
05316,05,316,1365,673,9,664,452,212,0.49304029304029307,0.01337295690936107,0.986627043090639,0.6716196136701337,0.3150074294205052
05317,05,317,1121,567,6,561,342,219,0.5057983942908117,0.010582010582010581,0.9894179894179894,0.6031746031746031,0.3862433862433862
05318,05,318,1225,648,14,634,453,181,0.5289795918367347,0.021604938271604937,0.9783950617283951,0.6990740740740741,0.279320987654321
05319,05,319,670,351,14,337,252,85,0.5238805970149254,0.039886039886039885,0.9601139601139601,0.717948717948718,0.24216524216524216
05320,05,320,1016,505,3,502,329,173,0.4970472440944882,0.005940594059405941,0.994059405940594,0.6514851485148515,0.3425742574257426
05321,05,321,1169,561,11,550,371,179,0.4798973481608212,0.0196078431372549,0.9803921568627451,0.661319073083779,0.31907308377896615
05322,05,322,1161,588,15,573,392,181,0.5064599483204134,0.025510204081632654,0.9744897959183674,0.6666666666666666,0.3078231292517007
05323,05,323,909,416,3,413,256,157,0.45764576457645767,0.007211538461538462,0.9927884615384616,0.6153846153846154,0.37740384615384615
05324,05,324,887,479,3,476,326,150,0.5400225479143179,0.006263048016701462,0.9937369519832986,0.6805845511482255,0.31315240083507306
05325,05,325,1290,669,11,658,403,255,0.5186046511627908,0.016442451420029897,0.9835575485799701,0.6023916292974589,0.3811659192825112
05326,05,326,1096,470,11,459,313,146,0.42883211678832117,0.023404255319148935,0.9765957446808511,0.6659574468085107,0.31063829787234043
05327,05,327,1049,591,6,585,379,206,0.563393708293613,0.01015228426395939,0.9898477157360406,0.6412859560067682,0.34856175972927245
05328,05,328,1243,632,9,623,456,167,0.5084473049074819,0.014240506329113924,0.9857594936708861,0.7215189873417721,0.26424050632911394
05329,05,329,1020,472,6,466,342,124,0.4627450980392157,0.012711864406779662,0.9872881355932204,0.7245762711864406,0.2627118644067797
05401,05,401,1026,560,4,556,171,385,0.5458089668615984,0.007142857142857143,0.9928571428571429,0.3053571428571429,0.6875
05402,05,402,725,383,0,383,125,258,0.5282758620689655,0.0,1.0,0.3263707571801567,0.6736292428198434
05403,05,403,958,540,5,535,142,393,0.5636743215031316,0.009259259259259259,0.9907407407407407,0.26296296296296295,0.7277777777777777
05404,05,404,1027,627,6,621,330,291,0.6105160662122687,0.009569377990430622,0.9904306220095693,0.5263157894736842,0.46411483253588515
05405,05,405,1083,600,5,595,242,353,0.554016620498615,0.008333333333333333,0.9916666666666667,0.4033333333333333,0.5883333333333334
05406,05,406,1106,520,3,517,322,195,0.4701627486437613,0.0057692307692307696,0.9942307692307693,0.6192307692307693,0.375
05407,05,407,968,508,3,505,265,240,0.5247933884297521,0.005905511811023622,0.9940944881889764,0.5216535433070866,0.47244094488188976
05408,05,408,952,421,14,407,279,128,0.4422268907563025,0.0332541567695962,0.9667458432304038,0.66270783847981,0.30403800475059384
05409,05,409,1133,639,8,631,384,247,0.5639894086496028,0.012519561815336464,0.9874804381846636,0.6009389671361502,0.3865414710485133
05410,05,410,1442,682,7,675,342,333,0.47295423023578365,0.010263929618768328,0.9897360703812317,0.501466275659824,0.48826979472140764
05411,05,411,1055,590,8,582,403,179,0.5592417061611374,0.013559322033898305,0.9864406779661017,0.6830508474576271,0.30338983050847457
05412,05,412,1399,717,10,707,479,228,0.5125089349535382,0.01394700139470014,0.9860529986052998,0.6680613668061367,0.3179916317991632
05413,05,413,1528,765,20,745,422,323,0.5006544502617801,0.026143790849673203,0.9738562091503268,0.5516339869281046,0.4222222222222222
05414,05,414,860,443,5,438,312,126,0.5151162790697674,0.011286681715575621,0.9887133182844243,0.7042889390519187,0.28442437923250563
05415,05,415,1411,628,9,619,441,178,0.445074415308292,0.014331210191082803,0.9856687898089171,0.7022292993630573,0.28343949044585987
05416,05,416,1247,596,4,592,137,455,0.47794707297514033,0.006711409395973154,0.9932885906040269,0.22986577181208054,0.7634228187919463
05417,05,417,1372,766,7,759,410,349,0.5583090379008746,0.009138381201044387,0.9908616187989556,0.5352480417754569,0.4556135770234987
05418,05,418,805,324,7,317,182,135,0.40248447204968946,0.021604938271604937,0.9783950617283951,0.5617283950617284,0.4166666666666667
05419,05,419,1096,618,8,610,161,449,0.5638686131386861,0.012944983818770227,0.9870550161812298,0.2605177993527508,0.7265372168284789
05420,05,420,1122,559,4,555,111,444,0.4982174688057041,0.007155635062611807,0.9928443649373881,0.19856887298747763,0.7942754919499105
05421,05,421,1300,601,10,591,427,164,0.4623076923076923,0.016638935108153077,0.9833610648918469,0.7104825291181365,0.27287853577371046
05422,05,422,1035,471,8,463,343,120,0.45507246376811594,0.016985138004246284,0.9830148619957537,0.7282377919320594,0.25477707006369427
05423,05,423,897,467,3,464,197,267,0.5206243032329989,0.006423982869379015,0.9935760171306209,0.42184154175588867,0.5717344753747323
05424,05,424,1387,685,16,669,311,358,0.4938716654650324,0.02335766423357664,0.9766423357664233,0.454014598540146,0.5226277372262774
05425,05,425,1420,799,8,791,416,375,0.5626760563380282,0.010012515644555695,0.9899874843554443,0.5206508135168961,0.4693366708385482
05426,05,426,1117,703,5,698,427,271,0.6293643688451208,0.007112375533428165,0.9928876244665719,0.6073968705547653,0.38549075391180654
05427,05,427,888,421,7,414,283,131,0.4740990990990991,0.0166270783847981,0.9833729216152018,0.672209026128266,0.31116389548693585
05428,05,428,1117,641,10,631,245,386,0.5738585496866607,0.015600624024960999,0.984399375975039,0.38221528861154447,0.6021840873634945
05429,05,429,945,528,6,522,234,288,0.5587301587301587,0.011363636363636364,0.9886363636363636,0.4431818181818182,0.5454545454545454
05501,05,501,1130,545,17,528,359,169,0.4823008849557522,0.031192660550458717,0.9688073394495413,0.6587155963302752,0.3100917431192661
05502,05,502,1216,653,13,640,431,209,0.5370065789473685,0.019908116385911178,0.9800918836140888,0.6600306278713629,0.32006125574272587
05503,05,503,837,454,11,443,266,177,0.5424133811230586,0.024229074889867842,0.9757709251101322,0.5859030837004405,0.3898678414096916
05504,05,504,958,526,10,516,329,187,0.5490605427974948,0.019011406844106463,0.9809885931558935,0.6254752851711026,0.35551330798479086
05505,05,505,1127,452,16,436,275,161,0.4010647737355812,0.035398230088495575,0.9646017699115044,0.6084070796460177,0.3561946902654867
05506,05,506,1137,642,14,628,378,250,0.5646437994722955,0.021806853582554516,0.9781931464174455,0.5887850467289719,0.3894080996884735
05507,05,507,1007,576,8,568,368,200,0.5719960278053625,0.013888888888888888,0.9861111111111112,0.6388888888888888,0.3472222222222222
05508,05,508,941,508,10,498,328,170,0.5398512221041445,0.01968503937007874,0.9803149606299213,0.6456692913385826,0.3346456692913386
05509,05,509,1142,596,10,586,402,184,0.521891418563923,0.016778523489932886,0.9832214765100671,0.674496644295302,0.3087248322147651
05510,05,510,985,585,4,581,408,173,0.5939086294416244,0.006837606837606838,0.9931623931623932,0.6974358974358974,0.29572649572649573
05511,05,511,948,505,10,495,332,163,0.5327004219409283,0.019801980198019802,0.9801980198019802,0.6574257425742575,0.3227722772277228
05512,05,512,923,494,13,481,314,167,0.5352112676056338,0.02631578947368421,0.9736842105263158,0.6356275303643725,0.33805668016194335
05513,05,513,1421,924,9,915,620,295,0.6502463054187192,0.00974025974025974,0.9902597402597403,0.670995670995671,0.31926406926406925
05514,05,514,1140,479,13,466,346,120,0.4201754385964912,0.027139874739039668,0.9728601252609603,0.7223382045929019,0.25052192066805845
05515,05,515,1116,549,15,534,352,182,0.49193548387096775,0.0273224043715847,0.9726775956284153,0.6411657559198543,0.331511839708561
05516,05,516,1204,643,7,636,454,182,0.5340531561461794,0.01088646967340591,0.9891135303265941,0.7060653188180405,0.28304821150855364
05517,05,517,1071,554,14,540,393,147,0.5172735760971056,0.02527075812274368,0.9747292418772563,0.7093862815884476,0.26534296028880866
05518,05,518,927,508,6,502,345,157,0.5480043149946062,0.011811023622047244,0.9881889763779528,0.6791338582677166,0.3090551181102362
05519,05,519,1065,506,5,501,330,171,0.4751173708920188,0.009881422924901186,0.9901185770750988,0.6521739130434783,0.33794466403162055
05520,05,520,1252,580,17,563,412,151,0.46325878594249204,0.029310344827586206,0.9706896551724138,0.7103448275862069,0.2603448275862069
05521,05,521,1274,558,9,549,394,155,0.4379905808477237,0.016129032258064516,0.9838709677419355,0.7060931899641577,0.2777777777777778
05522,05,522,1023,537,7,530,333,197,0.5249266862170088,0.01303538175046555,0.9869646182495344,0.6201117318435754,0.36685288640595903
05523,05,523,1508,921,11,910,632,278,0.6107427055702918,0.011943539630836048,0.988056460369164,0.6862106406080347,0.30184581976112923
05524,05,524,1030,579,5,574,355,219,0.5621359223300971,0.008635578583765112,0.9913644214162349,0.613126079447323,0.37823834196891193
05525,05,525,825,429,14,415,250,165,0.52,0.03263403263403263,0.9673659673659674,0.5827505827505828,0.38461538461538464
05526,05,526,1212,645,11,634,429,205,0.5321782178217822,0.017054263565891473,0.9829457364341085,0.6651162790697674,0.3178294573643411
05527,05,527,1513,555,27,528,375,153,0.3668208856576338,0.04864864864864865,0.9513513513513514,0.6756756756756757,0.2756756756756757
05528,05,528,908,491,6,485,336,149,0.5407488986784141,0.012219959266802444,0.9877800407331976,0.6843177189409368,0.3034623217922607
05529,05,529,900,469,4,465,323,142,0.5211111111111111,0.008528784648187633,0.9914712153518124,0.6886993603411514,0.302771855010661
05530,05,530,1057,561,12,549,372,177,0.5307473982970672,0.0213903743315508,0.9786096256684492,0.6631016042780749,0.3155080213903743
06101,06,101,1857,867,13,854,536,318,0.4668820678513732,0.014994232987312572,0.9850057670126874,0.6182237600922722,0.36678200692041524
06102,06,102,1752,851,18,833,502,331,0.4857305936073059,0.021151586368977675,0.9788484136310224,0.5898942420681551,0.3889541715628672
06103,06,103,1800,934,18,916,582,334,0.5188888888888888,0.019271948608137045,0.9807280513918629,0.6231263383297645,0.3576017130620985
06104,06,104,1991,1045,26,1019,573,446,0.5248618784530387,0.024880382775119617,0.9751196172248804,0.5483253588516747,0.4267942583732057
06105,06,105,1589,813,15,798,550,248,0.5116425424795469,0.01845018450184502,0.981549815498155,0.6765067650676507,0.3050430504305043
06106,06,106,1675,771,10,761,449,312,0.4602985074626866,0.01297016861219196,0.9870298313878081,0.582360570687419,0.4046692607003891
06107,06,107,1848,992,21,971,616,355,0.5367965367965368,0.021169354838709676,0.9788306451612904,0.6209677419354839,0.35786290322580644
06108,06,108,1960,906,7,899,542,357,0.46224489795918366,0.00772626931567329,0.9922737306843267,0.5982339955849889,0.39403973509933776
06109,06,109,1943,940,19,921,531,390,0.4837879567678847,0.02021276595744681,0.9797872340425532,0.5648936170212766,0.4148936170212766
06110,06,110,1808,873,26,847,545,302,0.48285398230088494,0.029782359679266894,0.9702176403207331,0.6242840778923253,0.3459335624284078
06111,06,111,1888,939,23,916,598,318,0.4973516949152542,0.024494142705005325,0.9755058572949947,0.6368477103301384,0.33865814696485624
06112,06,112,1619,858,21,837,508,329,0.5299567634342186,0.024475524475524476,0.9755244755244755,0.5920745920745921,0.38344988344988346
06113,06,113,1825,798,11,787,516,271,0.43726027397260275,0.013784461152882205,0.9862155388471178,0.6466165413533834,0.33959899749373434
06114,06,114,1835,867,19,848,545,303,0.47247956403269753,0.02191464821222607,0.9780853517877739,0.6286043829296425,0.3494809688581315
06115,06,115,1536,766,18,748,458,290,0.4986979166666667,0.02349869451697128,0.9765013054830287,0.597911227154047,0.3785900783289817
06116,06,116,1969,964,13,951,551,400,0.489588623666836,0.013485477178423237,0.9865145228215768,0.5715767634854771,0.4149377593360996
06117,06,117,1723,803,13,790,526,264,0.4660475914103308,0.0161892901618929,0.9838107098381071,0.6550435865504358,0.3287671232876712
06118,06,118,1765,840,21,819,512,307,0.47592067988668557,0.025,0.975,0.6095238095238096,0.36547619047619045
06201,06,201,1906,1027,32,995,581,414,0.5388247639034628,0.0311587147030185,0.9688412852969815,0.5657254138266796,0.40311587147030187
06202,06,202,1712,876,19,857,541,316,0.5116822429906542,0.021689497716894976,0.978310502283105,0.617579908675799,0.3607305936073059
06203,06,203,1919,928,25,903,577,326,0.4835852006253257,0.02693965517241379,0.9730603448275862,0.6217672413793104,0.35129310344827586
06204,06,204,1663,890,18,872,524,348,0.5351773902585688,0.020224719101123594,0.9797752808988764,0.5887640449438202,0.39101123595505616
06205,06,205,1704,755,18,737,459,278,0.443075117370892,0.02384105960264901,0.976158940397351,0.6079470198675496,0.36821192052980134
06206,06,206,1612,698,13,685,451,234,0.43300248138957814,0.01862464183381089,0.9813753581661891,0.6461318051575932,0.335243553008596
06207,06,207,1535,738,12,726,424,302,0.48078175895765474,0.016260162601626018,0.983739837398374,0.5745257452574526,0.4092140921409214
06208,06,208,1557,808,11,797,562,235,0.518946692357097,0.013613861386138614,0.9863861386138614,0.6955445544554455,0.2908415841584158
06209,06,209,1867,821,14,807,528,279,0.43974290305302627,0.01705237515225335,0.9829476248477467,0.6431181485992692,0.3398294762484775
06210,06,210,1716,764,18,746,459,287,0.44522144522144524,0.02356020942408377,0.9764397905759162,0.6007853403141361,0.3756544502617801
06211,06,211,1687,731,13,718,464,254,0.4333135743924126,0.017783857729138167,0.9822161422708618,0.6347469220246238,0.34746922024623805
06212,06,212,1881,837,18,819,546,273,0.4449760765550239,0.021505376344086023,0.978494623655914,0.6523297491039427,0.32616487455197135
06213,06,213,2074,1031,27,1004,633,371,0.4971070395371263,0.026188166828322017,0.973811833171678,0.6139670223084384,0.35984481086323955
06214,06,214,1940,1008,20,988,606,382,0.5195876288659794,0.01984126984126984,0.9801587301587301,0.6011904761904762,0.37896825396825395
06215,06,215,1718,904,17,887,586,301,0.5261932479627474,0.018805309734513276,0.9811946902654868,0.6482300884955752,0.3329646017699115
06216,06,216,1639,819,17,802,508,294,0.4996949359365467,0.020757020757020756,0.9792429792429792,0.6202686202686203,0.358974358974359
06217,06,217,1944,1077,16,1061,674,387,0.5540123456790124,0.014856081708449397,0.9851439182915506,0.6258124419684308,0.3593314763231198
06218,06,218,1634,658,10,648,447,201,0.40269277845777235,0.015197568389057751,0.9848024316109423,0.6793313069908815,0.30547112462006076
06301,06,301,1886,939,17,922,548,374,0.49787910922587486,0.01810436634717785,0.9818956336528222,0.5835995740149095,0.39829605963791265
06302,06,302,1748,828,18,810,481,329,0.47368421052631576,0.021739130434782608,0.9782608695652174,0.5809178743961353,0.3973429951690821
06303,06,303,1829,968,15,953,609,344,0.5292509568069984,0.015495867768595042,0.984504132231405,0.6291322314049587,0.35537190082644626
06304,06,304,1841,957,17,940,552,388,0.5198261814231396,0.017763845350052248,0.9822361546499477,0.5768025078369906,0.4054336468129572
06305,06,305,1616,810,16,794,462,332,0.5012376237623762,0.019753086419753086,0.980246913580247,0.5703703703703704,0.40987654320987654
06306,06,306,1973,889,15,874,555,319,0.45058286872782566,0.01687289088863892,0.983127109111361,0.6242969628796401,0.35883014623172105
06307,06,307,1729,762,19,743,482,261,0.4407171775592828,0.024934383202099737,0.9750656167979003,0.6325459317585301,0.3425196850393701
06308,06,308,1743,864,16,848,557,291,0.49569707401032703,0.018518518518518517,0.9814814814814815,0.6446759259259259,0.3368055555555556
06309,06,309,1828,865,22,843,532,311,0.47319474835886216,0.025433526011560695,0.9745664739884393,0.6150289017341041,0.35953757225433525
06310,06,310,1768,914,9,905,543,362,0.5169683257918553,0.009846827133479213,0.9901531728665208,0.5940919037199125,0.39606126914660833
06311,06,311,1749,887,10,877,582,295,0.5071469411092052,0.011273957158962795,0.9887260428410372,0.6561443066516347,0.33258173618940245
06312,06,312,1810,917,19,898,578,320,0.5066298342541437,0.020719738276990186,0.9792802617230099,0.6303162486368593,0.3489640130861505
06313,06,313,1788,879,17,862,581,281,0.49161073825503354,0.019340159271899887,0.9806598407281001,0.6609783845278726,0.31968145620022753
06314,06,314,2729,1424,18,1406,966,440,0.5218028581898131,0.012640449438202247,0.9873595505617978,0.6783707865168539,0.3089887640449438
06315,06,315,1658,795,16,779,539,240,0.4794933655006031,0.02012578616352201,0.979874213836478,0.6779874213836478,0.3018867924528302
06316,06,316,1935,972,23,949,647,302,0.5023255813953489,0.023662551440329218,0.9763374485596708,0.6656378600823045,0.31069958847736623
06317,06,317,1936,858,17,841,600,241,0.4431818181818182,0.019813519813519812,0.9801864801864801,0.6993006993006993,0.28088578088578087
06318,06,318,2032,898,34,864,609,255,0.4419291338582677,0.0378619153674833,0.9621380846325167,0.678173719376392,0.28396436525612473
06401,06,401,1895,994,23,971,649,322,0.5245382585751979,0.023138832997987926,0.9768611670020121,0.6529175050301811,0.323943661971831
06402,06,402,1661,801,20,781,538,243,0.4822396146899458,0.024968789013732832,0.9750312109862672,0.6716604244694132,0.30337078651685395
06403,06,403,1628,729,16,713,468,245,0.4477886977886978,0.02194787379972565,0.9780521262002744,0.6419753086419753,0.33607681755829905
06404,06,404,1982,1029,16,1013,664,349,0.5191725529767911,0.015549076773566569,0.9844509232264335,0.6452866861030127,0.3391642371234208
06405,06,405,1780,940,17,923,599,324,0.5280898876404494,0.018085106382978722,0.9819148936170212,0.6372340425531915,0.3446808510638298
06406,06,406,1938,941,34,907,598,309,0.4855521155830753,0.036131774707757705,0.9638682252922423,0.6354941551540914,0.3283740701381509
06407,06,407,1946,926,20,906,614,292,0.47584789311408016,0.02159827213822894,0.978401727861771,0.6630669546436285,0.31533477321814257
06408,06,408,1814,864,19,845,546,299,0.4762954796030871,0.02199074074074074,0.9780092592592593,0.6319444444444444,0.3460648148148148
06409,06,409,1776,834,16,818,593,225,0.46959459459459457,0.019184652278177457,0.9808153477218226,0.7110311750599521,0.2697841726618705
06410,06,410,1638,864,23,841,583,258,0.5274725274725275,0.02662037037037037,0.9733796296296297,0.6747685185185185,0.2986111111111111
06411,06,411,1695,877,11,866,612,254,0.5174041297935104,0.012542759407069556,0.9874572405929305,0.6978335233751425,0.2896237172177879
06412,06,412,1473,805,16,789,562,227,0.5465037338764427,0.01987577639751553,0.9801242236024845,0.698136645962733,0.2819875776397516
06413,06,413,1749,787,21,766,528,238,0.4499714122355632,0.026683608640406607,0.9733163913595934,0.6709021601016518,0.30241423125794153
06414,06,414,1596,720,26,694,507,187,0.45112781954887216,0.03611111111111111,0.9638888888888889,0.7041666666666667,0.25972222222222224
06415,06,415,1578,727,14,713,493,220,0.46070975918884666,0.01925722145804677,0.9807427785419532,0.6781292984869326,0.30261348005502064
06416,06,416,1773,777,9,768,517,251,0.43824027072758037,0.011583011583011582,0.9884169884169884,0.6653796653796654,0.323037323037323
06417,06,417,1676,859,18,841,584,257,0.5125298329355609,0.020954598370197905,0.9790454016298021,0.6798603026775321,0.2991850989522701
06501,06,501,1779,788,18,770,501,269,0.44294547498594716,0.02284263959390863,0.9771573604060914,0.6357868020304569,0.3413705583756345
06502,06,502,1639,860,25,835,581,254,0.5247101891397193,0.029069767441860465,0.9709302325581395,0.6755813953488372,0.29534883720930233
06503,06,503,1385,663,9,654,418,236,0.4787003610108303,0.013574660633484163,0.9864253393665159,0.6304675716440422,0.3559577677224736
06504,06,504,1489,755,23,732,499,233,0.5070517125587642,0.030463576158940398,0.9695364238410596,0.6609271523178808,0.3086092715231788
06505,06,505,1838,953,25,928,580,348,0.5184983677910773,0.026232948583420776,0.9737670514165793,0.608604407135362,0.3651626442812172
06506,06,506,1676,725,12,713,501,212,0.43257756563245825,0.016551724137931035,0.983448275862069,0.6910344827586207,0.2924137931034483
06507,06,507,1686,863,17,846,602,244,0.5118623962040332,0.019698725376593278,0.9803012746234068,0.697566628041715,0.2827346465816918
06508,06,508,1839,867,23,844,617,227,0.47145187601957583,0.0265282583621684,0.9734717416378316,0.7116493656286044,0.2618223760092272
06509,06,509,1733,849,20,829,632,197,0.4899019042123485,0.023557126030624265,0.9764428739693758,0.7444051825677267,0.232037691401649
06510,06,510,1946,1071,24,1047,733,314,0.5503597122302158,0.022408963585434174,0.9775910364145658,0.6844070961718021,0.2931839402427638
06511,06,511,1561,726,11,715,468,247,0.46508648302370276,0.015151515151515152,0.9848484848484849,0.6446280991735537,0.3402203856749311
06512,06,512,1518,715,17,698,463,235,0.47101449275362317,0.023776223776223775,0.9762237762237762,0.6475524475524476,0.32867132867132864
06513,06,513,1998,1018,8,1010,746,264,0.5095095095095095,0.007858546168958742,0.9921414538310412,0.7328094302554028,0.2593320235756385
06514,06,514,1834,966,17,949,625,324,0.5267175572519084,0.017598343685300208,0.9824016563146998,0.6469979296066253,0.33540372670807456
06515,06,515,1580,816,12,804,512,292,0.5164556962025316,0.014705882352941176,0.9852941176470589,0.6274509803921569,0.35784313725490197
06516,06,516,1778,769,19,750,535,215,0.43250843644544434,0.0247074122236671,0.9752925877763329,0.6957087126137841,0.2795838751625488
06517,06,517,1694,661,10,651,472,179,0.3902007083825266,0.015128593040847202,0.9848714069591528,0.7140695915279879,0.2708018154311649
06518,06,518,1686,768,20,748,543,205,0.4555160142348754,0.026041666666666668,0.9739583333333334,0.70703125,0.2669270833333333
06601,06,601,1335,635,8,627,373,254,0.4756554307116105,0.012598425196850394,0.9874015748031496,0.5874015748031496,0.4
06602,06,602,1530,800,9,791,521,270,0.5228758169934641,0.01125,0.98875,0.65125,0.3375
06603,06,603,1506,741,16,725,457,268,0.49203187250996017,0.021592442645074223,0.9784075573549258,0.6167341430499326,0.3616734143049933
06604,06,604,1822,901,13,888,465,423,0.49451152579582874,0.014428412874583796,0.9855715871254163,0.516093229744728,0.4694783573806881
06605,06,605,1664,922,8,914,608,306,0.5540865384615384,0.008676789587852495,0.9913232104121475,0.6594360086767896,0.3318872017353579
06606,06,606,1231,538,3,535,411,124,0.4370430544272949,0.0055762081784386614,0.9944237918215614,0.7639405204460966,0.23048327137546468
06607,06,607,1475,669,4,665,451,214,0.4535593220338983,0.005979073243647235,0.9940209267563528,0.6741405082212257,0.31988041853512705
06608,06,608,2022,1037,19,1018,714,304,0.5128585558852621,0.01832208293153327,0.9816779170684667,0.6885245901639344,0.29315332690453233
06609,06,609,1755,889,18,871,522,349,0.5065527065527066,0.020247469066366704,0.9797525309336333,0.5871766029246345,0.3925759280089989
06610,06,610,1155,539,7,532,392,140,0.4666666666666667,0.012987012987012988,0.987012987012987,0.7272727272727273,0.2597402597402597
06611,06,611,1530,761,15,746,478,268,0.4973856209150327,0.01971090670170828,0.9802890932982917,0.6281208935611038,0.35216819973718794
06612,06,612,1840,906,16,890,577,313,0.4923913043478261,0.017660044150110375,0.9823399558498896,0.6368653421633554,0.3454746136865342
06613,06,613,1751,832,14,818,453,365,0.47515705311250717,0.016826923076923076,0.9831730769230769,0.5444711538461539,0.4387019230769231
06614,06,614,1916,902,22,880,553,327,0.4707724425887265,0.024390243902439025,0.975609756097561,0.6130820399113082,0.3625277161862528
06615,06,615,1746,783,16,767,523,244,0.4484536082474227,0.020434227330779056,0.979565772669221,0.6679438058748404,0.3116219667943806
06616,06,616,1962,1052,23,1029,687,342,0.5361875637104995,0.021863117870722433,0.9781368821292775,0.653041825095057,0.32509505703422054
06617,06,617,1775,978,22,956,677,279,0.5509859154929577,0.022494887525562373,0.9775051124744376,0.6922290388548057,0.2852760736196319
06618,06,618,1749,818,16,802,509,293,0.4676958261863922,0.019559902200488997,0.980440097799511,0.6222493887530562,0.3581907090464548
06619,06,619,1459,754,39,715,449,266,0.5167923235092529,0.05172413793103448,0.9482758620689655,0.5954907161803713,0.35278514588859416
06701,06,701,1638,863,14,849,577,272,0.5268620268620269,0.016222479721900347,0.9837775202780996,0.6685979142526072,0.31517960602549244
06702,06,702,1992,993,12,981,671,310,0.49849397590361444,0.012084592145015106,0.9879154078549849,0.675730110775428,0.3121852970795569
06703,06,703,1422,666,4,662,449,213,0.46835443037974683,0.006006006006006006,0.993993993993994,0.6741741741741741,0.31981981981981983
06704,06,704,1447,684,16,668,473,195,0.4727021423635107,0.023391812865497075,0.9766081871345029,0.6915204678362573,0.2850877192982456
06705,06,705,1442,592,4,588,393,195,0.4105409153952843,0.006756756756756757,0.9932432432432432,0.6638513513513513,0.3293918918918919
06706,06,706,1819,931,15,916,617,299,0.5118196811434854,0.01611170784103115,0.9838882921589689,0.6627282491944146,0.32116004296455425
06707,06,707,1753,793,6,787,540,247,0.45236737022247575,0.007566204287515763,0.9924337957124842,0.6809583858764187,0.3114754098360656
06708,06,708,1331,661,18,643,415,228,0.4966190833959429,0.02723146747352496,0.972768532526475,0.6278366111951589,0.34493192133131617
06709,06,709,1752,843,17,826,578,248,0.4811643835616438,0.020166073546856466,0.9798339264531435,0.6856465005931198,0.2941874258600237
06710,06,710,1728,820,23,797,568,229,0.47453703703703703,0.02804878048780488,0.9719512195121951,0.6926829268292682,0.27926829268292686
06711,06,711,1714,861,16,845,538,307,0.5023337222870479,0.018583042973286876,0.9814169570267132,0.6248548199767712,0.35656213704994194
06712,06,712,1611,911,13,898,547,351,0.5654872749844817,0.014270032930845226,0.9857299670691547,0.6004390779363337,0.38529088913282106
06713,06,713,1586,773,12,761,520,241,0.48738965952080704,0.015523932729624839,0.9844760672703752,0.6727037516170763,0.3117723156532988
06714,06,714,1306,602,8,594,382,212,0.4609494640122512,0.013289036544850499,0.9867109634551495,0.6345514950166113,0.3521594684385382
06715,06,715,1480,708,10,698,464,234,0.4783783783783784,0.014124293785310734,0.9858757062146892,0.655367231638418,0.3305084745762712
06716,06,716,1360,620,5,615,416,199,0.45588235294117646,0.008064516129032258,0.9919354838709677,0.6709677419354839,0.3209677419354839
06717,06,717,1166,613,15,598,397,201,0.5257289879931389,0.024469820554649267,0.9755301794453507,0.6476345840130505,0.3278955954323002
06718,06,718,1842,948,23,925,645,280,0.5146579804560261,0.024261603375527425,0.9757383966244726,0.680379746835443,0.29535864978902954
06719,06,719,1686,832,23,809,502,307,0.49347568208778175,0.027644230769230768,0.9723557692307693,0.6033653846153846,0.36899038461538464
07101,07,101,1816,728,19,709,546,163,0.4008810572687225,0.0260989010989011,0.9739010989010989,0.75,0.2239010989010989
07102,07,102,1988,868,13,855,583,272,0.43661971830985913,0.014976958525345621,0.9850230414746544,0.6716589861751152,0.31336405529953915
07103,07,103,1891,912,23,889,568,321,0.48228450555261765,0.025219298245614034,0.9747807017543859,0.6228070175438597,0.3519736842105263
07104,07,104,1849,887,31,856,489,367,0.4797187669010276,0.03494926719278467,0.9650507328072153,0.5512965050732808,0.4137542277339346
07105,07,105,1914,852,14,838,554,284,0.445141065830721,0.01643192488262911,0.9835680751173709,0.6502347417840375,0.3333333333333333
07106,07,106,1713,820,16,804,485,319,0.47869235259778165,0.01951219512195122,0.9804878048780488,0.5914634146341463,0.38902439024390245
07107,07,107,1697,818,19,799,418,381,0.48202710665880966,0.023227383863080684,0.9767726161369193,0.511002444987775,0.46577017114914426
07108,07,108,1816,859,12,847,507,340,0.47301762114537443,0.013969732246798603,0.9860302677532014,0.590221187427241,0.3958090803259604
07109,07,109,1893,876,18,858,500,358,0.46275752773375595,0.02054794520547945,0.9794520547945206,0.5707762557077626,0.408675799086758
07110,07,110,2051,1048,19,1029,657,372,0.5109702584105315,0.01812977099236641,0.9818702290076335,0.6269083969465649,0.3549618320610687
07111,07,111,1771,931,31,900,525,375,0.525691699604743,0.03329752953813104,0.966702470461869,0.5639097744360902,0.4027926960257787
07112,07,112,2061,1057,30,1027,513,514,0.5128578360019408,0.02838221381267739,0.9716177861873226,0.4853358561967833,0.48628192999053926
07113,07,113,1955,1009,17,992,532,460,0.5161125319693095,0.01684836471754212,0.9831516352824579,0.5272547076313181,0.45589692765113976
07114,07,114,1792,896,23,873,460,413,0.5,0.025669642857142856,0.9743303571428571,0.5133928571428571,0.4609375
07115,07,115,1738,826,24,802,370,432,0.475258918296893,0.029055690072639227,0.9709443099273608,0.44794188861985473,0.5230024213075061
07116,07,116,1976,881,13,868,546,322,0.4458502024291498,0.014755959137343927,0.985244040862656,0.619750283768445,0.3654937570942111
07117,07,117,1935,931,28,903,539,364,0.4811369509043928,0.03007518796992481,0.9699248120300752,0.5789473684210527,0.39097744360902253
07118,07,118,1942,951,27,924,450,474,0.4897013388259526,0.028391167192429023,0.9716088328075709,0.47318611987381703,0.49842271293375395
07201,07,201,1899,983,18,965,539,426,0.5176408636124276,0.018311291963377416,0.9816887080366226,0.5483214649033571,0.4333672431332655
07202,07,202,1950,953,26,927,544,383,0.4887179487179487,0.02728226652675761,0.9727177334732424,0.5708289611752361,0.4018887722980063
07203,07,203,2016,1087,23,1064,537,527,0.5391865079365079,0.021159153633854646,0.9788408463661453,0.49402023919043236,0.48482060717571296
07204,07,204,2004,879,19,860,437,423,0.43862275449101795,0.02161547212741752,0.9783845278725825,0.49715585893060293,0.4812286689419795
07205,07,205,1782,919,17,902,448,454,0.5157126823793491,0.018498367791077257,0.9815016322089227,0.48748639825897716,0.4940152339499456
07206,07,206,2217,1041,18,1023,524,499,0.469553450608931,0.01729106628242075,0.9827089337175793,0.5033621517771374,0.4793467819404419
07207,07,207,2263,1114,25,1089,506,583,0.49226690234202386,0.02244165170556553,0.9775583482944344,0.4542190305206463,0.5233393177737882
07208,07,208,1934,892,10,882,513,369,0.4612202688728025,0.011210762331838564,0.9887892376681614,0.5751121076233184,0.413677130044843
07209,07,209,1751,819,12,807,499,308,0.46773272415762424,0.014652014652014652,0.9853479853479854,0.6092796092796092,0.37606837606837606
07210,07,210,2052,1089,30,1059,531,528,0.5307017543859649,0.027548209366391185,0.9724517906336089,0.48760330578512395,0.48484848484848486
07211,07,211,1999,948,37,911,475,436,0.47423711855927964,0.039029535864978905,0.9609704641350211,0.5010548523206751,0.459915611814346
07212,07,212,1423,779,18,761,296,465,0.5474349964862966,0.023106546854942234,0.9768934531450578,0.37997432605905007,0.5969191270860077
07213,07,213,1675,818,20,798,338,460,0.48835820895522386,0.02444987775061125,0.9755501222493888,0.4132029339853301,0.5623471882640587
07214,07,214,1775,834,19,815,371,444,0.46985915492957747,0.022781774580335732,0.9772182254196643,0.4448441247002398,0.5323741007194245
07215,07,215,2040,932,30,902,510,392,0.4568627450980392,0.032188841201716736,0.9678111587982833,0.5472103004291845,0.4206008583690987
07216,07,216,2048,953,16,937,608,329,0.46533203125,0.016789087093389297,0.9832109129066107,0.6379853095487933,0.34522560335781743
07217,07,217,1577,717,21,696,452,244,0.45466074825618263,0.029288702928870293,0.9707112970711297,0.6304044630404463,0.3403068340306834
07301,07,301,1998,943,13,930,493,437,0.471971971971972,0.013785790031813362,0.9862142099681867,0.5227995758218452,0.4634146341463415
07302,07,302,1824,1041,16,1025,532,493,0.5707236842105263,0.01536983669548511,0.9846301633045149,0.5110470701248799,0.473583093179635
07303,07,303,1688,851,16,835,425,410,0.5041469194312796,0.01880141010575793,0.981198589894242,0.4994124559341951,0.481786133960047
07304,07,304,1464,720,10,710,385,325,0.4918032786885246,0.013888888888888888,0.9861111111111112,0.5347222222222222,0.4513888888888889
07305,07,305,1857,900,13,887,431,456,0.48465266558966075,0.014444444444444444,0.9855555555555555,0.47888888888888886,0.5066666666666667
07306,07,306,1761,941,13,928,487,441,0.5343554798409994,0.01381509032943677,0.9861849096705633,0.5175345377258236,0.46865037194473963
07307,07,307,1945,907,12,895,448,447,0.46632390745501284,0.013230429988974642,0.9867695700110254,0.49393605292171994,0.4928335170893054
07308,07,308,1726,865,18,847,405,442,0.5011587485515643,0.020809248554913295,0.9791907514450867,0.4682080924855491,0.5109826589595375
07309,07,309,1680,957,25,932,484,448,0.5696428571428571,0.02612330198537095,0.9738766980146291,0.5057471264367817,0.46812957157784746
07310,07,310,1868,890,16,874,448,426,0.47644539614561027,0.017977528089887642,0.9820224719101124,0.503370786516854,0.4786516853932584
07311,07,311,1686,910,26,884,450,434,0.5397390272835113,0.02857142857142857,0.9714285714285714,0.4945054945054945,0.47692307692307695
07312,07,312,1441,788,20,768,389,379,0.5468424705065926,0.025380710659898477,0.9746192893401016,0.4936548223350254,0.48096446700507617
07313,07,313,1833,935,12,923,503,420,0.5100927441352974,0.012834224598930482,0.9871657754010695,0.5379679144385027,0.44919786096256686
07314,07,314,1698,922,21,901,500,401,0.5429917550058893,0.0227765726681128,0.9772234273318872,0.5422993492407809,0.4349240780911063
07315,07,315,1936,991,18,973,489,484,0.5118801652892562,0.018163471241170535,0.9818365287588294,0.4934409687184662,0.4883955600403633
07316,07,316,1956,940,19,921,571,350,0.48057259713701433,0.02021276595744681,0.9797872340425532,0.6074468085106383,0.3723404255319149
07317,07,317,1846,882,23,859,517,342,0.47778981581798485,0.026077097505668934,0.9739229024943311,0.5861678004535147,0.3877551020408163
07318,07,318,1798,890,17,873,546,327,0.4949944382647386,0.019101123595505618,0.9808988764044944,0.6134831460674157,0.36741573033707864
07319,07,319,2087,864,14,850,571,279,0.41399137517968376,0.016203703703703703,0.9837962962962963,0.6608796296296297,0.3229166666666667
07401,07,401,1764,911,20,891,480,411,0.5164399092970522,0.021953896816684963,0.9780461031833151,0.5268935236004391,0.45115257958287597
07402,07,402,1874,912,23,889,389,500,0.48665955176093917,0.025219298245614034,0.9747807017543859,0.42653508771929827,0.5482456140350878
07403,07,403,1995,1071,33,1038,665,373,0.5368421052631579,0.03081232492997199,0.969187675070028,0.6209150326797386,0.34827264239028943
07404,07,404,1764,922,16,906,400,506,0.5226757369614512,0.01735357917570499,0.982646420824295,0.43383947939262474,0.5488069414316703
07405,07,405,1924,827,14,813,513,300,0.4298336798336798,0.016928657799274487,0.9830713422007256,0.6203143893591294,0.36275695284159615
07406,07,406,1979,994,10,984,631,353,0.5022738756947953,0.01006036217303823,0.9899396378269618,0.6348088531187123,0.3551307847082495
07407,07,407,1804,837,20,817,560,257,0.4639689578713969,0.023894862604540025,0.97610513739546,0.6690561529271206,0.3070489844683393
07408,07,408,1918,962,24,938,508,430,0.5015641293013556,0.02494802494802495,0.975051975051975,0.5280665280665281,0.446985446985447
07409,07,409,1922,837,18,819,490,329,0.43548387096774194,0.021505376344086023,0.978494623655914,0.5854241338112306,0.3930704898446834
07410,07,410,2189,969,15,954,613,341,0.44266788487894015,0.015479876160990712,0.9845201238390093,0.6326109391124871,0.35190918472652216
07411,07,411,2056,913,25,888,551,337,0.44406614785992216,0.027382256297918947,0.9726177437020811,0.6035049288061336,0.36911281489594744
07412,07,412,1864,958,20,938,544,394,0.5139484978540773,0.020876826722338204,0.9791231732776617,0.5678496868475992,0.4112734864300626
07413,07,413,2000,990,14,976,563,413,0.495,0.014141414141414142,0.9858585858585859,0.5686868686868687,0.4171717171717172
07414,07,414,2123,840,13,827,554,273,0.39566650965614697,0.015476190476190477,0.9845238095238096,0.6595238095238095,0.325
07415,07,415,1887,932,23,909,538,371,0.4939056703762586,0.02467811158798283,0.9753218884120172,0.5772532188841202,0.398068669527897
07416,07,416,2310,1051,27,1024,640,384,0.454978354978355,0.025689819219790674,0.9743101807802094,0.6089438629876308,0.3653663177925785
07417,07,417,1691,894,24,870,510,360,0.5286812536960378,0.026845637583892617,0.9731543624161074,0.5704697986577181,0.40268456375838924
07501,07,501,2320,1084,22,1062,738,324,0.4672413793103448,0.02029520295202952,0.9797047970479705,0.6808118081180812,0.2988929889298893
07502,07,502,1937,895,23,872,626,246,0.46205472379969026,0.02569832402234637,0.9743016759776536,0.6994413407821229,0.2748603351955307
07503,07,503,1857,936,15,921,627,294,0.5040387722132472,0.016025641025641024,0.9839743589743589,0.6698717948717948,0.3141025641025641
07504,07,504,2195,973,37,936,601,335,0.4432801822323462,0.03802672147995889,0.9619732785200411,0.6176772867420349,0.3442959917780062
07505,07,505,1971,998,15,983,668,315,0.5063419583967529,0.01503006012024048,0.9849699398797596,0.6693386773547094,0.3156312625250501
07506,07,506,2096,1061,23,1038,702,336,0.5062022900763359,0.021677662582469368,0.9783223374175306,0.6616399622997172,0.3166823751178134
07507,07,507,2131,860,23,837,591,246,0.40356640075082123,0.026744186046511628,0.9732558139534884,0.6872093023255814,0.28604651162790695
07508,07,508,1908,943,13,930,632,298,0.4942348008385744,0.013785790031813362,0.9862142099681867,0.6702014846235419,0.31601272534464475
07509,07,509,1987,952,12,940,675,265,0.4791142425767489,0.012605042016806723,0.9873949579831933,0.7090336134453782,0.27836134453781514
07510,07,510,1746,754,13,741,537,204,0.43184421534937,0.017241379310344827,0.9827586206896551,0.7122015915119363,0.27055702917771884
07511,07,511,1830,867,20,847,594,253,0.4737704918032787,0.02306805074971165,0.9769319492502884,0.6851211072664359,0.2918108419838524
07512,07,512,1657,820,21,799,587,212,0.4948702474351237,0.025609756097560974,0.974390243902439,0.7158536585365853,0.25853658536585367
07513,07,513,1928,798,21,777,553,224,0.4139004149377593,0.02631578947368421,0.9736842105263158,0.6929824561403509,0.2807017543859649
07514,07,514,2155,1012,32,980,660,320,0.46960556844547563,0.03162055335968379,0.9683794466403162,0.6521739130434783,0.31620553359683795
07515,07,515,1952,893,9,884,646,238,0.4574795081967213,0.010078387458006719,0.9899216125419933,0.723404255319149,0.26651735722284436
07516,07,516,2116,1106,26,1080,755,325,0.5226843100189036,0.023508137432188065,0.976491862567812,0.6826401446654611,0.2938517179023508
07517,07,517,2013,1010,14,996,676,320,0.50173869846001,0.013861386138613862,0.9861386138613861,0.6693069306930693,0.31683168316831684
07601,07,601,1928,922,31,891,588,303,0.4782157676348548,0.033622559652928416,0.9663774403470716,0.6377440347071583,0.3286334056399132
07602,07,602,2228,1199,39,1160,799,361,0.5381508078994613,0.03252710592160134,0.9674728940783986,0.6663886572143453,0.3010842368640534
07603,07,603,2110,1078,17,1061,711,350,0.5109004739336492,0.015769944341372914,0.9842300556586271,0.6595547309833024,0.3246753246753247
07604,07,604,2127,951,13,938,655,283,0.44710860366713684,0.013669821240799159,0.9863301787592008,0.6887486855941115,0.29758149316508936
07605,07,605,2020,951,19,932,680,252,0.47079207920792077,0.019978969505783387,0.9800210304942166,0.7150368033648791,0.26498422712933756
07606,07,606,1738,997,17,980,624,356,0.5736478711162255,0.017051153460381142,0.9829488465396189,0.6258776328986961,0.35707121364092276
07607,07,607,2031,1075,27,1048,740,308,0.5292959133431807,0.025116279069767444,0.9748837209302326,0.6883720930232559,0.28651162790697676
07608,07,608,1140,577,13,564,438,126,0.506140350877193,0.022530329289428077,0.9774696707105719,0.7590987868284229,0.21837088388214904
07609,07,609,2582,1140,26,1114,808,306,0.4415182029434547,0.02280701754385965,0.9771929824561404,0.7087719298245614,0.26842105263157895
07610,07,610,1329,449,13,436,336,100,0.3378480060195636,0.028953229398663696,0.9710467706013363,0.7483296213808464,0.22271714922049
07611,07,611,2033,1025,16,1009,734,275,0.5041810132808657,0.015609756097560976,0.984390243902439,0.7160975609756097,0.2682926829268293
07612,07,612,1555,711,17,694,523,171,0.4572347266881029,0.02390998593530239,0.9760900140646976,0.7355836849507735,0.24050632911392406
07613,07,613,2129,941,26,915,678,237,0.44199154532644436,0.02763018065887354,0.9723698193411264,0.720510095642933,0.2518597236981934
07614,07,614,2176,1034,8,1026,752,274,0.47518382352941174,0.007736943907156673,0.9922630560928434,0.7272727272727273,0.26499032882011603
07615,07,615,1778,865,18,847,597,250,0.4865016872890889,0.020809248554913295,0.9791907514450867,0.6901734104046243,0.28901734104046245
07616,07,616,2280,1055,19,1036,727,309,0.46271929824561403,0.01800947867298578,0.9819905213270143,0.6890995260663507,0.29289099526066353
07617,07,617,1931,1033,10,1023,711,312,0.53495598135681,0.00968054211035818,0.9903194578896418,0.6882865440464666,0.3020329138431752
07701,07,701,1973,1052,16,1036,747,289,0.5331981753674607,0.015209125475285171,0.9847908745247148,0.7100760456273765,0.2747148288973384
07702,07,702,2010,1049,24,1025,746,279,0.5218905472636816,0.022878932316491896,0.9771210676835081,0.7111534795042898,0.2659675881792183
07703,07,703,2120,1161,34,1127,858,269,0.5476415094339623,0.029285099052540915,0.970714900947459,0.7390180878552972,0.23169681309216192
07704,07,704,2318,1105,27,1078,777,301,0.47670405522001724,0.024434389140271493,0.9755656108597285,0.7031674208144797,0.27239819004524884
07705,07,705,1883,951,13,938,697,241,0.5050451407328731,0.013669821240799159,0.9863301787592008,0.732912723449001,0.25341745531019977
07706,07,706,1790,826,12,814,566,248,0.46145251396648046,0.014527845036319613,0.9854721549636803,0.6852300242130751,0.30024213075060535
07707,07,707,1962,977,18,959,693,266,0.4979612640163099,0.01842374616171955,0.9815762538382804,0.7093142272262026,0.27226202661207777
07708,07,708,2037,1005,34,971,735,236,0.49337260677466865,0.03383084577114428,0.9661691542288557,0.7313432835820896,0.23482587064676616
07709,07,709,1823,934,17,917,647,270,0.5123422929237521,0.018201284796573874,0.9817987152034261,0.6927194860813705,0.2890792291220557
07710,07,710,1784,787,20,767,604,163,0.44114349775784756,0.025412960609911054,0.974587039390089,0.7674714104193139,0.2071156289707751
07711,07,711,1527,698,11,687,519,168,0.45710543549443355,0.015759312320916905,0.9842406876790831,0.7435530085959885,0.24068767908309455
07712,07,712,1899,854,17,837,650,187,0.44971037388099,0.01990632318501171,0.9800936768149883,0.7611241217798594,0.2189695550351288
07713,07,713,1753,797,24,773,567,206,0.45464917284654877,0.030112923462986198,0.9698870765370138,0.7114178168130489,0.2584692597239649
07714,07,714,1686,793,20,773,598,175,0.47034400948991695,0.025220680958385876,0.9747793190416141,0.7540983606557377,0.22068095838587642
07715,07,715,1734,913,12,901,664,237,0.5265282583621684,0.013143483023001095,0.9868565169769989,0.7272727272727273,0.25958378970427165
07716,07,716,1470,723,10,713,513,200,0.49183673469387756,0.013831258644536652,0.9861687413554634,0.7095435684647303,0.2766251728907331
07717,07,717,1641,801,13,788,563,225,0.48811700182815354,0.016229712858926344,0.9837702871410736,0.7028714107365793,0.2808988764044944
07718,07,718,1704,854,10,844,642,202,0.5011737089201878,0.0117096018735363,0.9882903981264637,0.7517564402810304,0.23653395784543327
08101,08,101,1040,503,22,481,186,295,0.48365384615384616,0.0437375745526839,0.9562624254473161,0.3697813121272366,0.5864811133200796
08102,08,102,1128,549,21,528,219,309,0.4867021276595745,0.03825136612021858,0.9617486338797814,0.3989071038251366,0.5628415300546448
08103,08,103,1347,656,27,629,269,360,0.48700816629547145,0.041158536585365856,0.9588414634146342,0.4100609756097561,0.5487804878048781
08104,08,104,1260,592,2,590,257,333,0.46984126984126984,0.0033783783783783786,0.9966216216216216,0.4341216216216216,0.5625
08105,08,105,1188,571,17,554,241,313,0.48063973063973064,0.0297723292469352,0.9702276707530648,0.4220665499124343,0.5481611208406305
08106,08,106,1221,609,36,573,213,360,0.4987714987714988,0.059113300492610835,0.9408866995073891,0.3497536945812808,0.5911330049261084
08107,08,107,1427,646,26,620,251,369,0.452697967764541,0.04024767801857585,0.9597523219814241,0.38854489164086686,0.5712074303405573
08108,08,108,1054,568,6,562,196,366,0.538899430740038,0.01056338028169014,0.9894366197183099,0.34507042253521125,0.6443661971830986
08109,08,109,1160,616,15,601,242,359,0.5310344827586206,0.024350649350649352,0.9756493506493507,0.39285714285714285,0.5827922077922078
08110,08,110,1131,526,17,509,219,290,0.4650751547303271,0.03231939163498099,0.967680608365019,0.41634980988593157,0.5513307984790875
08111,08,111,1008,464,28,436,196,240,0.4603174603174603,0.0603448275862069,0.9396551724137931,0.4224137931034483,0.5172413793103449
08112,08,112,1401,577,20,557,256,301,0.4118486795146324,0.03466204506065858,0.9653379549393414,0.4436741767764298,0.5216637781629117
08113,08,113,1446,715,18,697,294,403,0.49446749654218536,0.025174825174825177,0.9748251748251748,0.4111888111888112,0.5636363636363636
08114,08,114,1159,573,16,557,227,330,0.4943917169974116,0.027923211169284468,0.9720767888307156,0.3961605584642234,0.5759162303664922
08115,08,115,1134,583,13,570,232,338,0.5141093474426808,0.022298456260720412,0.9777015437392796,0.3979416809605489,0.5797598627787307
08116,08,116,842,349,9,340,224,116,0.4144893111638955,0.025787965616045846,0.9742120343839542,0.6418338108882522,0.332378223495702
08117,08,117,1228,518,27,491,251,240,0.4218241042345277,0.052123552123552123,0.9478764478764479,0.48455598455598453,0.46332046332046334
08118,08,118,1481,713,19,694,274,420,0.4814314652261985,0.02664796633941094,0.9733520336605891,0.38429172510518933,0.5890603085553997
08119,08,119,1241,652,21,631,263,368,0.5253827558420628,0.032208588957055216,0.9677914110429447,0.40337423312883436,0.5644171779141104
08120,08,120,1198,601,21,580,299,281,0.501669449081803,0.03494176372712146,0.9650582362728786,0.49750415973377704,0.46755407653910147
08121,08,121,1184,529,11,518,289,229,0.4467905405405405,0.020793950850661626,0.9792060491493384,0.5463137996219282,0.43289224952741023
08122,08,122,1432,592,19,573,264,309,0.4134078212290503,0.03209459459459459,0.9679054054054054,0.44594594594594594,0.5219594594594594
08123,08,123,1478,729,22,707,302,405,0.493234100135318,0.03017832647462277,0.9698216735253772,0.41426611796982166,0.5555555555555556
08201,08,201,1486,724,17,707,287,420,0.48721399730820997,0.023480662983425413,0.9765193370165746,0.39640883977900554,0.580110497237569
08202,08,202,1336,639,25,614,309,305,0.4782934131736527,0.03912363067292645,0.9608763693270735,0.4835680751173709,0.47730829420970267
08203,08,203,1405,720,31,689,275,414,0.5124555160142349,0.043055555555555555,0.9569444444444445,0.3819444444444444,0.575
08204,08,204,1245,574,23,551,241,310,0.4610441767068273,0.04006968641114982,0.9599303135888502,0.41986062717770034,0.5400696864111498
08205,08,205,1355,586,11,575,249,326,0.43247232472324726,0.01877133105802048,0.9812286689419796,0.4249146757679181,0.5563139931740614
08206,08,206,1340,588,23,565,257,308,0.4388059701492537,0.0391156462585034,0.9608843537414966,0.4370748299319728,0.5238095238095238
08207,08,207,1435,678,24,654,264,390,0.47247386759581883,0.035398230088495575,0.9646017699115044,0.3893805309734513,0.5752212389380531
08208,08,208,1227,567,28,539,228,311,0.4621026894865526,0.04938271604938271,0.9506172839506173,0.4021164021164021,0.5485008818342152
08209,08,209,1447,778,10,768,335,433,0.5376641326883207,0.012853470437017995,0.987146529562982,0.4305912596401028,0.5565552699228792
08210,08,210,1325,653,18,635,283,352,0.4928301886792453,0.027565084226646247,0.9724349157733537,0.4333843797856049,0.5390505359877489
08211,08,211,1201,605,21,584,252,332,0.5037468776019983,0.03471074380165289,0.9652892561983472,0.41652892561983473,0.5487603305785124
08212,08,212,1329,670,31,639,260,379,0.5041384499623778,0.04626865671641791,0.9537313432835821,0.3880597014925373,0.5656716417910448
08213,08,213,1127,490,26,464,273,191,0.43478260869565216,0.053061224489795916,0.9469387755102041,0.5571428571428572,0.38979591836734695
08214,08,214,1111,469,13,456,286,170,0.4221422142214221,0.02771855010660981,0.9722814498933902,0.6098081023454158,0.3624733475479744
08215,08,215,1194,558,20,538,243,295,0.46733668341708545,0.035842293906810034,0.96415770609319,0.43548387096774194,0.5286738351254481
08216,08,216,1305,521,25,496,222,274,0.3992337164750958,0.04798464491362764,0.9520153550863724,0.42610364683301344,0.525911708253359
08217,08,217,1178,466,7,459,195,264,0.39558573853989815,0.015021459227467811,0.9849785407725322,0.4184549356223176,0.5665236051502146
08218,08,218,1317,586,25,561,247,314,0.44495064540622625,0.042662116040955635,0.9573378839590444,0.42150170648464164,0.5358361774744027
08219,08,219,1213,593,22,571,320,251,0.4888705688375927,0.03709949409780776,0.9629005059021922,0.5396290050590219,0.42327150084317033
08220,08,220,1217,609,23,586,242,344,0.5004108463434676,0.03776683087027915,0.9622331691297209,0.3973727422003284,0.5648604269293924
08221,08,221,1172,599,13,586,243,343,0.5110921501706485,0.021702838063439065,0.9782971619365609,0.4056761268781302,0.5726210350584308
08222,08,222,1549,754,25,729,322,407,0.486765655261459,0.033156498673740056,0.96684350132626,0.4270557029177719,0.5397877984084881
08301,08,301,1316,617,15,602,244,358,0.4688449848024316,0.024311183144246355,0.9756888168557536,0.39546191247974066,0.580226904376013
08302,08,302,1099,480,24,456,192,264,0.4367606915377616,0.05,0.95,0.4,0.55
08303,08,303,1384,686,22,664,306,358,0.4956647398843931,0.03206997084548105,0.967930029154519,0.446064139941691,0.521865889212828
08304,08,304,1463,688,25,663,275,388,0.47026657552973344,0.036337209302325583,0.9636627906976745,0.3997093023255814,0.563953488372093
08305,08,305,1187,632,23,609,250,359,0.5324347093513058,0.03639240506329114,0.9636075949367089,0.39556962025316456,0.5680379746835443
08306,08,306,1487,693,21,672,273,399,0.4660390047074647,0.030303030303030304,0.9696969696969697,0.3939393939393939,0.5757575757575758
08307,08,307,1034,485,19,466,239,227,0.4690522243713733,0.03917525773195876,0.9608247422680413,0.4927835051546392,0.46804123711340206
08308,08,308,1463,687,24,663,302,361,0.46958304853041694,0.034934497816593885,0.9650655021834061,0.4395924308588064,0.5254730713245997
08309,08,309,1101,522,17,505,206,299,0.47411444141689374,0.032567049808429116,0.9674329501915708,0.3946360153256705,0.5727969348659003
08310,08,310,1487,739,28,711,295,416,0.4969737726967048,0.037889039242219216,0.9621109607577808,0.39918809201623817,0.5629228687415426
08311,08,311,1293,601,14,587,247,340,0.4648105181747873,0.02329450915141431,0.9767054908485857,0.41098169717138106,0.5657237936772047
08312,08,312,1586,664,27,637,252,385,0.41866330390920553,0.04066265060240964,0.9593373493975904,0.3795180722891566,0.5798192771084337
08313,08,313,1028,421,18,403,184,219,0.4095330739299611,0.04275534441805225,0.9572446555819477,0.43705463182897863,0.5201900237529691
08314,08,314,1046,511,20,491,259,232,0.48852772466539196,0.03913894324853229,0.9608610567514677,0.5068493150684932,0.45401174168297453
08315,08,315,1268,445,12,433,230,203,0.3509463722397476,0.02696629213483146,0.9730337078651685,0.5168539325842697,0.45617977528089887
08316,08,316,1078,406,16,390,198,192,0.37662337662337664,0.03940886699507389,0.9605911330049262,0.4876847290640394,0.4729064039408867
08317,08,317,1098,493,22,471,265,206,0.44899817850637525,0.04462474645030426,0.9553752535496958,0.537525354969574,0.4178498985801217
08318,08,318,1101,315,11,304,151,153,0.28610354223433243,0.03492063492063492,0.9650793650793651,0.4793650793650794,0.4857142857142857
08319,08,319,1009,402,5,397,271,126,0.398414271555996,0.012437810945273632,0.9875621890547264,0.6741293532338308,0.31343283582089554
08320,08,320,1105,429,11,418,290,128,0.38823529411764707,0.02564102564102564,0.9743589743589743,0.675990675990676,0.29836829836829837
08321,08,321,1133,458,20,438,312,126,0.4042365401588703,0.043668122270742356,0.9563318777292577,0.6812227074235808,0.27510917030567683
08322,08,322,1190,531,20,511,350,161,0.446218487394958,0.03766478342749529,0.9623352165725048,0.6591337099811676,0.3032015065913371
08323,08,323,1369,678,8,670,417,253,0.4952520087655223,0.011799410029498525,0.9882005899705014,0.6150442477876106,0.37315634218289084
08324,08,324,1379,539,9,530,373,157,0.39086294416243655,0.016697588126159554,0.9833024118738405,0.6920222634508348,0.2912801484230056
08401,08,401,1485,649,13,636,324,312,0.43703703703703706,0.020030816640986132,0.9799691833590138,0.49922958397534667,0.48073959938366717
08402,08,402,1393,580,10,570,338,232,0.416367552045944,0.017241379310344827,0.9827586206896551,0.5827586206896552,0.4
08403,08,403,1343,573,10,563,361,202,0.426656738644825,0.017452006980802792,0.9825479930191972,0.6300174520069808,0.3525305410122164
08404,08,404,1362,542,13,529,396,133,0.39794419970631423,0.023985239852398525,0.9760147601476015,0.7306273062730627,0.24538745387453875
08405,08,405,1396,556,13,543,389,154,0.3982808022922636,0.023381294964028777,0.9766187050359713,0.6996402877697842,0.27697841726618705
08406,08,406,1466,784,7,777,497,280,0.5347885402455662,0.008928571428571428,0.9910714285714286,0.6339285714285714,0.35714285714285715
08407,08,407,1435,631,17,614,413,201,0.4397212543554007,0.02694136291600634,0.9730586370839936,0.6545166402535658,0.3185419968304279
08408,08,408,1158,480,20,460,290,170,0.41450777202072536,0.041666666666666664,0.9583333333333334,0.6041666666666666,0.3541666666666667
08409,08,409,1436,706,22,684,469,215,0.49164345403899723,0.031161473087818695,0.9688385269121813,0.6643059490084986,0.3045325779036827
08410,08,410,1071,439,16,423,294,129,0.4098972922502334,0.03644646924829157,0.9635535307517085,0.6697038724373576,0.2938496583143508
08411,08,411,1379,634,17,617,380,237,0.45975344452501815,0.026813880126182965,0.973186119873817,0.5993690851735016,0.37381703470031546
08412,08,412,1426,743,14,729,387,342,0.5210378681626928,0.018842530282637954,0.9811574697173621,0.5208613728129206,0.46029609690444145
08413,08,413,1603,685,8,677,430,247,0.42732376793512167,0.01167883211678832,0.9883211678832117,0.6277372262773723,0.3605839416058394
08414,08,414,1325,514,15,499,382,117,0.3879245283018868,0.029182879377431907,0.9708171206225681,0.7431906614785992,0.22762645914396887
08415,08,415,1043,456,14,442,320,122,0.43720038350910834,0.03070175438596491,0.9692982456140351,0.7017543859649122,0.2675438596491228
08416,08,416,999,518,16,502,305,197,0.5185185185185185,0.03088803088803089,0.9691119691119691,0.5888030888030888,0.3803088803088803
08417,08,417,1113,488,11,477,343,134,0.4384546271338724,0.022540983606557378,0.9774590163934426,0.7028688524590164,0.27459016393442626
08418,08,418,1437,645,4,641,423,218,0.4488517745302714,0.006201550387596899,0.993798449612403,0.6558139534883721,0.33798449612403103
08419,08,419,1056,481,11,470,349,121,0.45549242424242425,0.02286902286902287,0.9771309771309772,0.7255717255717256,0.2515592515592516
08420,08,420,1463,739,7,732,480,252,0.5051264524948735,0.009472259810554804,0.9905277401894452,0.6495263870094723,0.34100135317997293
08421,08,421,1028,555,10,545,375,170,0.5398832684824902,0.018018018018018018,0.9819819819819819,0.6756756756756757,0.3063063063063063
08422,08,422,1226,603,10,593,414,179,0.49184339314845027,0.01658374792703151,0.9834162520729685,0.6865671641791045,0.296849087893864
08423,08,423,1188,567,17,550,391,159,0.4772727272727273,0.029982363315696647,0.9700176366843033,0.689594356261023,0.2804232804232804
08501,08,501,1152,461,12,449,295,154,0.4001736111111111,0.026030368763557483,0.9739696312364425,0.6399132321041214,0.33405639913232105
08502,08,502,1409,765,8,757,495,262,0.5429382540809085,0.01045751633986928,0.9895424836601308,0.6470588235294118,0.34248366013071896
08503,08,503,1214,553,7,546,362,184,0.45551894563426687,0.012658227848101266,0.9873417721518988,0.6546112115732369,0.33273056057866185
08504,08,504,1442,743,19,724,544,180,0.515256588072122,0.02557200538358008,0.9744279946164199,0.7321668909825033,0.24226110363391656
08505,08,505,1373,701,21,680,492,188,0.5105608157319738,0.029957203994293864,0.9700427960057061,0.7018544935805991,0.268188302425107
08506,08,506,1368,707,18,689,532,157,0.5168128654970761,0.02545968882602546,0.9745403111739745,0.7524752475247525,0.22206506364922207
08507,08,507,1073,562,8,554,392,162,0.5237651444547996,0.014234875444839857,0.9857651245551602,0.697508896797153,0.28825622775800713
08508,08,508,1271,523,11,512,348,164,0.4114870180959874,0.021032504780114723,0.9789674952198852,0.6653919694072657,0.3135755258126195
08509,08,509,1112,517,2,515,387,128,0.46492805755395683,0.0038684719535783366,0.9961315280464217,0.7485493230174082,0.24758220502901354
08510,08,510,1586,890,22,868,596,272,0.5611601513240857,0.024719101123595506,0.9752808988764045,0.6696629213483146,0.3056179775280899
08511,08,511,1468,695,19,676,503,173,0.473433242506812,0.027338129496402876,0.9726618705035971,0.7237410071942446,0.2489208633093525
08512,08,512,1079,564,8,556,388,168,0.5227062094531975,0.014184397163120567,0.9858156028368794,0.6879432624113475,0.2978723404255319
08513,08,513,960,507,7,500,330,170,0.528125,0.013806706114398421,0.9861932938856016,0.650887573964497,0.33530571992110453
08514,08,514,1028,515,12,503,354,149,0.5009727626459144,0.02330097087378641,0.9766990291262136,0.6873786407766991,0.28932038834951457
08515,08,515,1160,596,4,592,444,148,0.5137931034482759,0.006711409395973154,0.9932885906040269,0.7449664429530202,0.2483221476510067
08516,08,516,1136,594,18,576,412,164,0.522887323943662,0.030303030303030304,0.9696969696969697,0.6936026936026936,0.2760942760942761
08517,08,517,1350,697,17,680,474,206,0.5162962962962963,0.024390243902439025,0.975609756097561,0.6800573888091822,0.29555236728837875
08518,08,518,1232,576,17,559,422,137,0.4675324675324675,0.029513888888888888,0.9704861111111112,0.7326388888888888,0.2378472222222222
08519,08,519,1033,504,14,490,357,133,0.4878993223620523,0.027777777777777776,0.9722222222222222,0.7083333333333334,0.2638888888888889
08520,08,520,1386,554,14,540,379,161,0.3997113997113997,0.02527075812274368,0.9747292418772563,0.6841155234657039,0.29061371841155237
08521,08,521,1219,611,15,596,416,180,0.5012305168170632,0.024549918166939442,0.9754500818330606,0.6808510638297872,0.2945990180032733
08522,08,522,1433,679,19,660,469,191,0.473831123517097,0.027982326951399118,0.9720176730486009,0.6907216494845361,0.2812960235640648
08601,08,601,1598,732,16,716,528,188,0.45807259073842305,0.02185792349726776,0.9781420765027322,0.7213114754098361,0.2568306010928962
08602,08,602,1709,637,8,629,442,187,0.3727325921591574,0.012558869701726845,0.9874411302982732,0.6938775510204082,0.29356357927786497
08603,08,603,1113,464,5,459,322,137,0.4168912848158131,0.010775862068965518,0.9892241379310345,0.6939655172413793,0.2952586206896552
08604,08,604,1280,584,15,569,412,157,0.45625,0.025684931506849314,0.9743150684931506,0.7054794520547946,0.2688356164383562
08605,08,605,1301,562,5,557,398,159,0.43197540353574176,0.008896797153024912,0.9911032028469751,0.708185053380783,0.28291814946619215
08606,08,606,1178,545,14,531,385,146,0.4626485568760611,0.025688073394495414,0.9743119266055046,0.7064220183486238,0.26788990825688075
08607,08,607,1257,481,12,469,328,141,0.3826571201272872,0.02494802494802495,0.975051975051975,0.681912681912682,0.29313929313929316
08608,08,608,1763,749,32,717,507,210,0.4248440158820193,0.042723631508678236,0.9572763684913218,0.6769025367156208,0.2803738317757009
08609,08,609,1558,641,11,630,460,170,0.41142490372272145,0.0171606864274571,0.982839313572543,0.717628705148206,0.26521060842433697
08610,08,610,1027,475,10,465,334,131,0.4625121713729309,0.021052631578947368,0.9789473684210527,0.7031578947368421,0.27578947368421053
08611,08,611,1565,594,15,579,446,133,0.3795527156549521,0.025252525252525252,0.9747474747474747,0.7508417508417509,0.2239057239057239
08612,08,612,1243,516,31,485,341,144,0.415124698310539,0.060077519379844964,0.939922480620155,0.6608527131782945,0.27906976744186046
08613,08,613,1441,706,20,686,493,193,0.4899375433726579,0.028328611898016998,0.9716713881019831,0.6983002832861189,0.273371104815864
08614,08,614,1016,395,5,390,297,93,0.3887795275590551,0.012658227848101266,0.9873417721518988,0.7518987341772152,0.23544303797468355
08615,08,615,1652,677,17,660,458,202,0.40980629539951574,0.025110782865583457,0.9748892171344166,0.6765140324963073,0.2983751846381093
08616,08,616,1191,461,8,453,305,148,0.38706968933669184,0.01735357917570499,0.982646420824295,0.6616052060737527,0.3210412147505423
08617,08,617,1318,654,8,646,466,180,0.496206373292868,0.012232415902140673,0.9877675840978594,0.7125382262996942,0.27522935779816515
08618,08,618,1215,536,19,517,389,128,0.4411522633744856,0.03544776119402985,0.9645522388059702,0.7257462686567164,0.23880597014925373
08619,08,619,1401,625,21,604,458,146,0.44610992148465384,0.0336,0.9664,0.7328,0.2336
08620,08,620,1566,635,9,626,447,179,0.4054916985951469,0.014173228346456693,0.9858267716535433,0.7039370078740157,0.28188976377952757
08621,08,621,864,405,6,399,296,103,0.46875,0.014814814814814815,0.9851851851851852,0.7308641975308642,0.254320987654321
08622,08,622,1325,576,10,566,423,143,0.43471698113207546,0.017361111111111112,0.9826388888888888,0.734375,0.2482638888888889
08701,08,701,1486,734,8,726,514,212,0.4939434724091521,0.010899182561307902,0.989100817438692,0.7002724795640327,0.2888283378746594
08702,08,702,1412,744,4,740,514,226,0.5269121813031161,0.005376344086021506,0.9946236559139785,0.6908602150537635,0.30376344086021506
08703,08,703,1177,558,13,545,397,148,0.47408666100254887,0.023297491039426525,0.9767025089605734,0.7114695340501792,0.26523297491039427
08704,08,704,1535,801,11,790,563,227,0.5218241042345277,0.01373283395755306,0.9862671660424469,0.7028714107365793,0.2833957553058677
08705,08,705,1268,710,16,694,484,210,0.5599369085173501,0.022535211267605635,0.9774647887323944,0.6816901408450704,0.29577464788732394
08706,08,706,1549,912,33,879,597,282,0.5887669464170433,0.03618421052631579,0.9638157894736842,0.6546052631578947,0.3092105263157895
08707,08,707,1419,688,19,669,474,195,0.48484848484848486,0.027616279069767442,0.9723837209302325,0.688953488372093,0.28343023255813954
08708,08,708,1397,713,12,701,504,197,0.5103793843951324,0.016830294530154277,0.9831697054698457,0.7068723702664796,0.2762973352033661
08709,08,709,1474,737,14,723,513,210,0.5,0.018995929443690638,0.9810040705563093,0.6960651289009498,0.28493894165535955
08710,08,710,1460,805,23,782,576,206,0.5513698630136986,0.02857142857142857,0.9714285714285714,0.715527950310559,0.25590062111801243
08711,08,711,1505,824,16,808,574,234,0.5475083056478405,0.019417475728155338,0.9805825242718447,0.6966019417475728,0.28398058252427183
08712,08,712,1518,796,15,781,561,220,0.5243741765480896,0.018844221105527637,0.9811557788944724,0.7047738693467337,0.27638190954773867
08713,08,713,1470,805,14,791,562,229,0.5476190476190477,0.017391304347826087,0.9826086956521739,0.698136645962733,0.284472049689441
08714,08,714,1408,659,14,645,459,186,0.4680397727272727,0.021244309559939303,0.9787556904400607,0.6965098634294385,0.2822458270106222
08715,08,715,1492,817,23,794,522,272,0.5475871313672922,0.028151774785801713,0.9718482252141983,0.6389228886168911,0.3329253365973072
08716,08,716,1640,844,17,827,602,225,0.5146341463414634,0.02014218009478673,0.9798578199052133,0.7132701421800948,0.2665876777251185
08717,08,717,1542,881,18,863,618,245,0.5713359273670557,0.02043132803632236,0.9795686719636776,0.7014755959137344,0.27809307604994327
08718,08,718,1673,869,17,852,612,240,0.5194261805140467,0.019562715765247412,0.9804372842347526,0.7042577675489068,0.2761795166858458
08719,08,719,1527,733,15,718,500,218,0.48002619515389655,0.020463847203274217,0.9795361527967258,0.6821282401091405,0.29740791268758526
09101,09,101,1469,818,30,788,315,473,0.5568413886997958,0.03667481662591687,0.9633251833740831,0.38508557457212717,0.578239608801956
09102,09,102,1849,884,29,855,397,458,0.4780962682531098,0.032805429864253395,0.9671945701357466,0.4490950226244344,0.5180995475113123
09103,09,103,1988,1092,31,1061,416,645,0.5492957746478874,0.028388278388278388,0.9716117216117216,0.38095238095238093,0.5906593406593407
09104,09,104,1353,791,37,754,340,414,0.5846267553584626,0.04677623261694058,0.9532237673830595,0.42983565107458915,0.5233881163084703
09105,09,105,1296,632,15,617,272,345,0.4876543209876543,0.023734177215189875,0.9762658227848101,0.43037974683544306,0.5458860759493671
09106,09,106,1993,939,27,912,348,564,0.4711490215755143,0.02875399361022364,0.9712460063897763,0.3706070287539936,0.6006389776357828
09107,09,107,2084,1048,24,1024,518,506,0.5028790786948176,0.022900763358778626,0.9770992366412213,0.49427480916030536,0.48282442748091603
09108,09,108,2059,980,22,958,450,508,0.4759592034968431,0.022448979591836733,0.9775510204081632,0.45918367346938777,0.5183673469387755
09109,09,109,1914,952,27,925,429,496,0.49738766980146293,0.028361344537815126,0.9716386554621849,0.45063025210084034,0.5210084033613446
09110,09,110,2093,903,16,887,470,417,0.431438127090301,0.017718715393133997,0.982281284606866,0.5204872646733112,0.46179401993355484
09111,09,111,1925,952,19,933,499,434,0.49454545454545457,0.01995798319327731,0.9800420168067226,0.5241596638655462,0.45588235294117646
09112,09,112,1640,945,28,917,448,469,0.5762195121951219,0.02962962962962963,0.9703703703703703,0.4740740740740741,0.4962962962962963
09113,09,113,1593,846,28,818,413,405,0.5310734463276836,0.03309692671394799,0.966903073286052,0.48817966903073284,0.4787234042553192
09114,09,114,2221,992,23,969,434,535,0.4466456551103107,0.023185483870967742,0.9768145161290323,0.4375,0.5393145161290323
09115,09,115,1672,852,17,835,472,363,0.5095693779904307,0.01995305164319249,0.9800469483568075,0.5539906103286385,0.426056338028169
09116,09,116,2208,1059,30,1029,533,496,0.4796195652173913,0.028328611898016998,0.9716713881019831,0.5033050047214354,0.4683663833805477
09117,09,117,1952,942,16,926,514,412,0.48258196721311475,0.016985138004246284,0.9830148619957537,0.5456475583864119,0.43736730360934184
09118,09,118,1272,650,15,635,372,263,0.5110062893081762,0.023076923076923078,0.9769230769230769,0.5723076923076923,0.4046153846153846
09119,09,119,1223,675,9,666,369,297,0.5519215044971382,0.013333333333333334,0.9866666666666667,0.5466666666666666,0.44
09201,09,201,2118,1119,21,1098,579,519,0.5283286118980169,0.01876675603217158,0.9812332439678284,0.517426273458445,0.46380697050938335
09202,09,202,2038,1120,25,1095,589,506,0.549558390578999,0.022321428571428572,0.9776785714285714,0.5258928571428572,0.4517857142857143
09203,09,203,1945,1071,23,1048,598,450,0.5506426735218509,0.021475256769374416,0.9785247432306255,0.5583566760037348,0.42016806722689076
09204,09,204,2177,1161,27,1134,667,467,0.5333027101515847,0.023255813953488372,0.9767441860465116,0.5745047372954349,0.40223944875107664
09205,09,205,1512,793,18,775,469,306,0.5244708994708994,0.02269861286254729,0.9773013871374527,0.5914249684741488,0.3858764186633039
09206,09,206,1712,872,18,854,507,347,0.5093457943925234,0.020642201834862386,0.9793577981651376,0.5814220183486238,0.39793577981651373
09207,09,207,1489,739,32,707,423,284,0.49630624580255206,0.04330175913396482,0.9566982408660352,0.5723951285520974,0.38430311231393777
09208,09,208,1395,749,12,737,418,319,0.5369175627240144,0.01602136181575434,0.9839786381842457,0.5580774365821095,0.4259012016021362
09209,09,209,1350,711,15,696,391,305,0.5266666666666666,0.02109704641350211,0.9789029535864979,0.549929676511955,0.4289732770745429
09210,09,210,1771,893,9,884,515,369,0.5042348955392434,0.010078387458006719,0.9899216125419933,0.5767077267637178,0.4132138857782755
09211,09,211,2277,1089,16,1073,585,488,0.4782608695652174,0.014692378328741965,0.9853076216712581,0.5371900826446281,0.44811753902662993
09212,09,212,2130,1051,26,1025,525,500,0.4934272300469484,0.024738344433872503,0.9752616555661275,0.4995242626070409,0.47573739295908657
09213,09,213,2286,1169,42,1127,662,465,0.5113735783027121,0.03592814371257485,0.9640718562874252,0.5662959794696322,0.397775876817793
09214,09,214,2268,1025,30,995,572,423,0.4519400352733686,0.02926829268292683,0.9707317073170731,0.5580487804878049,0.41268292682926827
09215,09,215,1325,687,16,671,388,283,0.5184905660377358,0.023289665211062592,0.9767103347889374,0.5647743813682679,0.4119359534206696
09216,09,216,1494,852,25,827,432,395,0.570281124497992,0.029342723004694836,0.9706572769953051,0.5070422535211268,0.4636150234741784
09217,09,217,2046,1039,19,1020,540,480,0.5078201368523949,0.01828681424446583,0.9817131857555341,0.519730510105871,0.4619826756496631
09218,09,218,1198,640,4,636,354,282,0.5342237061769616,0.00625,0.99375,0.553125,0.440625
09219,09,219,1271,706,29,677,412,265,0.5554681353265145,0.04107648725212465,0.9589235127478754,0.5835694050991501,0.37535410764872523
09220,09,220,1758,915,14,901,484,417,0.5204778156996587,0.015300546448087432,0.9846994535519126,0.5289617486338798,0.4557377049180328
09221,09,221,2067,946,22,924,549,375,0.4576681180454765,0.023255813953488372,0.9767441860465116,0.580338266384778,0.3964059196617336
09301,09,301,1747,977,30,947,545,402,0.5592444190040069,0.030706243602865915,0.9692937563971341,0.5578300921187308,0.41146366427840325
09302,09,302,1894,1007,34,973,529,444,0.5316789862724393,0.033763654419066536,0.9662363455809335,0.5253227408142999,0.44091360476663355
09303,09,303,2807,1399,28,1371,777,594,0.49839686498040614,0.020014295925661188,0.9799857040743388,0.5553967119370979,0.4245889921372409
09304,09,304,1754,1001,20,981,567,414,0.5706955530216647,0.01998001998001998,0.98001998001998,0.5664335664335665,0.41358641358641357
09305,09,305,1941,879,19,860,444,416,0.4528593508500773,0.02161547212741752,0.9783845278725825,0.5051194539249146,0.4732650739476678
09306,09,306,1907,1030,22,1008,589,419,0.540115364446775,0.021359223300970873,0.9786407766990292,0.5718446601941748,0.40679611650485437
09307,09,307,1621,832,9,823,483,340,0.51326341764343,0.010817307692307692,0.9891826923076923,0.5805288461538461,0.40865384615384615
09308,09,308,2047,1138,27,1111,660,451,0.5559355153883733,0.023725834797891036,0.976274165202109,0.5799648506151143,0.39630931458699475
09309,09,309,1351,726,8,718,431,287,0.537379718726869,0.011019283746556474,0.9889807162534435,0.59366391184573,0.3953168044077135
09310,09,310,1586,938,23,915,570,345,0.5914249684741488,0.024520255863539446,0.9754797441364605,0.6076759061833689,0.3678038379530917
09311,09,311,1888,1103,25,1078,624,454,0.5842161016949152,0.022665457842248413,0.9773345421577516,0.5657298277425205,0.41160471441523117
09312,09,312,1477,905,12,893,539,354,0.6127285037237644,0.013259668508287293,0.9867403314917127,0.5955801104972376,0.3911602209944751
09313,09,313,1988,1130,12,1118,706,412,0.56841046277666,0.010619469026548672,0.9893805309734514,0.6247787610619469,0.36460176991150445
09314,09,314,1881,932,32,900,593,307,0.4954811270600744,0.034334763948497854,0.9656652360515021,0.6362660944206009,0.3293991416309013
09315,09,315,1402,784,16,768,463,305,0.5592011412268189,0.02040816326530612,0.9795918367346939,0.5905612244897959,0.38903061224489793
09316,09,316,1681,945,11,934,563,371,0.5621653777513385,0.01164021164021164,0.9883597883597883,0.5957671957671957,0.3925925925925926
09317,09,317,1112,620,6,614,349,265,0.5575539568345323,0.00967741935483871,0.9903225806451613,0.5629032258064516,0.4274193548387097
09318,09,318,1839,814,21,793,509,284,0.4426318651441001,0.025798525798525797,0.9742014742014742,0.6253071253071253,0.3488943488943489
09319,09,319,847,442,11,431,258,173,0.5218417945690673,0.024886877828054297,0.9751131221719457,0.583710407239819,0.3914027149321267
09320,09,320,1950,989,15,974,589,385,0.5071794871794871,0.015166835187057633,0.9848331648129424,0.5955510616784631,0.38928210313447925
09401,09,401,1995,1105,5,1100,812,288,0.5538847117794486,0.004524886877828055,0.995475113122172,0.7348416289592761,0.26063348416289595
09402,09,402,1704,939,5,934,766,168,0.551056338028169,0.005324813631522897,0.9946751863684771,0.8157614483493077,0.17891373801916932
09403,09,403,2173,1108,12,1096,730,366,0.509894155545329,0.010830324909747292,0.9891696750902527,0.6588447653429603,0.3303249097472924
09404,09,404,1574,935,18,917,735,182,0.5940279542566709,0.019251336898395723,0.9807486631016042,0.786096256684492,0.1946524064171123
09405,09,405,1865,1013,15,998,865,133,0.5431635388739946,0.014807502467917079,0.9851924975320829,0.8538993089832182,0.13129318854886476
09406,09,406,1896,984,24,960,567,393,0.5189873417721519,0.024390243902439025,0.975609756097561,0.5762195121951219,0.39939024390243905
09407,09,407,1487,806,22,784,432,352,0.5420309347679892,0.02729528535980149,0.9727047146401985,0.5359801488833746,0.43672456575682383
09408,09,408,1322,688,13,675,382,293,0.5204236006051437,0.0188953488372093,0.9811046511627907,0.5552325581395349,0.4258720930232558
09409,09,409,1694,739,11,728,423,305,0.436245572609209,0.014884979702300407,0.9851150202976996,0.5723951285520974,0.41271989174560214
09410,09,410,1536,728,18,710,481,229,0.4739583333333333,0.024725274725274724,0.9752747252747253,0.6607142857142857,0.31456043956043955
09411,09,411,1326,741,17,724,428,296,0.5588235294117647,0.022941970310391364,0.9770580296896086,0.5775978407557355,0.39946018893387314
09412,09,412,2251,1266,4,1262,789,473,0.5624167036872502,0.00315955766192733,0.9968404423380727,0.6232227488151659,0.3736176935229068
09413,09,413,1308,739,5,734,502,232,0.5649847094801224,0.006765899864682003,0.993234100135318,0.6792963464140731,0.31393775372124494
09414,09,414,1483,860,15,845,720,125,0.5799055967633177,0.01744186046511628,0.9825581395348837,0.8372093023255814,0.14534883720930233
09415,09,415,793,466,3,463,429,34,0.587641866330391,0.006437768240343348,0.9935622317596566,0.9206008583690987,0.07296137339055794
09416,09,416,827,517,2,515,414,101,0.6251511487303507,0.0038684719535783366,0.9961315280464217,0.8007736943907157,0.195357833655706
09417,09,417,389,213,3,210,161,49,0.5475578406169666,0.014084507042253521,0.9859154929577465,0.755868544600939,0.2300469483568075
09418,09,418,2455,1308,23,1285,685,600,0.5327902240325866,0.017584097859327217,0.9824159021406728,0.5237003058103975,0.45871559633027525
09419,09,419,1537,850,21,829,486,343,0.5530253741054001,0.024705882352941175,0.9752941176470589,0.571764705882353,0.40352941176470586
09420,09,420,1153,570,10,560,352,208,0.4943625325238508,0.017543859649122806,0.9824561403508771,0.6175438596491228,0.3649122807017544
09421,09,421,1856,1006,17,989,551,438,0.5420258620689655,0.016898608349900597,0.9831013916500994,0.547713717693837,0.43538767395626243
09422,09,422,1774,892,20,872,514,358,0.5028184892897407,0.02242152466367713,0.9775784753363229,0.5762331838565022,0.4013452914798206
09501,09,501,1521,797,16,781,456,325,0.5239973701512163,0.020075282308657464,0.9799247176913425,0.5721455457967378,0.4077791718946048
09502,09,502,2113,1084,17,1067,652,415,0.5130146710837672,0.015682656826568265,0.9843173431734318,0.6014760147601476,0.3828413284132841
09503,09,503,1228,666,7,659,384,275,0.5423452768729642,0.010510510510510511,0.9894894894894894,0.5765765765765766,0.41291291291291293
09504,09,504,1837,1007,20,987,539,448,0.54817637452368,0.019860973187686197,0.9801390268123138,0.535253227408143,0.4448857994041708
09505,09,505,1201,716,16,700,406,294,0.5961698584512906,0.0223463687150838,0.9776536312849162,0.5670391061452514,0.4106145251396648
09506,09,506,1291,665,17,648,422,226,0.5151045701006971,0.02556390977443609,0.9744360902255639,0.6345864661654136,0.3398496240601504
09507,09,507,885,470,16,454,287,167,0.5310734463276836,0.03404255319148936,0.9659574468085106,0.6106382978723405,0.3553191489361702
09508,09,508,1408,677,16,661,443,218,0.48082386363636365,0.023633677991137372,0.9763663220088626,0.654357459379616,0.32200886262924666
09509,09,509,1572,822,26,796,518,278,0.5229007633587787,0.031630170316301706,0.9683698296836983,0.6301703163017032,0.3381995133819951
09510,09,510,1334,639,10,629,403,226,0.4790104947526237,0.01564945226917058,0.9843505477308294,0.6306729264475743,0.3536776212832551
09511,09,511,1601,918,11,907,581,326,0.5733916302311055,0.011982570806100218,0.9880174291938998,0.6328976034858388,0.355119825708061
09512,09,512,2165,1095,20,1075,694,381,0.5057736720554272,0.0182648401826484,0.9817351598173516,0.6337899543378995,0.34794520547945207
09513,09,513,2096,1045,27,1018,642,376,0.4985687022900763,0.02583732057416268,0.9741626794258373,0.614354066985646,0.3598086124401914
09514,09,514,2122,1125,20,1105,667,438,0.5301602262016966,0.017777777777777778,0.9822222222222222,0.5928888888888889,0.3893333333333333
09515,09,515,1998,1123,17,1106,703,403,0.5620620620620621,0.015138023152270703,0.9848619768477292,0.6260017809439002,0.358860195903829
09516,09,516,1979,1112,18,1094,921,173,0.561899949469429,0.01618705035971223,0.9838129496402878,0.8282374100719424,0.15557553956834533
09517,09,517,1996,1240,13,1227,1031,196,0.6212424849699398,0.010483870967741936,0.989516129032258,0.8314516129032258,0.15806451612903225
09518,09,518,1567,877,2,875,750,125,0.5596681557115507,0.002280501710376283,0.9977194982896237,0.855188141391106,0.14253135689851767
09601,09,601,1992,1044,38,1006,615,391,0.5240963855421686,0.03639846743295019,0.9636015325670498,0.5890804597701149,0.37452107279693486
09602,09,602,1495,852,25,827,514,313,0.5698996655518395,0.029342723004694836,0.9706572769953051,0.6032863849765259,0.3673708920187793
09603,09,603,1497,871,23,848,519,329,0.5818303273213092,0.02640642939150402,0.9735935706084959,0.5958668197474167,0.3777267508610792
09604,09,604,2026,1201,30,1171,762,409,0.5927936821322803,0.02497918401332223,0.9750208159866778,0.6344712739383847,0.3405495420482931
09605,09,605,2160,1175,22,1153,727,426,0.5439814814814815,0.01872340425531915,0.9812765957446808,0.6187234042553191,0.3625531914893617
09606,09,606,1952,1119,19,1100,683,417,0.5732581967213115,0.016979445933869526,0.9830205540661304,0.610366398570152,0.3726541554959786
09607,09,607,1615,876,18,858,552,306,0.5424148606811146,0.02054794520547945,0.9794520547945206,0.6301369863013698,0.3493150684931507
09608,09,608,2289,1122,35,1087,680,407,0.49017038007863695,0.031194295900178252,0.9688057040998217,0.6060606060606061,0.3627450980392157
09609,09,609,1618,894,7,887,501,386,0.5525339925834364,0.007829977628635347,0.9921700223713646,0.5604026845637584,0.4317673378076063
09610,09,610,1365,839,20,819,450,369,0.6146520146520147,0.023837902264600714,0.9761620977353993,0.5363528009535161,0.4398092967818832
09611,09,611,1711,970,26,944,529,415,0.5669199298655757,0.026804123711340205,0.9731958762886598,0.545360824742268,0.42783505154639173
09612,09,612,2144,1267,53,1214,644,570,0.5909514925373134,0.041831097079715863,0.9581689029202841,0.5082872928176796,0.4498816101026046
09613,09,613,1303,641,22,619,335,284,0.49194167306216424,0.0343213728549142,0.9656786271450858,0.5226209048361935,0.44305772230889234
09614,09,614,2651,1444,33,1411,805,606,0.5447001131648435,0.022853185595567867,0.9771468144044322,0.5574792243767313,0.4196675900277008
09615,09,615,1219,622,6,616,443,173,0.5102543068088597,0.00964630225080386,0.9903536977491961,0.7122186495176849,0.27813504823151125
09616,09,616,1558,843,10,833,568,265,0.5410783055198973,0.011862396204033215,0.9881376037959668,0.6737841043890866,0.3143534994068802
09617,09,617,1893,1110,17,1093,861,232,0.5863708399366085,0.015315315315315315,0.9846846846846847,0.7756756756756756,0.209009009009009
09618,09,618,1491,829,11,818,599,219,0.5560026827632462,0.013268998793727383,0.9867310012062727,0.7225572979493365,0.26417370325693607
09619,09,619,1379,834,10,824,670,154,0.6047860768672951,0.011990407673860911,0.988009592326139,0.8033573141486811,0.18465227817745802
10101,10,101,1808,805,14,791,461,330,0.4452433628318584,0.017391304347826087,0.9826086956521739,0.5726708074534161,0.40993788819875776
10102,10,102,1067,549,16,533,283,250,0.514526710402999,0.029143897996357013,0.970856102003643,0.5154826958105647,0.4553734061930783
10103,10,103,1235,506,13,493,288,205,0.4097165991902834,0.025691699604743084,0.974308300395257,0.5691699604743083,0.4051383399209486
10104,10,104,1384,698,16,682,369,313,0.5043352601156069,0.022922636103151862,0.9770773638968482,0.5286532951289399,0.4484240687679083
10105,10,105,1316,627,15,612,335,277,0.4764437689969605,0.023923444976076555,0.9760765550239234,0.5342902711323764,0.44178628389154706
10106,10,106,1309,632,14,618,388,230,0.4828113063407181,0.022151898734177215,0.9778481012658228,0.6139240506329114,0.3639240506329114
10107,10,107,1656,808,18,790,470,320,0.48792270531400966,0.022277227722772276,0.9777227722772277,0.5816831683168316,0.39603960396039606
10108,10,108,1664,701,20,681,412,269,0.42127403846153844,0.028530670470756064,0.9714693295292439,0.5877318116975749,0.38373751783166904
10109,10,109,1674,698,14,684,423,261,0.4169653524492234,0.02005730659025788,0.9799426934097422,0.6060171919770774,0.37392550143266473
10110,10,110,1750,822,16,806,481,325,0.4697142857142857,0.019464720194647202,0.9805352798053528,0.5851581508515815,0.3953771289537713
10111,10,111,1979,943,25,918,537,381,0.4765032844871147,0.026511134676564158,0.9734888653234358,0.5694591728525981,0.40402969247083775
10112,10,112,1633,795,18,777,484,293,0.48683404776484995,0.022641509433962263,0.9773584905660377,0.6088050314465409,0.36855345911949683
10113,10,113,1737,772,22,750,450,300,0.4444444444444444,0.02849740932642487,0.9715025906735751,0.582901554404145,0.38860103626943004
10114,10,114,1934,876,25,851,439,412,0.452947259565667,0.028538812785388126,0.9714611872146118,0.5011415525114156,0.4703196347031963
10115,10,115,2106,1152,19,1133,568,565,0.5470085470085471,0.016493055555555556,0.9835069444444444,0.4930555555555556,0.4904513888888889
10116,10,116,1686,717,19,698,424,274,0.42526690391459077,0.026499302649930265,0.9735006973500697,0.5913528591352859,0.3821478382147838
10117,10,117,1826,937,22,915,554,361,0.5131434830230011,0.023479188900747065,0.9765208110992529,0.5912486659551761,0.3852721451440768
10118,10,118,1466,676,12,664,405,259,0.461118690313779,0.01775147928994083,0.9822485207100592,0.599112426035503,0.3831360946745562
10119,10,119,1565,755,16,739,408,331,0.48242811501597443,0.02119205298013245,0.9788079470198675,0.5403973509933775,0.4384105960264901
10120,10,120,1378,607,18,589,357,232,0.4404934687953556,0.029654036243822075,0.9703459637561779,0.5881383855024712,0.38220757825370677
10201,10,201,1839,921,15,906,498,408,0.5008156606851549,0.016286644951140065,0.9837133550488599,0.5407166123778502,0.44299674267100975
10202,10,202,1880,848,4,844,472,372,0.451063829787234,0.0047169811320754715,0.9952830188679245,0.5566037735849056,0.4386792452830189
10203,10,203,2004,945,29,916,507,409,0.47155688622754494,0.030687830687830688,0.9693121693121693,0.5365079365079365,0.4328042328042328
10204,10,204,2117,1049,42,1007,509,498,0.4955125177137459,0.04003813155386082,0.9599618684461392,0.4852240228789323,0.4747378455672069
10205,10,205,1952,867,18,849,493,356,0.44415983606557374,0.020761245674740483,0.9792387543252595,0.5686274509803921,0.41061130334486734
10206,10,206,1669,720,12,708,408,300,0.4313960455362493,0.016666666666666666,0.9833333333333333,0.5666666666666667,0.4166666666666667
10207,10,207,1703,881,8,873,469,404,0.5173223722842043,0.009080590238365494,0.9909194097616345,0.5323496027241771,0.4585698070374574
10208,10,208,1781,885,16,869,481,388,0.49691184727681076,0.01807909604519774,0.9819209039548022,0.5435028248587571,0.4384180790960452
10209,10,209,1690,817,10,807,447,360,0.4834319526627219,0.012239902080783354,0.9877600979192166,0.5471236230110159,0.44063647490820074
10210,10,210,1927,901,22,879,471,408,0.46756616502335235,0.0244173140954495,0.9755826859045506,0.5227524972253053,0.4528301886792453
10211,10,211,1418,679,22,657,371,286,0.4788434414668547,0.03240058910162003,0.96759941089838,0.5463917525773195,0.4212076583210604
10212,10,212,1520,770,16,754,346,408,0.506578947368421,0.02077922077922078,0.9792207792207792,0.44935064935064933,0.5298701298701298
10213,10,213,1849,878,10,868,517,351,0.4748512709572742,0.011389521640091117,0.9886104783599089,0.5888382687927107,0.39977220956719817
10214,10,214,1702,930,21,909,434,475,0.5464159811985899,0.02258064516129032,0.9774193548387097,0.4666666666666667,0.510752688172043
10215,10,215,1635,870,25,845,456,389,0.5321100917431193,0.028735632183908046,0.9712643678160919,0.5241379310344828,0.4471264367816092
10216,10,216,1932,1037,24,1013,505,508,0.5367494824016563,0.023143683702989394,0.9768563162970106,0.4869816779170685,0.48987463837994216
10217,10,217,1597,730,8,722,438,284,0.4571070757670632,0.010958904109589041,0.989041095890411,0.6,0.38904109589041097
10218,10,218,1431,751,22,729,376,353,0.5248078266946191,0.02929427430093209,0.9707057256990679,0.5006657789613849,0.47003994673768307
10219,10,219,1283,564,15,549,319,230,0.4395946999220577,0.026595744680851064,0.973404255319149,0.5656028368794326,0.4078014184397163
10220,10,220,1489,779,28,751,406,345,0.5231699126930826,0.03594351732991014,0.9640564826700898,0.521181001283697,0.4428754813863928
10301,10,301,1924,1094,30,1064,563,501,0.5686070686070686,0.027422303473491772,0.9725776965265083,0.5146252285191956,0.4579524680073126
10302,10,302,1656,720,17,703,433,270,0.43478260869565216,0.02361111111111111,0.9763888888888889,0.6013888888888889,0.375
10303,10,303,1291,571,19,552,361,191,0.44229279628195195,0.03327495621716287,0.9667250437828371,0.6322241681260946,0.3345008756567426
10304,10,304,1427,574,6,568,351,217,0.4022424667133847,0.010452961672473868,0.9895470383275261,0.6114982578397212,0.3780487804878049
10305,10,305,1706,776,3,773,509,264,0.4548651817116061,0.003865979381443299,0.9961340206185567,0.6559278350515464,0.3402061855670103
10306,10,306,2105,1003,28,975,588,387,0.47648456057007127,0.027916251246261216,0.9720837487537388,0.5862412761714856,0.38584247258225324
10307,10,307,1968,924,24,900,571,329,0.4695121951219512,0.025974025974025976,0.974025974025974,0.6179653679653679,0.3560606060606061
10308,10,308,1435,710,18,692,404,288,0.49477351916376305,0.02535211267605634,0.9746478873239437,0.5690140845070423,0.4056338028169014
10309,10,309,2063,933,11,922,562,360,0.45225399903053803,0.011789924973204717,0.9882100750267953,0.602357984994641,0.3858520900321543
10310,10,310,1472,759,17,742,452,290,0.515625,0.022397891963109356,0.9776021080368906,0.5955204216073782,0.3820816864295125
10311,10,311,1413,648,13,635,493,142,0.4585987261146497,0.020061728395061727,0.9799382716049383,0.7608024691358025,0.2191358024691358
10312,10,312,1044,454,13,441,290,151,0.43486590038314177,0.028634361233480177,0.9713656387665198,0.6387665198237885,0.33259911894273125
10313,10,313,1483,540,13,527,363,164,0.3641267700606878,0.024074074074074074,0.975925925925926,0.6722222222222223,0.3037037037037037
10314,10,314,1513,730,20,710,407,303,0.48248512888301387,0.0273972602739726,0.9726027397260274,0.5575342465753425,0.41506849315068495
10315,10,315,1921,746,14,732,479,253,0.38833940655908383,0.01876675603217158,0.9812332439678284,0.6420911528150134,0.339142091152815
10316,10,316,1674,765,9,756,430,326,0.45698924731182794,0.011764705882352941,0.9882352941176471,0.5620915032679739,0.4261437908496732
10317,10,317,1821,867,19,848,511,337,0.47611202635914335,0.02191464821222607,0.9780853517877739,0.5893886966551326,0.3886966551326413
10318,10,318,1750,827,12,815,506,309,0.4725714285714286,0.014510278113663845,0.9854897218863361,0.6118500604594922,0.373639661426844
10319,10,319,1966,974,16,958,576,382,0.49542217700915564,0.01642710472279261,0.9835728952772074,0.5913757700205339,0.3921971252566735
10320,10,320,1724,902,19,883,549,334,0.5232018561484919,0.02106430155210643,0.9789356984478935,0.6086474501108647,0.37028824833702884
10401,10,401,2006,975,29,946,520,426,0.4860418743768694,0.029743589743589743,0.9702564102564103,0.5333333333333333,0.4369230769230769
10402,10,402,1938,1013,26,987,554,433,0.522703818369453,0.02566633761105627,0.9743336623889437,0.5468904244817374,0.42744323790720634
10403,10,403,1694,817,14,803,428,375,0.4822904368358914,0.017135862913096694,0.9828641370869033,0.5238678090575275,0.4589963280293758
10404,10,404,2125,936,25,911,474,437,0.4404705882352941,0.026709401709401708,0.9732905982905983,0.5064102564102564,0.4668803418803419
10405,10,405,1996,1047,30,1017,577,440,0.5245490981963928,0.02865329512893983,0.9713467048710601,0.5510983763132761,0.42024832855778416
10406,10,406,2050,1028,38,990,506,484,0.5014634146341463,0.03696498054474708,0.9630350194552529,0.49221789883268485,0.4708171206225681
10407,10,407,1921,1040,30,1010,443,567,0.5413846954711088,0.028846153846153848,0.9711538461538461,0.42596153846153845,0.5451923076923076
10408,10,408,1704,903,18,885,405,480,0.5299295774647887,0.019933554817275746,0.9800664451827242,0.4485049833887043,0.53156146179402
10409,10,409,1762,829,11,818,422,396,0.47048808172531215,0.013268998793727383,0.9867310012062727,0.5090470446320868,0.4776839565741858
10410,10,410,1376,602,24,578,327,251,0.4375,0.03986710963455149,0.9601328903654485,0.5431893687707641,0.4169435215946844
10411,10,411,1396,818,17,801,367,434,0.5859598853868195,0.02078239608801956,0.9792176039119804,0.44865525672371637,0.530562347188264
10412,10,412,1607,750,25,725,401,324,0.46670815183571873,0.03333333333333333,0.9666666666666667,0.5346666666666666,0.432
10413,10,413,1840,955,19,936,443,493,0.5190217391304348,0.019895287958115182,0.9801047120418848,0.4638743455497382,0.5162303664921466
10414,10,414,1881,1006,16,990,453,537,0.5348219032429559,0.015904572564612324,0.9840954274353877,0.45029821073558646,0.5337972166998012
10415,10,415,2182,1128,22,1106,545,561,0.5169569202566453,0.01950354609929078,0.9804964539007093,0.48315602836879434,0.4973404255319149
10416,10,416,1734,888,10,878,403,475,0.5121107266435986,0.01126126126126126,0.9887387387387387,0.45382882882882886,0.5349099099099099
10417,10,417,1912,1128,19,1109,553,556,0.5899581589958159,0.016843971631205674,0.9831560283687943,0.49024822695035464,0.4929078014184397
10418,10,418,1242,772,18,754,368,386,0.6215780998389694,0.023316062176165803,0.9766839378238342,0.47668393782383417,0.5
10419,10,419,1585,912,16,896,436,460,0.5753943217665615,0.017543859649122806,0.9824561403508771,0.4780701754385965,0.5043859649122807
10501,10,501,1979,1105,33,1072,543,529,0.5583628094997474,0.02986425339366516,0.9701357466063348,0.49140271493212667,0.47873303167420816
10502,10,502,2075,1115,20,1095,580,515,0.5373493975903615,0.017937219730941704,0.9820627802690582,0.5201793721973094,0.4618834080717489
10503,10,503,2077,1249,20,1229,588,641,0.6013480982185845,0.016012810248198558,0.9839871897518014,0.4707766212970376,0.5132105684547638
10504,10,504,2152,1230,21,1209,615,594,0.5715613382899628,0.01707317073170732,0.9829268292682927,0.5,0.48292682926829267
10505,10,505,1975,1059,19,1040,573,467,0.5362025316455696,0.01794145420207743,0.9820585457979226,0.5410764872521246,0.4409820585457979
10506,10,506,1874,1084,12,1072,571,501,0.5784418356456777,0.01107011070110701,0.988929889298893,0.5267527675276753,0.4621771217712177
10507,10,507,1768,1072,30,1042,504,538,0.6063348416289592,0.027985074626865673,0.9720149253731343,0.4701492537313433,0.5018656716417911
10508,10,508,1671,941,11,930,450,480,0.5631358467983244,0.011689691817215728,0.9883103081827843,0.4782146652497343,0.51009564293305
10509,10,509,1647,907,14,893,422,471,0.5506982392228293,0.015435501653803748,0.9845644983461963,0.4652701212789416,0.5192943770672547
10510,10,510,2051,1173,18,1155,551,604,0.5719161384690395,0.015345268542199489,0.9846547314578005,0.4697357203751066,0.514919011082694
10511,10,511,2068,1108,30,1078,492,586,0.5357833655705996,0.02707581227436823,0.9729241877256317,0.44404332129963897,0.5288808664259927
10512,10,512,1746,1007,27,980,472,508,0.5767468499427262,0.026812313803376366,0.9731876861966237,0.46871896722939427,0.5044687189672294
10513,10,513,1677,957,15,942,420,522,0.5706618962432916,0.01567398119122257,0.9843260188087775,0.438871473354232,0.5454545454545454
10514,10,514,2112,1232,19,1213,553,660,0.5833333333333334,0.015422077922077922,0.984577922077922,0.44886363636363635,0.5357142857142857
10515,10,515,2007,1102,11,1091,490,601,0.5490782262082711,0.009981851179673321,0.9900181488203267,0.44464609800362975,0.5453720508166969
10516,10,516,2104,1293,15,1278,572,706,0.6145437262357415,0.01160092807424594,0.988399071925754,0.4423820572312452,0.5460170146945089
10517,10,517,2083,1111,23,1088,464,624,0.5333653384541527,0.020702070207020702,0.9792979297929792,0.41764176417641763,0.5616561656165616
10601,10,601,1679,811,16,795,505,290,0.48302561048243003,0.01972872996300863,0.9802712700369913,0.6226880394574599,0.35758323057953145
10602,10,602,1959,914,16,898,569,329,0.4665645737621235,0.0175054704595186,0.9824945295404814,0.6225382932166302,0.3599562363238512
10603,10,603,1937,953,17,936,585,351,0.49199793495095506,0.017838405036726127,0.9821615949632738,0.6138509968520461,0.3683105981112277
10604,10,604,1547,839,12,827,463,364,0.5423400129282482,0.014302741358760428,0.9856972586412396,0.5518474374255066,0.433849821215733
10605,10,605,1185,578,21,557,316,241,0.4877637130801688,0.03633217993079585,0.9636678200692042,0.5467128027681661,0.41695501730103807
10606,10,606,2001,1033,19,1014,554,460,0.5162418790604698,0.018393030009680542,0.9816069699903195,0.5363020329138432,0.4453049370764763
10607,10,607,2065,1007,24,983,590,393,0.48765133171912833,0.023833167825223437,0.9761668321747765,0.5858987090367428,0.3902681231380338
10608,10,608,1666,773,20,753,451,302,0.4639855942376951,0.0258732212160414,0.9741267787839586,0.5834411384217335,0.3906856403622251
10609,10,609,1609,840,20,820,456,364,0.5220633934120572,0.023809523809523808,0.9761904761904762,0.5428571428571428,0.43333333333333335
10610,10,610,1914,1031,23,1008,540,468,0.5386624869383491,0.02230843840931135,0.9776915615906887,0.5237633365664404,0.4539282250242483
10611,10,611,1865,911,16,895,486,409,0.48847184986595177,0.01756311745334797,0.9824368825466521,0.5334796926454446,0.4489571899012075
10612,10,612,1851,1048,17,1031,535,496,0.5661804430037818,0.016221374045801526,0.9837786259541985,0.5104961832061069,0.4732824427480916
10613,10,613,1875,985,21,964,495,469,0.5253333333333333,0.02131979695431472,0.9786802030456853,0.5025380710659898,0.4761421319796954
10614,10,614,2009,1116,18,1098,515,583,0.5555002488800398,0.016129032258064516,0.9838709677419355,0.4614695340501792,0.5224014336917563
10615,10,615,1898,939,14,925,581,344,0.4947312961011591,0.014909478168264111,0.9850905218317358,0.6187433439829606,0.3663471778487753
10616,10,616,1918,909,28,881,534,347,0.47393117831074033,0.030803080308030802,0.9691969196919692,0.5874587458745875,0.38173817381738173
10617,10,617,1864,797,18,779,479,300,0.42757510729613735,0.02258469259723965,0.9774153074027604,0.6010037641154329,0.37641154328732745
10618,10,618,1855,790,23,767,472,295,0.42587601078167114,0.02911392405063291,0.970886075949367,0.5974683544303797,0.37341772151898733
11101,11,101,1079,571,10,561,198,363,0.5291936978683967,0.017513134851138354,0.9824868651488616,0.3467600700525394,0.6357267950963222
11102,11,102,1034,618,7,611,108,503,0.597678916827853,0.011326860841423949,0.988673139158576,0.17475728155339806,0.813915857605178
11103,11,103,1059,637,4,633,183,450,0.6015108593012276,0.006279434850863423,0.9937205651491365,0.28728414442700156,0.706436420722135
11104,11,104,1167,615,13,602,244,358,0.5269922879177378,0.02113821138211382,0.9788617886178862,0.3967479674796748,0.5821138211382114
11105,11,105,983,571,6,565,122,443,0.5808748728382502,0.010507880910683012,0.989492119089317,0.2136602451838879,0.7758318739054291
11106,11,106,1093,571,10,561,290,271,0.5224153705397987,0.017513134851138354,0.9824868651488616,0.5078809106830122,0.4746059544658494
11107,11,107,894,388,11,377,182,195,0.43400447427293065,0.028350515463917526,0.9716494845360825,0.4690721649484536,0.5025773195876289
11108,11,108,1055,472,10,462,227,235,0.44739336492890996,0.0211864406779661,0.9788135593220338,0.4809322033898305,0.4978813559322034
11109,11,109,1067,548,1,547,287,260,0.5135895032802249,0.0018248175182481751,0.9981751824817519,0.5237226277372263,0.4744525547445255
11110,11,110,1137,499,1,498,230,268,0.4388742304309587,0.002004008016032064,0.9979959919839679,0.46092184368737477,0.5370741482965932
11111,11,111,999,533,4,529,210,319,0.5335335335335335,0.0075046904315197,0.9924953095684803,0.39399624765478425,0.5984990619136961
11112,11,112,1236,564,7,557,314,243,0.4563106796116505,0.012411347517730497,0.9875886524822695,0.5567375886524822,0.4308510638297872
11113,11,113,893,411,4,407,205,202,0.46024636058230683,0.009732360097323601,0.9902676399026764,0.49878345498783455,0.49148418491484186
11114,11,114,998,502,7,495,252,243,0.503006012024048,0.013944223107569721,0.9860557768924303,0.50199203187251,0.48406374501992033
11115,11,115,914,463,9,454,203,251,0.5065645514223195,0.019438444924406047,0.980561555075594,0.43844492440604754,0.5421166306695464
11116,11,116,986,537,9,528,251,277,0.5446247464503042,0.01675977653631285,0.9832402234636871,0.46741154562383613,0.515828677839851
11117,11,117,1117,480,10,470,281,189,0.4297224709042077,0.020833333333333332,0.9791666666666666,0.5854166666666667,0.39375
11118,11,118,1044,492,29,463,240,223,0.47126436781609193,0.05894308943089431,0.9410569105691057,0.4878048780487805,0.4532520325203252
11119,11,119,1304,598,14,584,347,237,0.45858895705521474,0.023411371237458192,0.9765886287625418,0.580267558528428,0.3963210702341137
11120,11,120,1347,566,22,544,305,239,0.4201930215293244,0.038869257950530034,0.9611307420494699,0.5388692579505301,0.42226148409893993
11121,11,121,1066,507,7,500,294,206,0.47560975609756095,0.013806706114398421,0.9861932938856016,0.5798816568047337,0.40631163708086787
11122,11,122,1245,653,12,641,340,301,0.5244979919678715,0.018376722817764167,0.9816232771822359,0.5206738131699847,0.4609494640122512
11123,11,123,1223,644,4,640,289,351,0.526573998364677,0.006211180124223602,0.9937888198757764,0.44875776397515527,0.5450310559006211
11124,11,124,1050,489,10,479,266,213,0.4657142857142857,0.02044989775051125,0.9795501022494888,0.5439672801635992,0.43558282208588955
11125,11,125,1229,603,11,592,314,278,0.4906427990235964,0.01824212271973466,0.9817578772802653,0.5207296849087893,0.46102819237147596
11126,11,126,1175,542,14,528,291,237,0.46127659574468083,0.025830258302583026,0.974169741697417,0.5369003690036901,0.43726937269372695
11127,11,127,1211,634,14,620,284,336,0.523534269199009,0.022082018927444796,0.9779179810725552,0.4479495268138801,0.5299684542586751
11201,11,201,967,467,3,464,160,304,0.48293691830403307,0.006423982869379015,0.9935760171306209,0.3426124197002141,0.6509635974304069
11202,11,202,1273,675,23,652,294,358,0.5302435192458759,0.034074074074074076,0.965925925925926,0.43555555555555553,0.5303703703703704
11203,11,203,1244,632,7,625,284,341,0.5080385852090032,0.011075949367088608,0.9889240506329114,0.44936708860759494,0.5395569620253164
11204,11,204,1094,525,9,516,262,254,0.47989031078610606,0.017142857142857144,0.9828571428571429,0.4990476190476191,0.4838095238095238
11205,11,205,1146,552,3,549,282,267,0.4816753926701571,0.005434782608695652,0.9945652173913043,0.5108695652173914,0.483695652173913
11206,11,206,1138,552,12,540,288,252,0.4850615114235501,0.021739130434782608,0.9782608695652174,0.5217391304347826,0.45652173913043476
11207,11,207,1059,510,8,502,282,220,0.48158640226628896,0.01568627450980392,0.984313725490196,0.5529411764705883,0.43137254901960786
11208,11,208,878,391,2,389,227,162,0.44533029612756264,0.005115089514066497,0.9948849104859335,0.5805626598465473,0.4143222506393862
11209,11,209,960,476,10,466,267,199,0.49583333333333335,0.02100840336134454,0.9789915966386554,0.5609243697478992,0.4180672268907563
11210,11,210,1178,625,11,614,231,383,0.530560271646859,0.0176,0.9824,0.3696,0.6128
11211,11,211,1065,577,2,575,185,390,0.5417840375586854,0.0034662045060658577,0.9965337954939342,0.32062391681109187,0.6759098786828422
11212,11,212,1116,561,13,548,280,268,0.5026881720430108,0.023172905525846704,0.9768270944741533,0.49910873440285203,0.47771836007130125
11213,11,213,1377,752,12,740,358,382,0.5461147421931736,0.015957446808510637,0.9840425531914894,0.47606382978723405,0.5079787234042553
11214,11,214,915,497,2,495,243,252,0.5431693989071038,0.004024144869215292,0.9959758551307847,0.48893360160965793,0.5070422535211268
11215,11,215,988,447,8,439,239,200,0.4524291497975709,0.017897091722595078,0.9821029082774049,0.5346756152125279,0.44742729306487694
11216,11,216,1367,793,21,772,341,431,0.5801024140453548,0.02648171500630517,0.9735182849936949,0.4300126103404792,0.5435056746532156
11217,11,217,1184,621,14,607,288,319,0.5244932432432432,0.02254428341384863,0.9774557165861514,0.463768115942029,0.5136876006441223
11218,11,218,1635,799,12,787,420,367,0.4886850152905199,0.015018773466833541,0.9849812265331664,0.5256570713391739,0.4593241551939925
11219,11,219,993,535,4,531,228,303,0.5387713997985901,0.007476635514018692,0.9925233644859813,0.4261682242990654,0.5663551401869159
11220,11,220,1128,656,2,654,253,401,0.5815602836879432,0.003048780487804878,0.9969512195121951,0.3856707317073171,0.6112804878048781
11221,11,221,1193,678,8,670,356,314,0.5683151718357083,0.011799410029498525,0.9882005899705014,0.5250737463126843,0.4631268436578171
11222,11,222,1286,669,22,647,299,348,0.5202177293934681,0.03288490284005979,0.9671150971599403,0.4469357249626308,0.5201793721973094
11223,11,223,1157,611,29,582,308,274,0.5280898876404494,0.04746317512274959,0.9525368248772504,0.5040916530278232,0.44844517184942717
11224,11,224,1420,777,9,768,347,421,0.5471830985915493,0.011583011583011582,0.9884169884169884,0.4465894465894466,0.5418275418275418
11225,11,225,1218,636,23,613,330,283,0.5221674876847291,0.036163522012578615,0.9638364779874213,0.5188679245283019,0.4449685534591195
11226,11,226,1250,711,28,683,323,360,0.5688,0.03938115330520394,0.960618846694796,0.4542897327707454,0.5063291139240507
11227,11,227,1232,697,21,676,379,297,0.5657467532467533,0.03012912482065997,0.96987087517934,0.5437589670014347,0.4261119081779053
11228,11,228,1175,657,10,647,306,341,0.5591489361702128,0.015220700152207,0.984779299847793,0.4657534246575342,0.5190258751902588
11301,11,301,1165,594,26,568,308,260,0.5098712446351932,0.04377104377104377,0.9562289562289562,0.5185185185185185,0.4377104377104377
11302,11,302,917,525,10,515,255,260,0.5725190839694656,0.01904761904761905,0.9809523809523809,0.4857142857142857,0.49523809523809526
11303,11,303,1005,448,8,440,259,181,0.445771144278607,0.017857142857142856,0.9821428571428571,0.578125,0.40401785714285715
11304,11,304,1295,644,21,623,358,265,0.4972972972972973,0.03260869565217391,0.967391304347826,0.5559006211180124,0.4114906832298137
11305,11,305,1173,624,12,612,322,290,0.5319693094629157,0.019230769230769232,0.9807692307692307,0.5160256410256411,0.46474358974358976
11306,11,306,1430,679,11,668,384,284,0.47482517482517483,0.016200294550810016,0.9837997054491899,0.5655375552282769,0.4182621502209131
11307,11,307,1717,911,19,892,404,488,0.5305765870704717,0.020856201975850714,0.9791437980241493,0.4434687156970362,0.535675082327113
11308,11,308,1366,736,18,718,387,331,0.5387994143484627,0.024456521739130436,0.9755434782608695,0.5258152173913043,0.44972826086956524
11309,11,309,1225,604,14,590,356,234,0.4930612244897959,0.023178807947019868,0.9768211920529801,0.5894039735099338,0.38741721854304634
11310,11,310,1283,655,9,646,338,308,0.5105222135619641,0.013740458015267175,0.9862595419847329,0.516030534351145,0.47022900763358777
11311,11,311,1173,560,9,551,317,234,0.4774083546462063,0.01607142857142857,0.9839285714285714,0.5660714285714286,0.41785714285714287
11312,11,312,1064,474,3,471,230,241,0.44548872180451127,0.006329113924050633,0.9936708860759493,0.48523206751054854,0.5084388185654009
11313,11,313,1332,732,7,725,399,326,0.5495495495495496,0.009562841530054645,0.9904371584699454,0.5450819672131147,0.4453551912568306
11314,11,314,1258,659,20,639,365,274,0.5238473767885533,0.030349013657056147,0.9696509863429439,0.5538694992412747,0.4157814871016692
11315,11,315,1207,741,9,732,368,364,0.6139188069594035,0.012145748987854251,0.9878542510121457,0.4966261808367072,0.49122807017543857
11316,11,316,1106,544,11,533,279,254,0.4918625678119349,0.02022058823529412,0.9797794117647058,0.5128676470588235,0.46691176470588236
11317,11,317,799,442,11,431,229,202,0.5531914893617021,0.024886877828054297,0.9751131221719457,0.5180995475113123,0.45701357466063347
11318,11,318,1312,671,12,659,355,304,0.5114329268292683,0.01788375558867362,0.9821162444113264,0.5290611028315947,0.45305514157973176
11319,11,319,1085,482,13,469,255,214,0.44423963133640554,0.026970954356846474,0.9730290456431535,0.529045643153527,0.44398340248962653
11320,11,320,1034,470,12,458,228,230,0.45454545454545453,0.02553191489361702,0.9744680851063829,0.4851063829787234,0.48936170212765956
11321,11,321,1052,488,10,478,257,221,0.46387832699619774,0.020491803278688523,0.9795081967213115,0.5266393442622951,0.45286885245901637
11322,11,322,1180,590,14,576,312,264,0.5,0.023728813559322035,0.976271186440678,0.5288135593220339,0.44745762711864406
11323,11,323,1301,640,14,626,334,292,0.49192928516525747,0.021875,0.978125,0.521875,0.45625
11324,11,324,975,467,14,453,256,197,0.47897435897435897,0.029978586723768737,0.9700214132762313,0.5481798715203426,0.42184154175588867
11325,11,325,1305,582,13,569,311,258,0.4459770114942529,0.022336769759450172,0.9776632302405498,0.5343642611683849,0.44329896907216493
11326,11,326,1728,671,15,656,305,351,0.3883101851851852,0.022354694485842028,0.977645305514158,0.45454545454545453,0.5230998509687034
11327,11,327,1218,608,31,577,306,271,0.49917898193760263,0.05098684210526316,0.9490131578947368,0.5032894736842105,0.4457236842105263
11328,11,328,1329,743,19,724,362,362,0.5590669676448458,0.02557200538358008,0.9744279946164199,0.48721399730820997,0.48721399730820997
11329,11,329,1293,621,17,604,304,300,0.4802784222737819,0.027375201288244767,0.9726247987117552,0.4895330112721417,0.4830917874396135
11401,11,401,1200,575,25,550,291,259,0.4791666666666667,0.043478260869565216,0.9565217391304348,0.5060869565217392,0.4504347826086956
11402,11,402,1231,680,15,665,336,329,0.5523964256701869,0.022058823529411766,0.9779411764705882,0.49411764705882355,0.4838235294117647
11403,11,403,1341,659,8,651,331,320,0.49142431021625654,0.012139605462822459,0.9878603945371776,0.5022761760242792,0.48558421851289835
11404,11,404,1019,556,14,542,256,286,0.5456329735034348,0.025179856115107913,0.9748201438848921,0.460431654676259,0.5143884892086331
11405,11,405,1171,548,8,540,296,244,0.46797608881298036,0.014598540145985401,0.9854014598540146,0.5401459854014599,0.44525547445255476
11406,11,406,1307,663,16,647,325,322,0.5072685539403213,0.024132730015082957,0.975867269984917,0.49019607843137253,0.4856711915535445
11407,11,407,1341,715,26,689,334,355,0.5331841909023117,0.03636363636363636,0.9636363636363636,0.4671328671328671,0.4965034965034965
11408,11,408,1307,591,26,565,273,292,0.4521805661820964,0.043993231810490696,0.9560067681895094,0.4619289340101523,0.494077834179357
11409,11,409,1196,593,11,582,318,264,0.49581939799331104,0.01854974704890388,0.9814502529510961,0.5362563237774031,0.4451939291736931
11410,11,410,1254,608,22,586,317,269,0.48484848484848486,0.03618421052631579,0.9638157894736842,0.5213815789473685,0.44243421052631576
11411,11,411,1544,710,17,693,333,360,0.45984455958549225,0.023943661971830985,0.976056338028169,0.46901408450704224,0.5070422535211268
11412,11,412,957,473,11,462,209,253,0.4942528735632184,0.023255813953488372,0.9767441860465116,0.4418604651162791,0.5348837209302325
11413,11,413,1498,749,17,732,389,343,0.5,0.022696929238985315,0.9773030707610146,0.5193591455273698,0.45794392523364486
11414,11,414,1221,577,9,568,272,296,0.4725634725634726,0.01559792027729636,0.9844020797227037,0.4714038128249567,0.512998266897747
11415,11,415,1312,716,35,681,341,340,0.5457317073170732,0.04888268156424581,0.9511173184357542,0.4762569832402235,0.4748603351955307
11416,11,416,1345,707,22,685,342,343,0.5256505576208178,0.031117397454031116,0.9688826025459689,0.4837340876944837,0.48514851485148514
11417,11,417,1334,654,20,634,335,299,0.49025487256371814,0.03058103975535168,0.9694189602446484,0.5122324159021406,0.45718654434250766
11418,11,418,1256,647,12,635,350,285,0.5151273885350318,0.01854714064914992,0.98145285935085,0.5409582689335394,0.44049459041731065
11419,11,419,1263,636,11,625,328,297,0.503562945368171,0.01729559748427673,0.9827044025157232,0.5157232704402516,0.4669811320754717
11420,11,420,1521,785,26,759,361,398,0.5161078238001315,0.033121019108280254,0.9668789808917198,0.45987261146496816,0.5070063694267516
11421,11,421,1206,566,27,539,287,252,0.4693200663349917,0.04770318021201413,0.9522968197879859,0.5070671378091873,0.4452296819787986
11422,11,422,1300,661,14,647,354,293,0.5084615384615384,0.02118003025718608,0.9788199697428139,0.5355521936459909,0.443267776096823
11423,11,423,1403,712,18,694,374,320,0.5074839629365645,0.025280898876404494,0.9747191011235955,0.5252808988764045,0.449438202247191
11424,11,424,1130,556,14,542,312,230,0.4920353982300885,0.025179856115107913,0.9748201438848921,0.5611510791366906,0.4136690647482014
11425,11,425,1219,656,12,644,295,349,0.5381460213289582,0.018292682926829267,0.9817073170731707,0.4496951219512195,0.5320121951219512
11426,11,426,970,486,6,480,250,230,0.5010309278350515,0.012345679012345678,0.9876543209876543,0.51440329218107,0.4732510288065844
11427,11,427,1160,600,11,589,297,292,0.5172413793103449,0.018333333333333333,0.9816666666666667,0.495,0.4866666666666667
11428,11,428,975,534,12,522,280,242,0.5476923076923077,0.02247191011235955,0.9775280898876404,0.5243445692883895,0.45318352059925093
11501,11,501,1303,541,8,533,276,257,0.4151957022256332,0.014787430683918669,0.9852125693160814,0.5101663585951941,0.47504621072088726
11502,11,502,1573,787,18,769,459,310,0.5003178639542276,0.022871664548919948,0.97712833545108,0.5832274459974587,0.39390088945362134
11503,11,503,1343,700,16,684,413,271,0.5212211466865228,0.022857142857142857,0.9771428571428571,0.59,0.3871428571428571
11504,11,504,1057,471,11,460,247,213,0.445600756859035,0.02335456475583864,0.9766454352441614,0.524416135881104,0.45222929936305734
11505,11,505,1067,547,8,539,311,228,0.5126522961574508,0.014625228519195612,0.9853747714808044,0.5685557586837294,0.41681901279707495
11506,11,506,1126,546,11,535,301,234,0.4849023090586146,0.020146520146520148,0.9798534798534798,0.5512820512820513,0.42857142857142855
11507,11,507,958,496,19,477,287,190,0.5177453027139874,0.038306451612903226,0.9616935483870968,0.5786290322580645,0.38306451612903225
11508,11,508,1430,748,15,733,400,333,0.5230769230769231,0.020053475935828877,0.9799465240641712,0.5347593582887701,0.4451871657754011
11509,11,509,1459,737,18,719,375,344,0.5051405071967101,0.024423337856173677,0.9755766621438263,0.508819538670285,0.46675712347354137
11510,11,510,1267,646,13,633,333,300,0.5098658247829518,0.020123839009287926,0.9798761609907121,0.5154798761609907,0.46439628482972134
11511,11,511,1064,568,11,557,312,245,0.5338345864661654,0.01936619718309859,0.9806338028169014,0.5492957746478874,0.43133802816901406
11512,11,512,1242,666,9,657,327,330,0.5362318840579711,0.013513513513513514,0.9864864864864865,0.49099099099099097,0.4954954954954955
11513,11,513,1216,567,12,555,291,264,0.4662828947368421,0.021164021164021163,0.9788359788359788,0.5132275132275133,0.4656084656084656
11514,11,514,1298,582,7,575,307,268,0.44838212634822805,0.012027491408934709,0.9879725085910653,0.5274914089347079,0.46048109965635736
11515,11,515,1125,579,15,564,321,243,0.5146666666666667,0.025906735751295335,0.9740932642487047,0.5544041450777202,0.41968911917098445
11516,11,516,1090,564,12,552,290,262,0.5174311926605505,0.02127659574468085,0.9787234042553191,0.5141843971631206,0.4645390070921986
11517,11,517,1063,580,14,566,287,279,0.5456255879586077,0.02413793103448276,0.9758620689655172,0.49482758620689654,0.4810344827586207
11518,11,518,1259,593,22,571,315,256,0.4710087370929309,0.03709949409780776,0.9629005059021922,0.5311973018549747,0.4317032040472175
11519,11,519,1476,838,25,813,308,505,0.5677506775067751,0.029832935560859187,0.9701670644391408,0.36754176610978523,0.6026252983293556
11520,11,520,1264,744,22,722,284,438,0.5886075949367089,0.02956989247311828,0.9704301075268817,0.3817204301075269,0.5887096774193549
11521,11,521,1345,694,29,665,298,367,0.5159851301115241,0.04178674351585014,0.9582132564841499,0.42939481268011526,0.5288184438040345
11522,11,522,1051,571,15,556,257,299,0.5432921027592769,0.02626970227670753,0.9737302977232924,0.4500875656742557,0.5236427320490368
11523,11,523,1325,694,5,689,339,350,0.5237735849056604,0.007204610951008645,0.9927953890489913,0.4884726224783862,0.5043227665706052
11524,11,524,1269,650,14,636,346,290,0.512214342001576,0.021538461538461538,0.9784615384615385,0.5323076923076923,0.4461538461538462
11525,11,525,1269,629,22,607,328,279,0.49566587864460204,0.034976152623211444,0.9650238473767886,0.5214626391096979,0.4435612082670906
11526,11,526,1286,678,20,658,294,364,0.5272161741835147,0.029498525073746312,0.9705014749262537,0.4336283185840708,0.5368731563421829
11527,11,527,1139,583,13,570,275,295,0.5118525021949079,0.022298456260720412,0.9777015437392796,0.4716981132075472,0.5060034305317325
11528,11,528,1283,672,21,651,310,341,0.5237724084177708,0.03125,0.96875,0.46130952380952384,0.5074404761904762
11601,11,601,1269,660,19,641,324,317,0.5200945626477541,0.02878787878787879,0.9712121212121212,0.4909090909090909,0.4803030303030303
11602,11,602,1299,704,22,682,303,379,0.541955350269438,0.03125,0.96875,0.4303977272727273,0.5383522727272727
11603,11,603,1083,555,18,537,289,248,0.5124653739612188,0.032432432432432434,0.9675675675675676,0.5207207207207207,0.44684684684684683
11604,11,604,1006,515,13,502,247,255,0.5119284294234593,0.02524271844660194,0.974757281553398,0.4796116504854369,0.49514563106796117
11605,11,605,1228,647,13,634,308,326,0.5268729641693811,0.02009273570324575,0.9799072642967542,0.4760432766615147,0.5038639876352395
11606,11,606,1173,593,12,581,298,283,0.505541346973572,0.02023608768971332,0.9797639123102867,0.5025295109612141,0.4772344013490725
11607,11,607,1222,628,18,610,318,292,0.513911620294599,0.028662420382165606,0.9713375796178344,0.5063694267515924,0.46496815286624205
11608,11,608,1087,547,14,533,267,266,0.5032198712051518,0.025594149908592323,0.9744058500914077,0.48811700182815354,0.48628884826325414
11609,11,609,1347,726,17,709,359,350,0.5389755011135857,0.023415977961432508,0.9765840220385675,0.49449035812672176,0.4820936639118457
11610,11,610,1395,679,11,668,377,291,0.4867383512544803,0.016200294550810016,0.9837997054491899,0.5552282768777614,0.42857142857142855
11611,11,611,1628,840,44,796,435,361,0.515970515970516,0.05238095238095238,0.9476190476190476,0.5178571428571429,0.4297619047619048
11612,11,612,1290,604,13,591,291,300,0.4682170542635659,0.02152317880794702,0.9784768211920529,0.4817880794701987,0.4966887417218543
11613,11,613,1249,723,20,703,287,416,0.5788630904723779,0.027662517289073305,0.9723374827109267,0.3969571230982019,0.5753803596127247
11614,11,614,1174,731,11,720,289,431,0.6226575809199318,0.015047879616963064,0.9849521203830369,0.3953488372093023,0.5896032831737346
11615,11,615,1275,712,14,698,349,349,0.5584313725490196,0.019662921348314606,0.9803370786516854,0.4901685393258427,0.4901685393258427
11616,11,616,1815,961,6,955,487,468,0.5294765840220386,0.006243496357960458,0.9937565036420395,0.5067637877211238,0.4869927159209157
11617,11,617,981,549,7,542,253,289,0.5596330275229358,0.012750455373406194,0.9872495446265938,0.46083788706739526,0.5264116575591985
11618,11,618,1113,567,13,554,260,294,0.5094339622641509,0.02292768959435626,0.9770723104056437,0.4585537918871252,0.5185185185185185
11619,11,619,1174,670,9,661,317,344,0.5706984667802385,0.013432835820895522,0.9865671641791045,0.47313432835820896,0.5134328358208955
11620,11,620,1059,575,17,558,239,319,0.5429650613786591,0.029565217391304348,0.9704347826086956,0.4156521739130435,0.5547826086956522
11621,11,621,1461,876,14,862,389,473,0.5995893223819302,0.01598173515981735,0.9840182648401826,0.4440639269406393,0.5399543378995434
11622,11,622,1302,744,19,725,319,406,0.5714285714285714,0.025537634408602152,0.9744623655913979,0.42876344086021506,0.5456989247311828
11623,11,623,1181,714,13,701,298,403,0.6045723962743438,0.018207282913165267,0.9817927170868347,0.4173669467787115,0.5644257703081232
11624,11,624,959,527,17,510,215,295,0.5495307612095933,0.03225806451612903,0.967741935483871,0.4079696394686907,0.5597722960151803
11625,11,625,1158,709,15,694,293,401,0.6122625215889465,0.021156558533145273,0.9788434414668548,0.4132581100141044,0.5655853314527504
11626,11,626,1281,781,13,768,347,421,0.60967993754879,0.016645326504481434,0.9833546734955185,0.44430217669654287,0.5390524967989757
11627,11,627,1399,775,16,759,299,460,0.5539671193709793,0.02064516129032258,0.9793548387096774,0.3858064516129032,0.5935483870967742
11628,11,628,1218,687,11,676,263,413,0.5640394088669951,0.01601164483260553,0.9839883551673945,0.38282387190684136,0.6011644832605532
11629,11,629,1144,641,19,622,278,344,0.5603146853146853,0.029641185647425898,0.9703588143525741,0.43369734789391573,0.5366614664586583
11630,11,630,963,632,6,626,217,409,0.656282450674974,0.00949367088607595,0.990506329113924,0.34335443037974683,0.6471518987341772
12101,12,101,1186,574,4,570,292,278,0.4839797639123103,0.006968641114982578,0.9930313588850174,0.5087108013937283,0.4843205574912892
12102,12,102,903,417,10,407,256,151,0.46179401993355484,0.023980815347721823,0.9760191846522782,0.6139088729016786,0.36211031175059955
12103,12,103,849,386,6,380,245,135,0.4546525323910483,0.015544041450777202,0.9844559585492227,0.6347150259067358,0.34974093264248707
12104,12,104,914,460,8,452,264,188,0.5032822757111597,0.017391304347826087,0.9826086956521739,0.5739130434782609,0.40869565217391307
12105,12,105,816,355,2,353,211,142,0.43504901960784315,0.005633802816901409,0.9943661971830986,0.5943661971830986,0.4
12106,12,106,1142,551,9,542,282,260,0.48248686514886163,0.016333938294010888,0.9836660617059891,0.5117967332123412,0.47186932849364793
12107,12,107,892,508,4,504,242,262,0.5695067264573991,0.007874015748031496,0.9921259842519685,0.4763779527559055,0.515748031496063
12108,12,108,1223,676,12,664,387,277,0.552739165985282,0.01775147928994083,0.9822485207100592,0.5724852071005917,0.40976331360946744
12109,12,109,910,399,4,395,210,185,0.43846153846153846,0.010025062656641603,0.9899749373433584,0.5263157894736842,0.46365914786967416
12110,12,110,934,402,7,395,208,187,0.430406852248394,0.017412935323383085,0.9825870646766169,0.5174129353233831,0.4651741293532338
12111,12,111,1183,593,4,589,324,265,0.5012679628064244,0.006745362563237774,0.9932546374367622,0.5463743676222597,0.4468802698145025
12112,12,112,1232,552,3,549,304,245,0.44805194805194803,0.005434782608695652,0.9945652173913043,0.5507246376811594,0.4438405797101449
12113,12,113,671,317,2,315,183,132,0.47242921013412814,0.006309148264984227,0.9936908517350158,0.5772870662460567,0.416403785488959
12114,12,114,1747,801,12,789,499,290,0.4585002862049227,0.0149812734082397,0.9850187265917603,0.6229712858926342,0.3620474406991261
12115,12,115,674,335,5,330,179,151,0.4970326409495549,0.014925373134328358,0.9850746268656716,0.5343283582089552,0.4507462686567164
12116,12,116,1071,519,8,511,305,206,0.484593837535014,0.015414258188824663,0.9845857418111753,0.5876685934489403,0.3969171483622351
12117,12,117,1587,677,11,666,355,311,0.426591052299937,0.01624815361890694,0.983751846381093,0.5243722304283605,0.45937961595273263
12118,12,118,1470,570,14,556,302,254,0.3877551020408163,0.02456140350877193,0.9754385964912281,0.5298245614035088,0.4456140350877193
12119,12,119,1317,691,12,679,359,320,0.524677296886864,0.017366136034732273,0.9826338639652678,0.5195369030390738,0.4630969609261939
12120,12,120,1360,674,8,666,317,349,0.49558823529411766,0.011869436201780416,0.9881305637982196,0.47032640949554894,0.5178041543026706
12121,12,121,1189,554,9,545,309,236,0.4659377628259041,0.016245487364620937,0.983754512635379,0.5577617328519856,0.4259927797833935
12122,12,122,1477,711,6,705,383,322,0.4813811780636425,0.008438818565400843,0.9915611814345991,0.5386779184247539,0.45288326300984527
12123,12,123,1511,673,7,666,361,305,0.4454003970880212,0.010401188707280832,0.9895988112927192,0.5364041604754829,0.45319465081723626
12124,12,124,1048,481,8,473,282,191,0.45896946564885494,0.016632016632016633,0.9833679833679834,0.5862785862785863,0.3970893970893971
12125,12,125,1238,557,8,549,323,226,0.4499192245557351,0.01436265709156194,0.9856373429084381,0.5798922800718133,0.40574506283662476
12126,12,126,1160,565,10,555,301,254,0.4870689655172414,0.017699115044247787,0.9823008849557522,0.5327433628318584,0.4495575221238938
12201,12,201,1096,602,1,601,444,157,0.5492700729927007,0.0016611295681063123,0.9983388704318937,0.7375415282392026,0.260797342192691
12202,12,202,1173,537,6,531,323,208,0.4578005115089514,0.0111731843575419,0.9888268156424581,0.6014897579143389,0.38733705772811916
12203,12,203,1418,715,4,711,335,376,0.504231311706629,0.005594405594405594,0.9944055944055944,0.46853146853146854,0.5258741258741259
12204,12,204,763,410,2,408,223,185,0.5373525557011796,0.004878048780487805,0.9951219512195122,0.5439024390243903,0.45121951219512196
12205,12,205,782,438,5,433,215,218,0.5601023017902813,0.01141552511415525,0.9885844748858448,0.4908675799086758,0.4977168949771689
12206,12,206,1211,457,0,457,232,225,0.37737407101568954,0.0,1.0,0.5076586433260394,0.4923413566739606
12207,12,207,1458,733,17,716,494,222,0.5027434842249657,0.023192360163710776,0.9768076398362893,0.6739427012278308,0.30286493860845837
12208,12,208,1309,674,28,646,428,218,0.5148968678380443,0.04154302670623145,0.9584569732937686,0.6350148367952523,0.32344213649851633
12209,12,209,1250,542,5,537,355,182,0.4336,0.00922509225092251,0.9907749077490775,0.6549815498154982,0.33579335793357934
12210,12,210,1466,703,2,701,442,259,0.4795361527967258,0.002844950213371266,0.9971550497866287,0.6287339971550497,0.3684210526315789
12211,12,211,1227,605,9,596,358,238,0.4930725346373268,0.01487603305785124,0.9851239669421488,0.5917355371900826,0.3933884297520661
12212,12,212,1657,790,7,783,480,303,0.4767652383826192,0.008860759493670886,0.9911392405063291,0.6075949367088608,0.38354430379746834
12213,12,213,1647,802,14,788,517,271,0.4869459623557984,0.017456359102244388,0.9825436408977556,0.6446384039900249,0.33790523690773067
12214,12,214,1079,572,13,559,344,215,0.5301204819277109,0.022727272727272728,0.9772727272727273,0.6013986013986014,0.3758741258741259
12215,12,215,1443,720,8,712,419,293,0.498960498960499,0.011111111111111112,0.9888888888888889,0.5819444444444445,0.40694444444444444
12216,12,216,1576,749,8,741,466,275,0.475253807106599,0.010680907877169559,0.9893190921228304,0.6221628838451269,0.3671562082777036
12217,12,217,1414,677,7,670,379,291,0.4787835926449788,0.0103397341211226,0.9896602658788775,0.5598227474150664,0.4298375184638109
12218,12,218,1049,409,5,404,240,164,0.38989513822688276,0.012224938875305624,0.9877750611246944,0.58679706601467,0.40097799511002447
12219,12,219,1106,539,0,539,229,310,0.4873417721518987,0.0,1.0,0.424860853432282,0.575139146567718
12220,12,220,1325,555,13,542,394,148,0.4188679245283019,0.023423423423423424,0.9765765765765766,0.7099099099099099,0.26666666666666666
12221,12,221,1467,656,5,651,395,256,0.44717109747784595,0.007621951219512195,0.9923780487804879,0.6021341463414634,0.3902439024390244
12222,12,222,983,423,6,417,224,193,0.4303153611393693,0.014184397163120567,0.9858156028368794,0.5295508274231678,0.4562647754137116
12223,12,223,584,327,1,326,85,241,0.559931506849315,0.0030581039755351682,0.9969418960244648,0.2599388379204893,0.7370030581039755
12224,12,224,354,184,1,183,139,44,0.519774011299435,0.005434782608695652,0.9945652173913043,0.7554347826086957,0.2391304347826087
12225,12,225,1179,543,2,541,320,221,0.46055979643765904,0.003683241252302026,0.996316758747698,0.5893186003683242,0.40699815837937386
12301,12,301,1536,952,19,933,602,331,0.6197916666666666,0.01995798319327731,0.9800420168067226,0.6323529411764706,0.3476890756302521
12302,12,302,1010,574,6,568,375,193,0.5683168316831683,0.010452961672473868,0.9895470383275261,0.6533101045296167,0.3362369337979094
12303,12,303,1134,662,17,645,463,182,0.5837742504409171,0.0256797583081571,0.974320241691843,0.6993957703927492,0.27492447129909364
12304,12,304,980,455,3,452,279,173,0.4642857142857143,0.006593406593406593,0.9934065934065934,0.6131868131868132,0.3802197802197802
12305,12,305,1405,771,10,761,486,275,0.5487544483985766,0.01297016861219196,0.9870298313878081,0.6303501945525292,0.35667963683527887
12306,12,306,1392,807,5,802,558,244,0.5797413793103449,0.006195786864931847,0.9938042131350682,0.6914498141263941,0.3023543990086741
12307,12,307,1395,809,3,806,574,232,0.5799283154121864,0.003708281829419036,0.9962917181705809,0.7095179233621756,0.2867737948084054
12308,12,308,1274,664,7,657,398,259,0.521193092621664,0.010542168674698794,0.9894578313253012,0.5993975903614458,0.39006024096385544
12309,12,309,1340,681,8,673,453,220,0.5082089552238805,0.011747430249632892,0.9882525697503671,0.6651982378854625,0.32305433186490456
12310,12,310,1114,650,10,640,424,216,0.5834829443447038,0.015384615384615385,0.9846153846153847,0.6523076923076923,0.3323076923076923
12311,12,311,1258,624,10,614,410,204,0.4960254372019078,0.016025641025641024,0.9839743589743589,0.657051282051282,0.3269230769230769
12312,12,312,1416,844,18,826,541,285,0.596045197740113,0.02132701421800948,0.9786729857819905,0.6409952606635071,0.33767772511848343
12313,12,313,1262,642,6,636,363,273,0.508716323296355,0.009345794392523364,0.9906542056074766,0.5654205607476636,0.4252336448598131
12314,12,314,1824,999,15,984,657,327,0.5476973684210527,0.015015015015015015,0.984984984984985,0.6576576576576577,0.32732732732732733
12315,12,315,1249,675,9,666,379,287,0.5404323458767014,0.013333333333333334,0.9866666666666667,0.5614814814814815,0.42518518518518517
12316,12,316,1674,897,15,882,560,322,0.53584229390681,0.016722408026755852,0.9832775919732442,0.6243032329988851,0.358974358974359
12317,12,317,1702,877,9,868,580,288,0.5152761457109283,0.010262257696693273,0.9897377423033067,0.661345496009122,0.32839224629418473
12318,12,318,1197,709,8,701,359,342,0.5923141186299081,0.011283497884344146,0.9887165021156559,0.5063469675599436,0.4823695345557123
12319,12,319,1605,871,14,857,618,239,0.5426791277258567,0.016073478760045924,0.983926521239954,0.7095292766934558,0.2743972445464983
12320,12,320,960,482,4,478,323,155,0.5020833333333333,0.008298755186721992,0.991701244813278,0.6701244813278008,0.3215767634854772
12321,12,321,1294,643,10,633,422,211,0.49690880989180836,0.015552099533437015,0.9844479004665629,0.656298600311042,0.328149300155521
12322,12,322,1568,819,10,809,524,285,0.5223214285714286,0.01221001221001221,0.9877899877899878,0.6398046398046398,0.34798534798534797
12323,12,323,1117,649,5,644,258,386,0.5810205908683975,0.007704160246533128,0.9922958397534669,0.3975346687211094,0.5947611710323575
12324,12,324,254,127,0,127,23,104,0.5,0.0,1.0,0.18110236220472442,0.8188976377952756
12401,12,401,1383,753,9,744,476,268,0.544468546637744,0.01195219123505976,0.9880478087649402,0.6321381142098274,0.3559096945551129
12402,12,402,1218,632,9,623,448,175,0.5188834154351396,0.014240506329113924,0.9857594936708861,0.7088607594936709,0.27689873417721517
12403,12,403,777,391,1,390,250,140,0.5032175032175032,0.0025575447570332483,0.9974424552429667,0.639386189258312,0.35805626598465473
12404,12,404,1521,722,13,709,558,151,0.4746877054569362,0.018005540166204988,0.981994459833795,0.7728531855955678,0.20914127423822715
12405,12,405,1618,818,13,805,579,226,0.5055624227441285,0.01589242053789731,0.9841075794621027,0.7078239608801956,0.2762836185819071
12406,12,406,1809,924,21,903,600,303,0.5107794361525705,0.022727272727272728,0.9772727272727273,0.6493506493506493,0.32792207792207795
12407,12,407,1172,689,3,686,455,231,0.5878839590443686,0.0043541364296081275,0.9956458635703919,0.660377358490566,0.3352685050798258
12408,12,408,1372,814,8,806,496,310,0.5932944606413995,0.009828009828009828,0.9901719901719902,0.6093366093366094,0.3808353808353808
12409,12,409,1113,590,9,581,414,167,0.5300988319856245,0.015254237288135594,0.9847457627118644,0.7016949152542373,0.2830508474576271
12410,12,410,1089,621,6,615,446,169,0.5702479338842975,0.00966183574879227,0.9903381642512077,0.7181964573268921,0.2721417069243156
12411,12,411,870,478,6,472,338,134,0.5494252873563218,0.012552301255230125,0.9874476987447699,0.7071129707112971,0.2803347280334728
12412,12,412,1652,968,9,959,644,315,0.585956416464891,0.009297520661157025,0.9907024793388429,0.6652892561983471,0.32541322314049587
12413,12,413,1468,799,7,792,504,288,0.5442779291553134,0.008760951188986232,0.9912390488110138,0.6307884856070087,0.360450563204005
12414,12,414,1448,736,5,731,454,277,0.5082872928176796,0.006793478260869565,0.9932065217391305,0.6168478260869565,0.3763586956521739
12415,12,415,1684,775,8,767,541,226,0.46021377672209024,0.01032258064516129,0.9896774193548387,0.6980645161290323,0.29161290322580646
12416,12,416,1825,1003,16,987,706,281,0.5495890410958905,0.015952143569292122,0.9840478564307079,0.7038883349950149,0.28015952143569295
12417,12,417,1596,833,8,825,466,359,0.5219298245614035,0.009603841536614645,0.9903961584633854,0.5594237695078031,0.4309723889555822
12418,12,418,1169,580,4,576,413,163,0.49615055603079555,0.006896551724137931,0.993103448275862,0.7120689655172414,0.2810344827586207
12419,12,419,1578,758,4,754,519,235,0.4803548795944233,0.005277044854881266,0.9947229551451188,0.6846965699208444,0.3100263852242744
12420,12,420,1027,602,8,594,437,157,0.5861733203505355,0.013289036544850499,0.9867109634551495,0.7259136212624585,0.260797342192691
12421,12,421,1046,618,13,605,399,206,0.5908221797323135,0.021035598705501618,0.9789644012944984,0.6456310679611651,0.3333333333333333
12422,12,422,1599,831,6,825,532,293,0.5196998123827392,0.007220216606498195,0.9927797833935018,0.6401925391095066,0.3525872442839952
12423,12,423,1364,730,9,721,497,224,0.5351906158357771,0.012328767123287671,0.9876712328767123,0.6808219178082192,0.30684931506849317
12424,12,424,772,391,5,386,239,147,0.5064766839378239,0.01278772378516624,0.9872122762148338,0.6112531969309463,0.37595907928388744
12425,12,425,1809,970,1,969,630,339,0.5362078496406855,0.0010309278350515464,0.9989690721649485,0.6494845360824743,0.3494845360824742
12426,12,426,655,350,2,348,221,127,0.5343511450381679,0.005714285714285714,0.9942857142857143,0.6314285714285715,0.3628571428571429
12501,12,501,854,491,2,489,299,190,0.5749414519906323,0.004073319755600814,0.9959266802443992,0.6089613034623218,0.3869653767820774
12502,12,502,1267,711,13,698,480,218,0.5611681136543015,0.01828410689170183,0.9817158931082982,0.6751054852320675,0.3066104078762307
12503,12,503,1722,1030,11,1019,718,301,0.5981416957026713,0.010679611650485437,0.9893203883495145,0.6970873786407767,0.2922330097087379
12504,12,504,1295,626,35,591,455,136,0.4833976833976834,0.05591054313099041,0.9440894568690096,0.7268370607028753,0.21725239616613418
12505,12,505,852,470,10,460,346,114,0.5516431924882629,0.02127659574468085,0.9787234042553191,0.7361702127659574,0.2425531914893617
12506,12,506,876,461,7,454,338,116,0.526255707762557,0.015184381778741865,0.9848156182212582,0.7331887201735358,0.25162689804772237
12507,12,507,841,403,6,397,302,95,0.47919143876337694,0.01488833746898263,0.9851116625310173,0.749379652605459,0.23573200992555832
12508,12,508,639,292,8,284,209,75,0.4569640062597809,0.0273972602739726,0.9726027397260274,0.7157534246575342,0.2568493150684932
12509,12,509,979,472,12,460,360,100,0.4821246169560776,0.025423728813559324,0.9745762711864406,0.7627118644067796,0.211864406779661
12510,12,510,761,355,5,350,279,71,0.4664914586070959,0.014084507042253521,0.9859154929577465,0.7859154929577464,0.2
12511,12,511,902,389,8,381,304,77,0.4312638580931264,0.02056555269922879,0.9794344473007712,0.781491002570694,0.19794344473007713
12512,12,512,971,505,1,504,394,110,0.5200823892893924,0.0019801980198019802,0.998019801980198,0.7801980198019802,0.21782178217821782
12513,12,513,1460,630,10,620,465,155,0.4315068493150685,0.015873015873015872,0.9841269841269841,0.7380952380952381,0.24603174603174602
12514,12,514,1337,455,3,452,324,128,0.3403141361256545,0.006593406593406593,0.9934065934065934,0.7120879120879121,0.2813186813186813
12515,12,515,854,403,1,402,292,110,0.4718969555035129,0.0024813895781637717,0.9975186104218362,0.7245657568238213,0.2729528535980149
12516,12,516,1267,598,7,591,460,131,0.47198105761641673,0.011705685618729096,0.9882943143812709,0.7692307692307693,0.21906354515050167
12517,12,517,942,418,9,409,319,90,0.4437367303609342,0.0215311004784689,0.9784688995215312,0.7631578947368421,0.215311004784689
12518,12,518,987,530,5,525,383,142,0.5369807497467072,0.009433962264150943,0.9905660377358491,0.7226415094339622,0.2679245283018868
12519,12,519,1088,546,13,533,396,137,0.5018382352941176,0.023809523809523808,0.9761904761904762,0.7252747252747253,0.2509157509157509
12520,12,520,1026,374,15,359,273,86,0.3645224171539961,0.040106951871657755,0.9598930481283422,0.7299465240641712,0.22994652406417113
12521,12,521,1069,523,3,520,371,149,0.4892422825070159,0.0057361376673040155,0.994263862332696,0.7093690248565966,0.28489483747609945
12522,12,522,811,363,1,362,259,103,0.4475955610357583,0.0027548209366391185,0.9972451790633609,0.7134986225895317,0.2837465564738292
12523,12,523,1068,521,9,512,378,134,0.48782771535580527,0.01727447216890595,0.982725527831094,0.72552783109405,0.2571976967370441
12524,12,524,1157,522,5,517,399,118,0.4511668107173725,0.009578544061302681,0.9904214559386973,0.764367816091954,0.2260536398467433
12525,12,525,805,480,5,475,339,136,0.5962732919254659,0.010416666666666666,0.9895833333333334,0.70625,0.2833333333333333
12526,12,526,1448,766,4,762,598,164,0.5290055248618785,0.005221932114882507,0.9947780678851175,0.7806788511749347,0.21409921671018275
12601,12,601,260,163,1,162,97,65,0.6269230769230769,0.006134969325153374,0.9938650306748467,0.5950920245398773,0.3987730061349693
12602,12,602,1389,814,9,805,557,248,0.5860331173506119,0.011056511056511056,0.9889434889434889,0.6842751842751843,0.3046683046683047
12603,12,603,1203,646,7,639,433,206,0.5369908561928513,0.010835913312693499,0.9891640866873065,0.6702786377708978,0.3188854489164087
12604,12,604,1055,598,5,593,385,208,0.566824644549763,0.008361204013377926,0.9916387959866221,0.6438127090301003,0.34782608695652173
12605,12,605,929,486,12,474,301,173,0.5231431646932185,0.024691358024691357,0.9753086419753086,0.6193415637860082,0.3559670781893004
12606,12,606,1249,710,10,700,495,205,0.5684547638110489,0.014084507042253521,0.9859154929577465,0.6971830985915493,0.2887323943661972
12607,12,607,1020,567,5,562,394,168,0.5558823529411765,0.008818342151675485,0.9911816578483245,0.6948853615520282,0.2962962962962963
12608,12,608,765,415,9,406,297,109,0.5424836601307189,0.021686746987951807,0.9783132530120482,0.7156626506024096,0.26265060240963856
12609,12,609,1453,790,7,783,506,277,0.5437026841018582,0.008860759493670886,0.9911392405063291,0.640506329113924,0.35063291139240504
12610,12,610,1013,569,6,563,383,180,0.5616979269496545,0.01054481546572935,0.9894551845342706,0.6731107205623902,0.3163444639718805
12611,12,611,841,497,7,490,332,158,0.5909631391200951,0.014084507042253521,0.9859154929577465,0.6680080482897385,0.317907444668008
12612,12,612,1097,549,8,541,354,187,0.5004557885141294,0.014571948998178506,0.9854280510018215,0.644808743169399,0.3406193078324226
12613,12,613,1127,600,14,586,384,202,0.5323868677905945,0.023333333333333334,0.9766666666666667,0.64,0.33666666666666667
12614,12,614,1426,707,8,699,436,263,0.4957924263674614,0.011315417256011316,0.9886845827439887,0.6166902404526167,0.371994342291372
12615,12,615,1790,959,14,945,650,295,0.535754189944134,0.014598540145985401,0.9854014598540146,0.6777893639207507,0.30761209593326383
12616,12,616,1442,823,6,817,550,267,0.5707350901525658,0.007290400972053463,0.9927095990279465,0.6682867557715675,0.3244228432563791
12617,12,617,1131,630,11,619,416,203,0.5570291777188329,0.01746031746031746,0.9825396825396825,0.6603174603174603,0.32222222222222224
12618,12,618,1433,794,13,781,512,269,0.5540823447313329,0.0163727959697733,0.9836272040302267,0.6448362720403022,0.33879093198992444
12619,12,619,1715,952,16,936,604,332,0.5551020408163265,0.01680672268907563,0.9831932773109243,0.634453781512605,0.3487394957983193
12620,12,620,1020,578,2,576,373,203,0.5666666666666667,0.0034602076124567475,0.9965397923875432,0.6453287197231834,0.35121107266435986
12621,12,621,932,486,2,484,320,164,0.5214592274678111,0.00411522633744856,0.9958847736625515,0.6584362139917695,0.3374485596707819
12622,12,622,1071,593,3,590,381,209,0.5536881419234361,0.00505902192242833,0.9949409780775716,0.642495784148398,0.3524451939291737
12623,12,623,891,487,7,480,307,173,0.5465768799102132,0.014373716632443531,0.9856262833675564,0.6303901437371663,0.35523613963039014
12624,12,624,1194,722,9,713,473,240,0.6046901172529313,0.012465373961218837,0.9875346260387812,0.6551246537396122,0.33240997229916897
12625,12,625,1104,661,11,650,428,222,0.5987318840579711,0.01664145234493192,0.983358547655068,0.6475037821482602,0.3358547655068079
011A,01,1A,0,1982,2,1980,1223,757,inf,0.0010090817356205853,0.9989909182643795,0.6170534813319879,0.3819374369323915
011B,01,1B,0,1184,5,1179,767,412,inf,0.004222972972972973,0.995777027027027,0.6478040540540541,0.34797297297297297
011C,01,1C,0,1063,9,1054,611,443,inf,0.008466603951081843,0.9915333960489181,0.5747883349012229,0.4167450611476952
011D,01,1D,0,1433,208,1225,688,537,inf,0.1451500348918353,0.8548499651081647,0.4801116538729937,0.374738311235171
011E,01,1E,0,1494,5,1489,860,629,inf,0.0033467202141900937,0.9966532797858099,0.5756358768406962,0.4210174029451138
012A,01,2A,0,1522,7,1515,925,590,inf,0.0045992115637319315,0.9954007884362681,0.6077529566360053,0.3876478318002628
012B,01,2B,0,1334,12,1322,733,589,inf,0.008995502248875561,0.9910044977511244,0.5494752623688156,0.44152923538230887
012C,01,2C,0,1171,10,1161,638,523,inf,0.008539709649871904,0.9914602903501281,0.5448334756618275,0.4466268146883006
012D,01,2D,0,926,3,923,440,483,inf,0.0032397408207343412,0.9967602591792657,0.47516198704103674,0.521598272138229
012E,01,2E,0,1104,7,1097,557,540,inf,0.006340579710144928,0.9936594202898551,0.5045289855072463,0.4891304347826087
012F,01,2F,0,1277,10,1267,615,652,inf,0.007830853563038372,0.9921691464369616,0.4815974941268598,0.5105716523101018
013A,01,3A,0,1026,14,1012,587,425,inf,0.01364522417153996,0.98635477582846,0.5721247563352827,0.4142300194931774
013B,01,3B,0,1490,159,1331,729,602,inf,0.10671140939597315,0.8932885906040269,0.489261744966443,0.4040268456375839
013C,01,3C,0,1344,134,1210,721,489,inf,0.09970238095238096,0.9002976190476191,0.5364583333333334,0.3638392857142857
013D,01,3D,0,1009,10,999,616,383,inf,0.009910802775024777,0.9900891972249752,0.6105054509415263,0.379583746283449
013E,01,3E,0,1457,12,1445,990,455,inf,0.008236101578586136,0.9917638984214139,0.6794783802333562,0.31228551818805766
013F,01,3F,0,718,1,717,418,299,inf,0.001392757660167131,0.9986072423398329,0.5821727019498607,0.41643454038997213
014A,01,4A,0,1144,8,1136,742,394,inf,0.006993006993006993,0.993006993006993,0.6486013986013986,0.34440559440559443
014B,01,4B,0,1250,11,1239,725,514,inf,0.0088,0.9912,0.58,0.4112
014C,01,4C,0,1061,10,1051,589,462,inf,0.00942507068803016,0.9905749293119699,0.5551366635249765,0.4354382657869934
014D,01,4D,0,1142,12,1130,656,474,inf,0.010507880910683012,0.989492119089317,0.574430823117338,0.415061295971979
014E,01,4E,0,1487,9,1478,792,686,inf,0.00605245460659045,0.9939475453934096,0.5326160053799597,0.4613315400134499
015A,01,5A,0,1101,4,1097,561,536,inf,0.0036330608537693005,0.9963669391462306,0.5095367847411444,0.4868301544050863
015B,01,5B,0,1024,3,1021,478,543,inf,0.0029296875,0.9970703125,0.466796875,0.5302734375
015C,01,5C,0,893,5,888,460,428,inf,0.005599104143337066,0.9944008958566629,0.5151175811870101,0.47928331466965285
015D,01,5D,0,1288,12,1276,594,682,inf,0.009316770186335404,0.9906832298136646,0.4611801242236025,0.5295031055900621
015E,01,5E,0,855,66,789,397,392,inf,0.07719298245614035,0.9228070175438596,0.464327485380117,0.4584795321637427
016A,01,6A,0,768,0,768,303,465,inf,0.0,1.0,0.39453125,0.60546875
016B,01,6B,0,733,3,730,334,396,inf,0.004092769440654843,0.9959072305593452,0.45566166439290584,0.5402455661664393
016C,01,6C,0,1016,6,1010,470,540,inf,0.005905511811023622,0.9940944881889764,0.4625984251968504,0.531496062992126
016D,01,6D,0,797,10,787,410,377,inf,0.012547051442910916,0.9874529485570891,0.5144291091593476,0.4730238393977415
016E,01,6E,0,879,79,800,411,389,inf,0.08987485779294653,0.9101251422070534,0.46757679180887374,0.44254835039817975
017A,01,7A,0,1041,10,1031,530,501,inf,0.009606147934678195,0.9903938520653218,0.5091258405379443,0.4812680115273775
017B,01,7B,0,1163,7,1156,619,537,inf,0.0060189165950128975,0.9939810834049871,0.532244196044712,0.46173688736027513
017C,01,7C,0,759,9,750,451,299,inf,0.011857707509881422,0.9881422924901185,0.5942028985507246,0.3939393939393939
017D,01,7D,0,571,3,568,366,202,inf,0.005253940455341506,0.9947460595446584,0.6409807355516638,0.35376532399299476
017E,01,7E,0,934,6,928,548,380,inf,0.006423982869379015,0.9935760171306209,0.5867237687366167,0.4068522483940043
021A,02,1A,0,772,14,758,374,384,inf,0.018134715025906734,0.9818652849740933,0.4844559585492228,0.49740932642487046
021B,02,1B,0,707,7,700,307,393,inf,0.009900990099009901,0.9900990099009901,0.43422913719943423,0.5558698727015559
021C,02,1C,0,770,8,762,359,403,inf,0.01038961038961039,0.9896103896103896,0.4662337662337662,0.5233766233766234
021D,02,1D,0,688,8,680,281,399,inf,0.011627906976744186,0.9883720930232558,0.40843023255813954,0.5799418604651163
021E,02,1E,0,661,5,656,289,367,inf,0.007564296520423601,0.9924357034795764,0.4372163388804841,0.5552193645990923
021F,02,1F,0,734,9,725,325,400,inf,0.01226158038147139,0.9877384196185286,0.4427792915531335,0.5449591280653951
021G,02,1G,0,661,6,655,276,379,inf,0.009077155824508321,0.9909228441754917,0.4175491679273828,0.573373676248109
021H,02,1H,0,638,6,632,244,388,inf,0.009404388714733543,0.9905956112852664,0.3824451410658307,0.6081504702194357
021J,02,1J,0,573,14,559,241,318,inf,0.02443280977312391,0.9755671902268761,0.4205933682373473,0.5549738219895288
021K,02,1K,0,441,6,435,169,266,inf,0.013605442176870748,0.9863945578231292,0.3832199546485261,0.6031746031746031
021L,02,1L,0,419,7,412,196,216,inf,0.016706443914081145,0.9832935560859188,0.4677804295942721,0.5155131264916468
021M,02,1M,0,449,6,443,226,217,inf,0.013363028953229399,0.9866369710467706,0.5033407572383074,0.48329621380846327
021N,02,1N,0,494,4,490,234,256,inf,0.008097165991902834,0.9919028340080972,0.47368421052631576,0.5182186234817814
022A,02,2A,0,439,7,432,192,240,inf,0.015945330296127564,0.9840546697038725,0.43735763097949887,0.5466970387243736
022B,02,2B,0,579,7,572,261,311,inf,0.012089810017271158,0.9879101899827288,0.45077720207253885,0.5371329879101899
022C,02,2C,0,430,3,427,180,247,inf,0.0069767441860465115,0.9930232558139535,0.4186046511627907,0.5744186046511628
022D,02,2D,0,521,4,517,198,319,inf,0.007677543186180422,0.9923224568138196,0.3800383877159309,0.6122840690978887
022E,02,2E,0,388,8,380,165,215,inf,0.020618556701030927,0.979381443298969,0.4252577319587629,0.5541237113402062
022F,02,2F,0,412,7,405,143,262,inf,0.01699029126213592,0.9830097087378641,0.3470873786407767,0.6359223300970874
022G,02,2G,0,425,9,416,180,236,inf,0.021176470588235293,0.9788235294117648,0.4235294117647059,0.5552941176470588
022H,02,2H,0,824,12,812,381,431,inf,0.014563106796116505,0.9854368932038835,0.46237864077669905,0.5230582524271845
022J,02,2J,0,756,14,742,303,439,inf,0.018518518518518517,0.9814814814814815,0.4007936507936508,0.5806878306878307
022K,02,2K,0,597,5,592,302,290,inf,0.008375209380234505,0.9916247906197655,0.5058626465661642,0.48576214405360135
022L,02,2L,0,595,8,587,278,309,inf,0.013445378151260505,0.9865546218487395,0.4672268907563025,0.519327731092437
022M,02,2M,0,672,5,667,314,353,inf,0.00744047619047619,0.9925595238095238,0.46726190476190477,0.5252976190476191
022N,02,2N,0,558,8,550,245,305,inf,0.014336917562724014,0.985663082437276,0.4390681003584229,0.546594982078853
023A,02,3A,0,391,2,389,242,147,inf,0.005115089514066497,0.9948849104859335,0.618925831202046,0.37595907928388744
023B,02,3B,0,331,5,326,166,160,inf,0.015105740181268883,0.9848942598187311,0.5015105740181269,0.48338368580060426
023C,02,3C,0,607,5,602,376,226,inf,0.008237232289950576,0.9917627677100495,0.6194398682042833,0.3723228995057661
023D,02,3D,0,551,10,541,337,204,inf,0.018148820326678767,0.9818511796733213,0.6116152450090744,0.3702359346642468
023E,02,3E,0,637,8,629,277,352,inf,0.012558869701726845,0.9874411302982732,0.434850863422292,0.5525902668759811
023F,02,3F,0,461,4,457,270,187,inf,0.008676789587852495,0.9913232104121475,0.5856832971800434,0.40563991323210413
023G,02,3G,0,448,15,433,207,226,inf,0.033482142857142856,0.9665178571428571,0.46205357142857145,0.5044642857142857
023H,02,3H,0,693,7,686,246,440,inf,0.010101010101010102,0.98989898989899,0.354978354978355,0.6349206349206349
023J,02,3J,0,641,4,637,275,362,inf,0.0062402496099844,0.9937597503900156,0.4290171606864275,0.5647425897035881
024A,02,4A,0,531,5,526,262,264,inf,0.009416195856873822,0.9905838041431262,0.4934086629001883,0.4971751412429379
024B,02,4B,0,435,3,432,194,238,inf,0.006896551724137931,0.993103448275862,0.4459770114942529,0.5471264367816092
024C,02,4C,0,506,7,499,243,256,inf,0.01383399209486166,0.9861660079051383,0.48023715415019763,0.5059288537549407
024D,02,4D,0,600,7,593,291,302,inf,0.011666666666666667,0.9883333333333333,0.485,0.5033333333333333
024E,02,4E,0,522,6,516,229,287,inf,0.011494252873563218,0.9885057471264368,0.4386973180076628,0.5498084291187739
024F,02,4F,0,412,2,410,208,202,inf,0.0048543689320388345,0.9951456310679612,0.5048543689320388,0.49029126213592233
024G,02,4G,0,566,7,559,251,308,inf,0.012367491166077738,0.9876325088339223,0.44346289752650175,0.5441696113074205
024H,02,4H,0,691,9,682,315,367,inf,0.013024602026049204,0.9869753979739508,0.4558610709117221,0.5311143270622286
024J,02,4J,0,482,1,481,249,232,inf,0.002074688796680498,0.9979253112033195,0.516597510373444,0.48132780082987553
024K,02,4K,0,555,1,554,250,304,inf,0.0018018018018018018,0.9981981981981982,0.45045045045045046,0.5477477477477477
024L,02,4L,0,598,5,593,271,322,inf,0.008361204013377926,0.9916387959866221,0.4531772575250836,0.5384615384615384
024M,02,4M,0,475,7,468,214,254,inf,0.014736842105263158,0.9852631578947368,0.45052631578947366,0.5347368421052632
024N,02,4N,0,584,4,580,299,281,inf,0.00684931506849315,0.9931506849315068,0.511986301369863,0.4811643835616438
025A,02,5A,0,649,9,640,318,322,inf,0.01386748844375963,0.9861325115562404,0.4899845916795069,0.49614791987673346
025B,02,5B,0,527,12,515,210,305,inf,0.022770398481973434,0.9772296015180265,0.3984819734345351,0.5787476280834914
025C,02,5C,0,650,5,645,311,334,inf,0.007692307692307693,0.9923076923076923,0.47846153846153844,0.5138461538461538
025D,02,5D,0,820,11,809,377,432,inf,0.013414634146341463,0.9865853658536585,0.45975609756097563,0.526829268292683
025E,02,5E,0,831,14,817,371,446,inf,0.01684717208182912,0.9831528279181708,0.4464500601684717,0.5367027677496992
025F,02,5F,0,467,4,463,229,234,inf,0.008565310492505354,0.9914346895074947,0.49036402569593146,0.5010706638115632
025G,02,5G,0,551,4,547,258,289,inf,0.007259528130671506,0.9927404718693285,0.46823956442831216,0.5245009074410163
025H,02,5H,0,544,9,535,251,284,inf,0.016544117647058824,0.9834558823529411,0.46139705882352944,0.5220588235294118
025J,02,5J,0,629,10,619,267,352,inf,0.01589825119236884,0.9841017488076311,0.424483306836248,0.5596184419713831
025K,02,5K,0,649,9,640,269,371,inf,0.01386748844375963,0.9861325115562404,0.41448382126348227,0.5716486902927581
025L,02,5L,0,528,6,522,244,278,inf,0.011363636363636364,0.9886363636363636,0.4621212121212121,0.5265151515151515
025M,02,5M,0,817,16,801,378,423,inf,0.019583843329253364,0.9804161566707467,0.46266829865361075,0.5177478580171359
025N,02,5N,0,629,6,623,308,315,inf,0.009538950715421303,0.9904610492845787,0.48966613672496023,0.5007949125596184
031A,03,1A,0,824,2,822,406,416,inf,0.0024271844660194173,0.9975728155339806,0.49271844660194175,0.5048543689320388
031B,03,1B,0,484,5,479,254,225,inf,0.010330578512396695,0.9896694214876033,0.5247933884297521,0.46487603305785125
031C,03,1C,0,371,3,368,215,153,inf,0.008086253369272238,0.9919137466307277,0.5795148247978437,0.4123989218328841
031D,03,1D,0,615,2,613,349,264,inf,0.0032520325203252032,0.9967479674796748,0.567479674796748,0.4292682926829268
031E,03,1E,0,397,5,392,208,184,inf,0.012594458438287154,0.9874055415617129,0.5239294710327456,0.4634760705289673
031F,03,1F,0,542,4,538,266,272,inf,0.007380073800738007,0.992619926199262,0.4907749077490775,0.5018450184501845
031G,03,1G,0,608,2,606,308,298,inf,0.003289473684210526,0.9967105263157895,0.506578947368421,0.4901315789473684
031H,03,1H,0,397,1,396,238,158,inf,0.0025188916876574307,0.9974811083123426,0.5994962216624685,0.3979848866498741
031I,03,1I,0,600,3,597,271,326,inf,0.005,0.995,0.45166666666666666,0.5433333333333333
031K,03,1K,0,686,0,686,321,365,inf,0.0,1.0,0.4679300291545189,0.532069970845481
031L,03,1L,0,578,0,578,314,264,inf,0.0,1.0,0.5432525951557093,0.45674740484429066
032A,03,2A,0,632,3,629,350,279,inf,0.004746835443037975,0.995253164556962,0.5537974683544303,0.44145569620253167
032B,03,2B,0,488,6,482,270,212,inf,0.012295081967213115,0.9877049180327869,0.5532786885245902,0.4344262295081967
032C,03,2C,0,611,6,605,355,250,inf,0.009819967266775777,0.9901800327332242,0.5810147299509002,0.40916530278232405
032D,03,2D,0,930,3,927,465,462,inf,0.0032258064516129032,0.9967741935483871,0.5,0.4967741935483871
032E,03,2E,0,1022,3,1019,416,603,inf,0.0029354207436399216,0.99706457925636,0.4070450097847358,0.5900195694716243
032F,03,2F,0,602,6,596,311,285,inf,0.009966777408637873,0.9900332225913622,0.5166112956810631,0.473421926910299
032G,03,2G,0,721,2,719,334,385,inf,0.0027739251040221915,0.9972260748959778,0.463245492371706,0.5339805825242718
032H,03,2H,0,1027,3,1024,437,587,inf,0.0029211295034079843,0.997078870496592,0.4255111976630964,0.5715676728334956
032I,03,2I,0,993,5,988,313,675,inf,0.005035246727089627,0.9949647532729103,0.3152064451158107,0.6797583081570997
033A,03,3A,0,649,3,646,273,373,inf,0.004622496147919877,0.9953775038520801,0.4206471494607088,0.5747303543913713
033B,03,3B,0,752,4,748,288,460,inf,0.005319148936170213,0.9946808510638298,0.3829787234042553,0.6117021276595744
033C,03,3C,0,803,6,797,281,516,inf,0.007471980074719801,0.9925280199252802,0.34993773349937735,0.6425902864259029
033D,03,3D,0,640,4,636,156,480,inf,0.00625,0.99375,0.24375,0.75
033E,03,3E,0,616,3,613,196,417,inf,0.00487012987012987,0.9951298701298701,0.3181818181818182,0.676948051948052
033F,03,3F,0,654,4,650,199,451,inf,0.0061162079510703364,0.9938837920489296,0.30428134556574926,0.6896024464831805
033G,03,3G,0,1091,8,1083,207,876,inf,0.007332722273143905,0.9926672777268561,0.18973418881759854,0.8029330889092575
033H,03,3H,0,1251,5,1246,292,954,inf,0.003996802557953637,0.9960031974420464,0.23341326938449242,0.762589928057554
033I,03,3I,0,1355,6,1349,302,1047,inf,0.004428044280442804,0.9955719557195571,0.22287822878228783,0.7726937269372693
034A,03,4A,0,699,4,695,279,416,inf,0.005722460658082976,0.994277539341917,0.39914163090128757,0.5951359084406295
034B,03,4B,0,900,6,894,350,544,inf,0.006666666666666667,0.9933333333333333,0.3888888888888889,0.6044444444444445
034C,03,4C,0,575,6,569,224,345,inf,0.010434782608695653,0.9895652173913043,0.38956521739130434,0.6
034D,03,4D,0,554,4,550,274,276,inf,0.007220216606498195,0.9927797833935018,0.49458483754512633,0.4981949458483754
034E,03,4E,0,509,7,502,189,313,inf,0.0137524557956778,0.9862475442043221,0.3713163064833006,0.6149312377210217
034F,03,4F,0,504,2,502,220,282,inf,0.003968253968253968,0.996031746031746,0.4365079365079365,0.5595238095238095
034G,03,4G,0,810,4,806,194,612,inf,0.0049382716049382715,0.9950617283950617,0.23950617283950618,0.7555555555555555
034H,03,4H,0,1085,1,1084,351,733,inf,0.0009216589861751152,0.9990783410138249,0.32350230414746545,0.6755760368663595
034I,03,4I,0,415,1,414,202,212,inf,0.0024096385542168677,0.9975903614457832,0.4867469879518072,0.5108433734939759
035A,03,5A,0,629,1,628,205,423,inf,0.001589825119236884,0.9984101748807631,0.32591414944356123,0.6724960254372019
035B,03,5B,0,651,2,649,221,428,inf,0.0030721966205837174,0.9969278033794163,0.33947772657450076,0.6574500768049155
035C,03,5C,0,610,4,606,195,411,inf,0.006557377049180328,0.9934426229508196,0.319672131147541,0.6737704918032786
035D,03,5D,0,582,6,576,224,352,inf,0.010309278350515464,0.9896907216494846,0.3848797250859107,0.6048109965635738
035E,03,5E,0,813,3,810,333,477,inf,0.0036900369003690036,0.996309963099631,0.4095940959409594,0.5867158671586716
035F,03,5F,0,728,3,725,255,470,inf,0.004120879120879121,0.9958791208791209,0.35027472527472525,0.6456043956043956
035G,03,5G,0,629,3,626,214,412,inf,0.0047694753577106515,0.9952305246422893,0.34022257551669316,0.6550079491255962
035H,03,5H,0,688,8,680,199,481,inf,0.011627906976744186,0.9883720930232558,0.28924418604651164,0.6991279069767442
035I,03,5I,0,466,1,465,149,316,inf,0.002145922746781116,0.9978540772532188,0.3197424892703863,0.6781115879828327
035K,03,5K,0,691,4,687,110,577,inf,0.005788712011577424,0.9942112879884226,0.15918958031837915,0.8350217076700435
036A,03,6A,0,627,5,622,223,399,inf,0.007974481658692184,0.9920255183413078,0.35566188197767146,0.6363636363636364
036B,03,6B,0,633,9,624,282,342,inf,0.014218009478672985,0.985781990521327,0.44549763033175355,0.5402843601895735
036C,03,6C,0,638,2,636,266,370,inf,0.003134796238244514,0.9968652037617555,0.4169278996865204,0.5799373040752351
036D,03,6D,0,913,4,909,423,486,inf,0.004381161007667032,0.9956188389923329,0.4633077765607886,0.5323110624315444
036E,03,6E,0,748,8,740,342,398,inf,0.0106951871657754,0.9893048128342246,0.4572192513368984,0.5320855614973262
036F,03,6F,0,707,7,700,315,385,inf,0.009900990099009901,0.9900990099009901,0.44554455445544555,0.5445544554455446
036G,03,6G,0,771,2,769,357,412,inf,0.0025940337224383916,0.9974059662775616,0.46303501945525294,0.5343709468223087
036H,03,6H,0,997,11,986,483,503,inf,0.011033099297893681,0.9889669007021064,0.4844533600802407,0.5045135406218656
036I,03,6I,0,897,5,892,452,440,inf,0.005574136008918618,0.9944258639910813,0.5039018952062431,0.49052396878483834
036K,03,6K,0,809,5,804,352,452,inf,0.006180469715698393,0.9938195302843016,0.43510506798516685,0.5587144622991347
037A,03,7A,0,848,2,846,426,420,inf,0.0023584905660377358,0.9976415094339622,0.5023584905660378,0.49528301886792453
037B,03,7B,0,518,4,514,255,259,inf,0.007722007722007722,0.9922779922779923,0.4922779922779923,0.5
037C,03,7C,0,632,5,627,275,352,inf,0.007911392405063292,0.9920886075949367,0.435126582278481,0.5569620253164557
037D,03,7D,0,783,6,777,406,371,inf,0.007662835249042145,0.9923371647509579,0.5185185185185185,0.47381864623243936
037E,03,7E,0,581,1,580,278,302,inf,0.0017211703958691911,0.9982788296041308,0.4784853700516351,0.5197934595524957
037F,03,7F,0,713,3,710,328,382,inf,0.004207573632538569,0.9957924263674615,0.4600280504908836,0.5357643758765779
037G,03,7G,0,1024,0,1024,490,534,inf,0.0,1.0,0.478515625,0.521484375
037H,03,7H,0,719,3,716,314,402,inf,0.004172461752433936,0.9958275382475661,0.43671766342141866,0.5591098748261474
037I,03,7I,0,511,3,508,220,288,inf,0.005870841487279843,0.9941291585127201,0.43052837573385516,0.5636007827788649
038A,03,8A,0,635,8,627,306,321,inf,0.012598425196850394,0.9874015748031496,0.4818897637795276,0.5055118110236221
038B,03,8B,0,674,3,671,339,332,inf,0.004451038575667656,0.9955489614243324,0.5029673590504451,0.49258160237388726
038C,03,8C,0,1049,6,1043,521,522,inf,0.005719733079122974,0.994280266920877,0.4966634890371783,0.49761677788369874
038D,03,8D,0,751,4,747,368,379,inf,0.005326231691078562,0.9946737683089214,0.49001331557922767,0.5046604527296937
038E,03,8E,0,764,8,756,403,353,inf,0.010471204188481676,0.9895287958115183,0.5274869109947644,0.4620418848167539
038F,03,8F,0,773,5,768,369,399,inf,0.00646830530401035,0.9935316946959897,0.47736093143596375,0.5161707632600259
038G,03,8G,0,971,5,966,515,451,inf,0.005149330587023687,0.9948506694129763,0.5303810504634398,0.46446961894953653
038H,03,8H,0,688,2,686,329,357,inf,0.0029069767441860465,0.997093023255814,0.47819767441860467,0.5188953488372093
038I,03,8I,0,906,2,904,490,414,inf,0.002207505518763797,0.9977924944812362,0.5408388520971302,0.45695364238410596
039A,03,9A,0,516,0,516,214,302,inf,0.0,1.0,0.41472868217054265,0.5852713178294574
039B,03,9B,0,677,4,673,296,377,inf,0.005908419497784343,0.9940915805022157,0.43722304283604135,0.5568685376661743
039C,03,9C,0,594,5,589,264,325,inf,0.008417508417508417,0.9915824915824916,0.4444444444444444,0.5471380471380471
039D,03,9D,0,643,5,638,325,313,inf,0.007776049766718507,0.9922239502332815,0.505443234836703,0.4867807153965785
039E,03,9E,0,768,3,765,373,392,inf,0.00390625,0.99609375,0.4856770833333333,0.5104166666666666
039F,03,9F,0,597,3,594,291,303,inf,0.005025125628140704,0.9949748743718593,0.48743718592964824,0.507537688442211
039G,03,9G,0,622,4,618,273,345,inf,0.006430868167202572,0.9935691318327974,0.43890675241157556,0.5546623794212219
039H,03,9H,0,739,5,734,354,380,inf,0.006765899864682003,0.993234100135318,0.4790257104194858,0.5142083897158322
039I,03,9I,0,1051,2,1049,455,594,inf,0.0019029495718363464,0.9980970504281637,0.4329210275927688,0.5651760228353948
039K,03,9K,0,375,3,372,191,181,inf,0.008,0.992,0.5093333333333333,0.4826666666666667
041A,04,1A,0,689,4,685,498,187,inf,0.005805515239477504,0.9941944847605225,0.7227866473149492,0.2714078374455733
041B,04,1B,0,697,3,694,459,235,inf,0.00430416068866571,0.9956958393113343,0.6585365853658537,0.33715925394548063
041C,04,1C,0,658,8,650,462,188,inf,0.0121580547112462,0.9878419452887538,0.7021276595744681,0.2857142857142857
041D,04,1D,0,1004,10,994,745,249,inf,0.0099601593625498,0.9900398406374502,0.7420318725099602,0.24800796812749004
041E,04,1E,0,1070,3,1067,741,326,inf,0.002803738317757009,0.997196261682243,0.6925233644859813,0.30467289719626167
042A,04,2A,0,1001,28,973,678,295,inf,0.027972027972027972,0.972027972027972,0.6773226773226774,0.2947052947052947
042B,04,2B,0,815,1,814,586,228,inf,0.001226993865030675,0.9987730061349693,0.7190184049079754,0.27975460122699386
042C,04,2C,0,641,3,638,464,174,inf,0.0046801872074883,0.9953198127925117,0.7238689547581904,0.2714508580343214
042D,04,2D,0,894,4,890,627,263,inf,0.0044742729306487695,0.9955257270693513,0.7013422818791947,0.2941834451901566
042E,04,2E,0,939,4,935,690,245,inf,0.004259850905218318,0.9957401490947817,0.7348242811501597,0.26091586794462196
042F,04,2F,0,774,0,774,590,184,inf,0.0,1.0,0.7622739018087855,0.23772609819121446
042G,04,2G,0,958,4,954,724,230,inf,0.0041753653444676405,0.9958246346555324,0.755741127348643,0.24008350730688935
042H,04,2H,0,949,5,944,681,263,inf,0.005268703898840885,0.9947312961011591,0.7175974710221286,0.27713382507903056
042J,04,2J,0,1040,9,1031,763,268,inf,0.008653846153846154,0.9913461538461539,0.7336538461538461,0.25769230769230766
043A,04,3A,0,1162,10,1152,808,344,inf,0.008605851979345954,0.9913941480206541,0.6953528399311532,0.29604130808950085
043B,04,3B,0,956,8,948,625,323,inf,0.008368200836820083,0.9916317991631799,0.6537656903765691,0.3378661087866109
043C,04,3C,0,995,6,989,715,274,inf,0.006030150753768844,0.9939698492462311,0.7185929648241206,0.27537688442211056
043D,04,3D,0,932,7,925,667,258,inf,0.0075107296137339056,0.9924892703862661,0.7156652360515021,0.27682403433476394
043E,04,3E,0,1005,4,1001,662,339,inf,0.003980099502487562,0.9960199004975124,0.6587064676616915,0.3373134328358209
043F,04,3F,0,1019,9,1010,668,342,inf,0.008832188420019628,0.9911678115799804,0.6555446516192346,0.3356231599607458
043G,04,3G,0,891,7,884,612,272,inf,0.007856341189674524,0.9921436588103255,0.6868686868686869,0.3052749719416386
043H,04,3H,0,801,7,794,600,194,inf,0.008739076154806492,0.9912609238451935,0.7490636704119851,0.2421972534332085
044A,04,4A,0,891,10,881,610,271,inf,0.01122334455667789,0.9887766554433222,0.6846240179573513,0.3041526374859708
044B,04,4B,0,1282,9,1273,1008,265,inf,0.0070202808112324495,0.9929797191887676,0.7862714508580343,0.20670826833073322
044C,04,4C,0,940,4,936,671,265,inf,0.00425531914893617,0.9957446808510638,0.7138297872340426,0.28191489361702127
044D,04,4D,0,1056,8,1048,755,293,inf,0.007575757575757576,0.9924242424242424,0.7149621212121212,0.2774621212121212
044E,04,4E,0,942,7,935,681,254,inf,0.0074309978768577496,0.9925690021231423,0.7229299363057324,0.26963906581740976
044F,04,4F,0,974,8,966,710,256,inf,0.008213552361396304,0.9917864476386037,0.728952772073922,0.26283367556468173
044G,04,4G,0,944,2,942,740,202,inf,0.00211864406779661,0.9978813559322034,0.7838983050847458,0.21398305084745764
044H,04,4H,0,860,5,855,670,185,inf,0.005813953488372093,0.9941860465116279,0.7790697674418605,0.21511627906976744
045A,04,5A,0,789,2,787,640,147,inf,0.0025348542458808617,0.9974651457541192,0.8111533586818758,0.18631178707224336
045B,04,5B,0,823,4,819,628,191,inf,0.004860267314702308,0.9951397326852977,0.7630619684082625,0.23207776427703525
045C,04,5C,0,811,6,805,565,240,inf,0.007398273736128237,0.9926017262638718,0.6966707768187423,0.2959309494451295
045D,04,5D,0,947,3,944,707,237,inf,0.0031678986272439284,0.996832101372756,0.7465681098204857,0.2502639915522703
045E,04,5E,0,927,3,924,668,256,inf,0.003236245954692557,0.9967637540453075,0.7206040992448759,0.2761596548004315
045F,04,5F,0,1119,10,1109,876,233,inf,0.008936550491510277,0.9910634495084897,0.7828418230563002,0.20822162645218945
045G,04,5G,0,648,3,645,510,135,inf,0.004629629629629629,0.9953703703703703,0.7870370370370371,0.20833333333333334
045H,04,5H,0,987,6,981,839,142,inf,0.0060790273556231,0.993920972644377,0.8500506585612969,0.14387031408308004
045J,04,5J,0,827,4,823,655,168,inf,0.0048367593712212815,0.9951632406287787,0.7920193470374849,0.20314389359129384
046A,04,6A,0,981,3,978,734,244,inf,0.0030581039755351682,0.9969418960244648,0.7482161060142711,0.24872579001019368
046B,04,6B,0,763,2,761,529,232,inf,0.002621231979030144,0.9973787680209698,0.6933158584534731,0.3040629095674967
046C,04,6C,0,1284,10,1274,915,359,inf,0.00778816199376947,0.9922118380062306,0.7126168224299065,0.279595015576324
046D,04,6D,0,1058,9,1049,685,364,inf,0.008506616257088847,0.9914933837429112,0.6474480151228733,0.3440453686200378
046E,04,6E,0,934,7,927,589,338,inf,0.007494646680942184,0.9925053533190579,0.6306209850107066,0.3618843683083512
046F,04,6F,0,879,3,876,586,290,inf,0.0034129692832764505,0.9965870307167235,0.6666666666666666,0.32992036405005687
046G,04,6G,0,822,5,817,473,344,inf,0.006082725060827251,0.9939172749391727,0.5754257907542579,0.41849148418491483
046H,04,6H,0,893,4,889,616,273,inf,0.004479283314669653,0.9955207166853304,0.6898096304591266,0.3057110862262038
047A,04,7A,0,907,9,898,636,262,inf,0.009922822491730982,0.9900771775082691,0.701212789415656,0.288864388092613
047B,04,7B,0,813,6,807,606,201,inf,0.007380073800738007,0.992619926199262,0.7453874538745388,0.24723247232472326
047C,04,7C,0,1008,10,998,632,366,inf,0.00992063492063492,0.9900793650793651,0.626984126984127,0.3630952380952381
047D,04,7D,0,1058,9,1049,679,370,inf,0.008506616257088847,0.9914933837429112,0.6417769376181475,0.3497164461247637
047E,04,7E,0,1061,9,1052,757,295,inf,0.008482563619227144,0.9915174363807728,0.7134778510838832,0.2780395852968897
047F,04,7F,0,1105,7,1098,738,360,inf,0.006334841628959276,0.9936651583710407,0.6678733031674208,0.3257918552036199
047G,04,7G,0,1096,2,1094,706,388,inf,0.0018248175182481751,0.9981751824817519,0.6441605839416058,0.354014598540146
047H,04,7H,0,861,5,856,627,229,inf,0.005807200929152149,0.9941927990708479,0.7282229965156795,0.2659698025551684
048A,04,8A,0,988,17,971,676,295,inf,0.01720647773279352,0.9827935222672065,0.6842105263157895,0.298582995951417
048B,04,8B,0,1183,10,1173,676,497,inf,0.0084530853761623,0.9915469146238377,0.5714285714285714,0.42011834319526625
051A,05,1A,0,780,4,776,424,352,inf,0.005128205128205128,0.9948717948717949,0.5435897435897435,0.4512820512820513
051B,05,1B,0,639,2,637,342,295,inf,0.003129890453834116,0.9968701095461658,0.5352112676056338,0.4616588419405321
051C,05,1C,0,942,5,937,446,491,inf,0.005307855626326964,0.994692144373673,0.4734607218683652,0.5212314225053079
051D,05,1D,0,716,3,713,341,372,inf,0.004189944134078212,0.9958100558659218,0.4762569832402235,0.5195530726256983
051E,05,1E,0,787,2,785,359,426,inf,0.0025412960609911056,0.9974587039390089,0.45616264294790343,0.5412960609911055
051F,05,1F,0,770,3,767,254,513,inf,0.003896103896103896,0.9961038961038962,0.32987012987012987,0.6662337662337663
051G,05,1G,0,760,1,759,412,347,inf,0.0013157894736842105,0.9986842105263158,0.5421052631578948,0.45657894736842103
051H,05,1H,0,722,1,721,362,359,inf,0.0013850415512465374,0.9986149584487535,0.5013850415512465,0.49722991689750695
052A,05,2A,0,694,2,692,316,376,inf,0.002881844380403458,0.9971181556195965,0.4553314121037464,0.5417867435158501
052B,05,2B,0,718,3,715,351,364,inf,0.004178272980501393,0.9958217270194986,0.48885793871866295,0.5069637883008357
052C,05,2C,0,716,0,716,430,286,inf,0.0,1.0,0.6005586592178771,0.3994413407821229
052D,05,2D,0,715,4,711,360,351,inf,0.005594405594405594,0.9944055944055944,0.5034965034965035,0.4909090909090909
052E,05,2E,0,611,5,606,272,334,inf,0.008183306055646482,0.9918166939443536,0.4451718494271686,0.546644844517185
052F,05,2F,0,709,4,705,511,194,inf,0.005641748942172073,0.9943582510578279,0.7207334273624824,0.2736248236953456
052G,05,2G,0,751,3,748,525,223,inf,0.0039946737683089215,0.996005326231691,0.6990679094540613,0.2969374167776298
053A,05,3A,0,687,3,684,465,219,inf,0.004366812227074236,0.9956331877729258,0.6768558951965066,0.31877729257641924
053B,05,3B,0,701,3,698,467,231,inf,0.0042796005706134095,0.9957203994293866,0.666191155492154,0.32952924393723254
053C,05,3C,0,669,5,664,450,214,inf,0.007473841554559043,0.992526158445441,0.672645739910314,0.31988041853512705
053D,05,3D,0,905,1,904,640,264,inf,0.0011049723756906078,0.9988950276243094,0.7071823204419889,0.29171270718232045
053E,05,3E,0,777,3,774,512,262,inf,0.003861003861003861,0.9961389961389961,0.6589446589446589,0.33719433719433717
053F,05,3F,0,807,4,803,444,359,inf,0.004956629491945477,0.9950433705080545,0.550185873605948,0.4448574969021066
053G,05,3G,0,793,3,790,443,347,inf,0.0037831021437578815,0.9962168978562421,0.5586380832282472,0.43757881462799497
053H,05,3H,0,875,1,874,366,508,inf,0.001142857142857143,0.9988571428571429,0.41828571428571426,0.5805714285714285
054A,05,4A,0,980,3,977,227,750,inf,0.003061224489795918,0.996938775510204,0.2316326530612245,0.7653061224489796
054B,05,4B,0,552,1,551,233,318,inf,0.0018115942028985507,0.9981884057971014,0.4221014492753623,0.5760869565217391
054C,05,4C,0,872,3,869,326,543,inf,0.0034403669724770644,0.9965596330275229,0.3738532110091743,0.6227064220183486
054D,05,4D,0,673,2,671,388,283,inf,0.0029717682020802376,0.9970282317979198,0.5765230312035661,0.42050520059435365
054E,05,4E,0,675,0,675,424,251,inf,0.0,1.0,0.6281481481481481,0.3718518518518519
054F,05,4F,0,817,2,815,530,285,inf,0.0024479804161566705,0.9975520195838433,0.6487148102815178,0.3488372093023256
054G,05,4G,0,892,5,887,508,379,inf,0.005605381165919282,0.9943946188340808,0.5695067264573991,0.4248878923766816
054H,05,4H,0,845,0,845,203,642,inf,0.0,1.0,0.24023668639053256,0.7597633136094675
055A,05,5A,0,747,2,745,497,248,inf,0.002677376171352075,0.9973226238286479,0.6653279785809906,0.3319946452476573
055B,05,5B,0,737,8,729,422,307,inf,0.010854816824966078,0.989145183175034,0.5725915875169606,0.41655359565807326
055C,05,5C,0,766,12,754,506,248,inf,0.015665796344647518,0.9843342036553525,0.660574412532637,0.3237597911227154
055D,05,5D,0,642,5,637,452,185,inf,0.00778816199376947,0.9922118380062306,0.7040498442367601,0.2881619937694704
055E,05,5E,0,618,7,611,426,185,inf,0.011326860841423949,0.988673139158576,0.6893203883495146,0.2993527508090615
055F,05,5F,0,871,4,867,585,282,inf,0.004592422502870264,0.9954075774971297,0.6716417910447762,0.3237657864523536
055G,05,5G,0,905,8,897,645,252,inf,0.008839779005524863,0.9911602209944751,0.712707182320442,0.27845303867403315
055H,05,5H,0,709,0,709,511,198,inf,0.0,1.0,0.7207334273624824,0.27926657263751764
055I,05,5I,0,547,2,545,404,141,inf,0.003656307129798903,0.9963436928702011,0.7385740402193784,0.2577696526508227
055J,05,5J,0,490,0,490,378,112,inf,0.0,1.0,0.7714285714285715,0.22857142857142856
055K,05,5K,0,568,2,566,408,158,inf,0.0035211267605633804,0.9964788732394366,0.7183098591549296,0.27816901408450706
055L,05,5L,0,614,3,611,443,168,inf,0.004885993485342019,0.995114006514658,0.7214983713355049,0.2736156351791531
061A,06,1A,0,1098,17,1081,734,347,inf,0.015482695810564663,0.9845173041894353,0.668488160291439,0.31602914389799636
061B,06,1B,0,1113,5,1108,740,368,inf,0.004492362982929021,0.995507637017071,0.6648697214734951,0.3306379155435759
061C,06,1C,0,913,8,905,583,322,inf,0.008762322015334063,0.9912376779846659,0.6385542168674698,0.35268346111719606
061D,06,1D,0,782,3,779,509,270,inf,0.0038363171355498722,0.9961636828644501,0.6508951406649617,0.3452685421994885
061E,06,1E,0,816,8,808,575,233,inf,0.00980392156862745,0.9901960784313726,0.7046568627450981,0.2855392156862745
061F,06,1F,0,804,9,795,561,234,inf,0.011194029850746268,0.9888059701492538,0.6977611940298507,0.291044776119403
061G,06,1G,0,1116,13,1103,724,379,inf,0.011648745519713262,0.9883512544802867,0.6487455197132617,0.3396057347670251
061H,06,1H,0,970,4,966,629,337,inf,0.004123711340206186,0.9958762886597938,0.6484536082474227,0.3474226804123711
061I,06,1I,0,1016,6,1010,659,351,inf,0.005905511811023622,0.9940944881889764,0.6486220472440944,0.3454724409448819
062A,06,2A,0,968,6,962,611,351,inf,0.006198347107438017,0.993801652892562,0.631198347107438,0.36260330578512395
062B,06,2B,0,802,4,798,546,252,inf,0.004987531172069825,0.9950124688279302,0.6807980049875312,0.314214463840399
062C,06,2C,0,708,2,706,502,204,inf,0.002824858757062147,0.9971751412429378,0.7090395480225988,0.288135593220339
062D,06,2D,0,911,12,899,650,249,inf,0.013172338090010977,0.986827661909989,0.7135016465422612,0.27332601536772777
062E,06,2E,0,863,7,856,577,279,inf,0.008111239860950173,0.9918887601390498,0.6685979142526072,0.32329084588644263
062F,06,2F,0,805,4,801,574,227,inf,0.004968944099378882,0.9950310559006211,0.7130434782608696,0.2819875776397516
062G,06,2G,0,1048,10,1038,710,328,inf,0.009541984732824428,0.9904580152671756,0.6774809160305344,0.31297709923664124
062H,06,2H,0,738,9,729,488,241,inf,0.012195121951219513,0.9878048780487805,0.6612466124661247,0.3265582655826558
062I,06,2I,0,893,9,884,595,289,inf,0.010078387458006719,0.9899216125419933,0.6662933930571109,0.3236282194848824
063A,06,3A,0,1095,4,1091,767,324,inf,0.0036529680365296802,0.9963470319634703,0.7004566210045662,0.2958904109589041
063B,06,3B,0,972,5,967,641,326,inf,0.0051440329218107,0.9948559670781894,0.6594650205761317,0.33539094650205764
063C,06,3C,0,950,6,944,673,271,inf,0.00631578947368421,0.9936842105263158,0.708421052631579,0.28526315789473683
063D,06,3D,0,1048,7,1041,699,342,inf,0.006679389312977099,0.9933206106870229,0.6669847328244275,0.32633587786259544
063E,06,3E,0,1241,1,1240,888,352,inf,0.0008058017727639,0.9991941982272361,0.7155519742143432,0.28364222401289285
063F,06,3F,0,1039,4,1035,746,289,inf,0.0038498556304138597,0.9961501443695862,0.7179980750721848,0.2781520692974013
063G,06,3G,0,1172,10,1162,854,308,inf,0.008532423208191127,0.9914675767918089,0.7286689419795221,0.2627986348122867
063H,06,3H,0,1084,9,1075,788,287,inf,0.008302583025830259,0.9916974169741697,0.7269372693726938,0.26476014760147604
063I,06,3I,0,1151,8,1143,847,296,inf,0.0069504778453518675,0.9930495221546481,0.735881841876629,0.2571676802780191
064A,06,4A,0,875,4,871,643,228,inf,0.004571428571428572,0.9954285714285714,0.7348571428571429,0.26057142857142856
064B,06,4B,0,934,6,928,667,261,inf,0.006423982869379015,0.9935760171306209,0.7141327623126338,0.27944325481798715
064C,06,4C,0,1026,6,1020,679,341,inf,0.005847953216374269,0.9941520467836257,0.6617933723196882,0.33235867446393763
064D,06,4D,0,805,4,801,578,223,inf,0.004968944099378882,0.9950310559006211,0.7180124223602484,0.27701863354037265
064E,06,4E,0,1014,8,1006,732,274,inf,0.007889546351084813,0.9921104536489151,0.7218934911242604,0.2702169625246548
064F,06,4F,0,889,0,889,672,217,inf,0.0,1.0,0.7559055118110236,0.2440944881889764
064G,06,4G,0,876,7,869,643,226,inf,0.007990867579908675,0.9920091324200914,0.7340182648401826,0.2579908675799087
064H,06,4H,0,846,3,843,597,246,inf,0.0035460992907801418,0.9964539007092199,0.7056737588652482,0.2907801418439716
065A,06,5A,0,750,5,745,522,223,inf,0.006666666666666667,0.9933333333333333,0.696,0.29733333333333334
065B,06,5B,0,981,8,973,684,289,inf,0.00815494393476045,0.9918450560652395,0.6972477064220184,0.2945973496432212
065C,06,5C,0,649,8,641,467,174,inf,0.012326656394453005,0.987673343605547,0.7195685670261941,0.26810477657935283
065D,06,5D,0,845,3,842,597,245,inf,0.0035502958579881655,0.9964497041420118,0.7065088757396449,0.28994082840236685
065E,06,5E,0,748,6,742,523,219,inf,0.008021390374331552,0.9919786096256684,0.6991978609625669,0.2927807486631016
065F,06,5F,0,580,0,580,450,130,inf,0.0,1.0,0.7758620689655172,0.22413793103448276
065G,06,5G,0,701,8,693,545,148,inf,0.011412268188302425,0.9885877318116976,0.7774607703281027,0.21112696148359486
065H,06,5H,0,785,0,785,599,186,inf,0.0,1.0,0.7630573248407644,0.23694267515923567
065I,06,5I,0,553,2,551,422,129,inf,0.003616636528028933,0.9963833634719711,0.7631103074141049,0.2332730560578662
066A,06,6A,0,882,5,877,610,267,inf,0.005668934240362812,0.9943310657596371,0.691609977324263,0.30272108843537415
066B,06,6B,0,872,11,861,582,279,inf,0.01261467889908257,0.9873853211009175,0.6674311926605505,0.31995412844036697
066C,06,6C,0,1004,4,1000,692,308,inf,0.00398406374501992,0.9960159362549801,0.6892430278884463,0.30677290836653387
066D,06,6D,0,1060,7,1053,734,319,inf,0.006603773584905661,0.9933962264150943,0.6924528301886792,0.3009433962264151
066E,06,6E,0,1164,8,1156,860,296,inf,0.006872852233676976,0.993127147766323,0.738831615120275,0.2542955326460481
066F,06,6F,0,1069,10,1059,739,320,inf,0.009354536950420954,0.990645463049579,0.6913002806361085,0.2993451824134705
066G,06,6G,0,880,8,872,641,231,inf,0.00909090909090909,0.990909090909091,0.7284090909090909,0.2625
066H,06,6H,0,1024,11,1013,690,323,inf,0.0107421875,0.9892578125,0.673828125,0.3154296875
066I,06,6I,0,1563,5,1558,1256,302,inf,0.003198976327575176,0.9968010236724248,0.8035828534868842,0.19321817018554063
067A,06,7A,0,832,5,827,614,213,inf,0.006009615384615385,0.9939903846153846,0.7379807692307693,0.25600961538461536
067B,06,7B,0,1000,4,996,753,243,inf,0.004,0.996,0.753,0.243
067C,06,7C,0,819,0,819,611,208,inf,0.0,1.0,0.746031746031746,0.25396825396825395
067D,06,7D,0,1157,3,1154,846,308,inf,0.0025929127052722557,0.9974070872947277,0.7312013828867762,0.2662057044079516
067E,06,7E,0,891,7,884,642,242,inf,0.007856341189674524,0.9921436588103255,0.7205387205387206,0.2716049382716049
067F,06,7F,0,908,5,903,629,274,inf,0.005506607929515419,0.9944933920704846,0.6927312775330396,0.30176211453744495
067G,06,7G,0,1181,1,1180,875,305,inf,0.000846740050804403,0.9991532599491956,0.7408975444538527,0.25825571549534293
067H,06,7H,0,1270,10,1260,900,360,inf,0.007874015748031496,0.9921259842519685,0.7086614173228346,0.28346456692913385
067I,06,7I,0,1067,8,1059,788,271,inf,0.007497656982193065,0.9925023430178069,0.7385192127460168,0.2539831302717901
071A,07,1A,0,860,4,856,620,236,inf,0.004651162790697674,0.9953488372093023,0.7209302325581395,0.2744186046511628
071B,07,1B,0,630,7,623,364,259,inf,0.011111111111111112,0.9888888888888889,0.5777777777777777,0.4111111111111111
071C,07,1C,0,762,12,750,378,372,inf,0.015748031496062992,0.984251968503937,0.49606299212598426,0.4881889763779528
071D,07,1D,0,781,3,778,428,350,inf,0.0038412291933418692,0.9961587708066582,0.5480153649167734,0.44814340588988477
071E,07,1E,0,1173,1,1172,719,453,inf,0.0008525149190110827,0.9991474850809889,0.6129582267689685,0.38618925831202044
071F,07,1F,0,1055,1,1054,700,354,inf,0.0009478672985781991,0.9990521327014218,0.6635071090047393,0.3355450236966825
071G,07,1G,0,1068,11,1057,650,407,inf,0.010299625468164793,0.9897003745318352,0.6086142322097379,0.38108614232209737
071H,07,1H,0,989,3,986,666,320,inf,0.003033367037411527,0.9969666329625885,0.673407482305359,0.3235591506572295
071I,07,1I,0,883,8,875,515,360,inf,0.009060022650056626,0.9909399773499433,0.5832389580973952,0.40770101925254815
072A,07,2A,0,1110,13,1097,668,429,inf,0.011711711711711712,0.9882882882882883,0.6018018018018018,0.3864864864864865
072B,07,2B,0,1103,20,1083,901,182,inf,0.01813236627379873,0.9818676337262012,0.8168631006346329,0.16500453309156846
072C,07,2C,0,791,6,785,398,387,inf,0.007585335018963337,0.9924146649810367,0.5031605562579013,0.4892541087231353
072D,07,2D,0,732,7,725,403,322,inf,0.009562841530054645,0.9904371584699454,0.5505464480874317,0.43989071038251365
072E,07,2E,0,803,16,787,385,402,inf,0.019925280199252802,0.9800747198007472,0.4794520547945205,0.5006226650062267
072F,07,2F,0,821,9,812,334,478,inf,0.010962241169305725,0.9890377588306942,0.40682095006090135,0.582216808769793
072G,07,2G,0,956,10,946,574,372,inf,0.010460251046025104,0.9895397489539749,0.600418410041841,0.3891213389121339
072H,07,2H,0,950,6,944,466,478,inf,0.00631578947368421,0.9936842105263158,0.4905263157894737,0.5031578947368421
072I,07,2I,0,604,5,599,268,331,inf,0.008278145695364239,0.9917218543046358,0.44370860927152317,0.5480132450331126
073A,07,3A,0,1005,11,994,565,429,inf,0.010945273631840797,0.9890547263681592,0.5621890547263682,0.42686567164179107
073B,07,3B,0,885,7,878,488,390,inf,0.007909604519774011,0.992090395480226,0.5514124293785311,0.4406779661016949
073C,07,3C,0,1077,6,1071,584,487,inf,0.005571030640668524,0.9944289693593314,0.542246982358403,0.4521819870009285
073D,07,3D,0,1043,5,1038,552,486,inf,0.004793863854266539,0.9952061361457335,0.5292425695110259,0.46596356663470756
073E,07,3E,0,1139,5,1134,623,511,inf,0.004389815627743635,0.9956101843722563,0.5469710272168569,0.4486391571553995
073F,07,3F,0,900,4,896,545,351,inf,0.0044444444444444444,0.9955555555555555,0.6055555555555555,0.39
073G,07,3G,0,1164,5,1159,696,463,inf,0.00429553264604811,0.9957044673539519,0.5979381443298969,0.39776632302405496
073H,07,3H,0,620,6,614,306,308,inf,0.00967741935483871,0.9903225806451613,0.4935483870967742,0.4967741935483871
073I,07,3I,0,635,9,626,380,246,inf,0.014173228346456693,0.9858267716535433,0.5984251968503937,0.38740157480314963
073K,07,3K,0,702,3,699,519,180,inf,0.004273504273504274,0.9957264957264957,0.7393162393162394,0.2564102564102564
074A,07,4A,0,938,7,931,476,455,inf,0.007462686567164179,0.9925373134328358,0.5074626865671642,0.48507462686567165
074B,07,4B,0,843,7,836,462,374,inf,0.00830367734282325,0.9916963226571768,0.5480427046263345,0.44365361803084225
074C,07,4C,0,855,16,839,558,281,inf,0.01871345029239766,0.9812865497076023,0.6526315789473685,0.3286549707602339
074D,07,4D,0,1055,9,1046,749,297,inf,0.008530805687203791,0.9914691943127962,0.7099526066350711,0.28151658767772514
074E,07,4E,0,1069,7,1062,703,359,inf,0.006548175865294668,0.9934518241347053,0.6576239476145931,0.33582787652011226
074F,07,4F,0,819,6,813,506,307,inf,0.007326007326007326,0.9926739926739927,0.6178266178266179,0.37484737484737485
074G,07,4G,0,1018,15,1003,574,429,inf,0.014734774066797643,0.9852652259332023,0.5638506876227898,0.4214145383104126
074H,07,4H,0,1010,8,1002,620,382,inf,0.007920792079207921,0.9920792079207921,0.6138613861386139,0.3782178217821782
074I,07,4I,0,326,2,324,198,126,inf,0.006134969325153374,0.9938650306748467,0.6073619631901841,0.38650306748466257
075A,07,5A,0,824,4,820,581,239,inf,0.0048543689320388345,0.9951456310679612,0.7050970873786407,0.29004854368932037
075B,07,5B,0,756,9,747,504,243,inf,0.011904761904761904,0.9880952380952381,0.6666666666666666,0.32142857142857145
075C,07,5C,0,741,4,737,495,242,inf,0.005398110661268556,0.9946018893387314,0.6680161943319838,0.3265856950067476
075D,07,5D,0,875,8,867,629,238,inf,0.009142857142857144,0.9908571428571429,0.7188571428571429,0.272
075E,07,5E,0,993,5,988,724,264,inf,0.005035246727089627,0.9949647532729103,0.729103726082578,0.26586102719033233
075F,07,5F,0,681,3,678,489,189,inf,0.004405286343612335,0.9955947136563876,0.7180616740088106,0.2775330396475771
075G,07,5G,0,853,6,847,661,186,inf,0.007033997655334115,0.9929660023446659,0.7749120750293084,0.21805392731535755
075H,07,5H,0,915,6,909,636,273,inf,0.006557377049180328,0.9934426229508196,0.6950819672131148,0.2983606557377049
075I,07,5I,0,519,3,516,361,155,inf,0.005780346820809248,0.9942196531791907,0.6955684007707129,0.29865125240847784
076A,07,6A,0,877,12,865,622,243,inf,0.013683010262257697,0.9863169897377423,0.7092360319270239,0.27708095781071834
076B,07,6B,0,1202,10,1192,844,348,inf,0.008319467554076539,0.9916805324459235,0.7021630615640599,0.2895174708818636
076C,07,6C,0,813,10,803,582,221,inf,0.012300123001230012,0.9876998769987699,0.7158671586715867,0.27183271832718325
076D,07,6D,0,655,1,654,460,194,inf,0.0015267175572519084,0.9984732824427481,0.7022900763358778,0.2961832061068702
076E,07,6E,0,834,1,833,664,169,inf,0.001199040767386091,0.9988009592326139,0.7961630695443646,0.2026378896882494
076F,07,6F,0,568,6,562,424,138,inf,0.01056338028169014,0.9894366197183099,0.7464788732394366,0.24295774647887325
076G,07,6G,0,644,1,643,492,151,inf,0.0015527950310559005,0.9984472049689441,0.7639751552795031,0.234472049689441
076H,07,6H,0,1059,2,1057,804,253,inf,0.0018885741265344666,0.9981114258734656,0.7592067988668555,0.23890462700661
076I,07,6I,0,572,0,572,428,144,inf,0.0,1.0,0.7482517482517482,0.2517482517482518
077A,07,7A,0,984,8,976,740,236,inf,0.008130081300813009,0.991869918699187,0.7520325203252033,0.23983739837398374
077B,07,7B,0,1018,4,1014,763,251,inf,0.003929273084479371,0.9960707269155207,0.74950884086444,0.24656188605108054
077C,07,7C,0,857,4,853,642,211,inf,0.004667444574095682,0.9953325554259043,0.7491248541423571,0.24620770128354727
077D,07,7D,0,1008,7,1001,781,220,inf,0.006944444444444444,0.9930555555555556,0.7748015873015873,0.21825396825396826
077E,07,7E,0,706,7,699,539,160,inf,0.009915014164305949,0.990084985835694,0.7634560906515581,0.22662889518413598
077F,07,7F,0,683,7,676,551,125,inf,0.010248901903367497,0.9897510980966325,0.8067349926793558,0.18301610541727673
077G,07,7G,0,804,6,798,624,174,inf,0.007462686567164179,0.9925373134328358,0.7761194029850746,0.21641791044776118
077H,07,7H,0,877,11,866,724,142,inf,0.012542759407069556,0.9874572405929305,0.8255416191562144,0.1619156214367161
077I,07,7I,0,874,5,869,626,243,inf,0.005720823798627002,0.994279176201373,0.7162471395881007,0.2780320366132723
081A,08,1A,0,1114,16,1098,462,636,inf,0.01436265709156194,0.9856373429084381,0.414721723518851,0.5709156193895871
081B,08,1B,0,1054,20,1034,415,619,inf,0.018975332068311195,0.9810246679316889,0.3937381404174573,0.5872865275142315
081C,08,1C,0,941,12,929,419,510,inf,0.012752391073326248,0.9872476089266737,0.4452709883103082,0.5419766206163655
081D,08,1D,0,1034,21,1013,478,535,inf,0.020309477756286266,0.9796905222437138,0.4622823984526112,0.5174081237911026
081E,08,1E,0,909,14,895,452,443,inf,0.015401540154015401,0.9845984598459846,0.49724972497249725,0.48734873487348734
081F,08,1F,0,886,15,871,437,434,inf,0.016930022573363433,0.9830699774266366,0.4932279909706546,0.4898419864559819
082A,08,2A,0,469,13,456,286,170,inf,0.02771855010660981,0.9722814498933902,0.6098081023454158,0.3624733475479744
082B,08,2B,0,1247,16,1231,547,684,inf,0.012830793905372895,0.9871692060946271,0.43865276663993585,0.5485164394546913
082C,08,2C,0,1197,19,1178,470,708,inf,0.015873015873015872,0.9841269841269841,0.39264828738512947,0.5914786967418546
082D,08,2D,0,1222,13,1209,552,657,inf,0.010638297872340425,0.9893617021276596,0.45171849427168576,0.5376432078559739
082E,08,2E,0,1373,21,1352,612,740,inf,0.01529497450837582,0.9847050254916242,0.4457392571012382,0.538965768390386
083A,08,3A,0,967,15,952,352,600,inf,0.015511892450879007,0.984488107549121,0.3640124095139607,0.6204756980351603
083B,08,3B,0,937,14,923,361,562,inf,0.014941302027748132,0.9850586979722519,0.3852721451440768,0.5997865528281751
083C,08,3C,0,1181,115,1066,451,615,inf,0.09737510584250635,0.9026248941574937,0.38187976291278575,0.5207451312447079
083D,08,3D,0,1005,11,994,520,474,inf,0.010945273631840797,0.9890547263681592,0.5174129353233831,0.4716417910447761
083E,08,3E,0,1003,15,988,663,325,inf,0.014955134596211365,0.9850448654037887,0.6610169491525424,0.3240279162512463
084A,08,4A,0,1121,13,1108,613,495,inf,0.01159678858162355,0.9884032114183765,0.5468331846565566,0.4415700267618198
084B,08,4B,0,1035,11,1024,696,328,inf,0.010628019323671498,0.9893719806763285,0.672463768115942,0.3169082125603865
084C,08,4C,0,1198,11,1187,809,378,inf,0.009181969949916527,0.9908180300500835,0.6752921535893155,0.31552587646076796
084D,08,4D,0,847,5,842,582,260,inf,0.0059031877213695395,0.9940968122786304,0.6871310507674144,0.3069657615112161
084E,08,4E,0,1215,4,1211,889,322,inf,0.0032921810699588477,0.9967078189300411,0.731687242798354,0.2650205761316872
084F,08,4F,0,986,4,982,732,250,inf,0.004056795131845842,0.9959432048681541,0.742393509127789,0.2535496957403651
085A,08,5A,0,1060,110,950,709,241,inf,0.10377358490566038,0.8962264150943396,0.6688679245283019,0.22735849056603774
085B,08,5B,0,944,2,942,663,279,inf,0.00211864406779661,0.9978813559322034,0.7023305084745762,0.2955508474576271
085C,08,5C,0,1049,4,1045,767,278,inf,0.0038131553860819827,0.996186844613918,0.7311725452812202,0.2650142993326978
085D,08,5D,0,932,3,929,712,217,inf,0.003218884120171674,0.9967811158798283,0.7639484978540773,0.23283261802575106
085E,08,5E,0,1114,5,1109,820,289,inf,0.004488330341113106,0.9955116696588869,0.7360861759425493,0.2594254937163375
085F,08,5F,0,810,62,748,544,204,inf,0.07654320987654321,0.9234567901234568,0.671604938271605,0.2518518518518518
086A,08,6A,0,826,4,822,595,227,inf,0.004842615012106538,0.9951573849878934,0.7203389830508474,0.274818401937046
086B,08,6B,0,709,1,708,534,174,inf,0.0014104372355430183,0.998589562764457,0.7531734837799718,0.2454160789844852
086C,08,6C,0,870,5,865,636,229,inf,0.005747126436781609,0.9942528735632183,0.7310344827586207,0.2632183908045977
086D,08,6D,0,756,4,752,564,188,inf,0.005291005291005291,0.9947089947089947,0.746031746031746,0.24867724867724866
086E,08,6E,0,875,11,864,629,235,inf,0.012571428571428572,0.9874285714285714,0.7188571428571429,0.26857142857142857
086F,08,6F,0,716,6,710,523,187,inf,0.008379888268156424,0.9916201117318436,0.7304469273743017,0.2611731843575419
087A,08,7A,0,1161,9,1152,830,322,inf,0.007751937984496124,0.9922480620155039,0.7149009474590869,0.27734711455641686
087B,08,7B,0,1012,106,906,676,230,inf,0.10474308300395258,0.8952569169960475,0.6679841897233202,0.22727272727272727
087C,08,7C,0,1062,10,1052,744,308,inf,0.009416195856873822,0.9905838041431262,0.7005649717514124,0.2900188323917137
087D,08,7D,0,860,3,857,636,221,inf,0.0034883720930232558,0.9965116279069768,0.7395348837209302,0.2569767441860465
087E,08,7E,0,1026,2,1024,737,287,inf,0.001949317738791423,0.9980506822612085,0.7183235867446394,0.2797270955165692
087F,08,7F,0,803,2,801,579,222,inf,0.0024906600249066002,0.9975093399750934,0.7210460772104608,0.2764632627646326
091A,09,1A,0,1319,15,1304,542,762,inf,0.011372251705837756,0.9886277482941622,0.41091736163760423,0.577710386656558
091B,09,1B,0,1858,19,1839,820,1019,inf,0.01022604951560818,0.9897739504843919,0.4413347685683531,0.5484391819160388
091C,09,1C,0,1032,0,1032,514,518,inf,0.0,1.0,0.49806201550387597,0.501937984496124
091D,09,1D,0,1036,9,1027,485,542,inf,0.008687258687258687,0.9913127413127413,0.46814671814671815,0.5231660231660231
091E,09,1E,0,1442,14,1428,719,709,inf,0.009708737864077669,0.9902912621359223,0.4986130374479889,0.49167822468793343
092A,09,2A,0,1405,11,1394,743,651,inf,0.007829181494661922,0.9921708185053381,0.5288256227758007,0.46334519572953736
092B,09,2B,0,1198,0,1198,636,562,inf,0.0,1.0,0.5308848080133556,0.4691151919866444
092C,09,2C,0,802,3,799,425,374,inf,0.003740648379052369,0.9962593516209476,0.529925187032419,0.46633416458852867
092D,09,2D,0,788,7,781,409,372,inf,0.008883248730964468,0.9911167512690355,0.5190355329949239,0.4720812182741117
092E,09,2E,0,1016,14,1002,503,499,inf,0.013779527559055118,0.9862204724409449,0.4950787401574803,0.4911417322834646
092F,09,2F,0,1218,18,1200,620,580,inf,0.014778325123152709,0.9852216748768473,0.5090311986863711,0.47619047619047616
093A,09,3A,0,1334,16,1318,642,676,inf,0.01199400299850075,0.9880059970014993,0.48125937031484256,0.5067466266866567
093B,09,3B,0,1348,14,1334,706,628,inf,0.010385756676557863,0.9896142433234422,0.5237388724035609,0.4658753709198813
093C,09,3C,0,1328,5,1323,810,513,inf,0.0037650602409638554,0.9962349397590361,0.6099397590361446,0.38629518072289154
093D,09,3D,0,1128,5,1123,668,455,inf,0.004432624113475178,0.9955673758865248,0.5921985815602837,0.4033687943262411
093E,09,3E,0,824,4,820,488,332,inf,0.0048543689320388345,0.9951456310679612,0.5922330097087378,0.4029126213592233
094A,09,4A,0,1391,11,1380,1328,52,inf,0.007907979870596693,0.9920920201294033,0.9547088425593099,0.037383177570093455
094B,09,4B,0,1139,12,1127,672,455,inf,0.010535557506584723,0.9894644424934153,0.5899912203687445,0.3994732221246708
094C,09,4C,0,1347,9,1338,687,651,inf,0.0066815144766146995,0.9933184855233853,0.5100222717149221,0.48329621380846327
094D,09,4D,0,1172,20,1152,614,538,inf,0.017064846416382253,0.9829351535836177,0.5238907849829352,0.4590443686006826
094E,09,4E,0,1429,4,1425,1179,246,inf,0.0027991602519244225,0.9972008397480756,0.8250524842547236,0.172148355493352
095A,09,5A,0,1068,10,1058,591,467,inf,0.009363295880149813,0.9906367041198502,0.5533707865168539,0.43726591760299627
095B,09,5B,0,1126,11,1115,616,499,inf,0.009769094138543518,0.9902309058614565,0.5470692717584369,0.44316163410301956
095C,09,5C,0,897,11,886,524,362,inf,0.012263099219620958,0.987736900780379,0.5841694537346711,0.4035674470457079
095D,09,5D,0,1281,34,1247,758,489,inf,0.02654176424668228,0.9734582357533177,0.5917252146760343,0.38173302107728335
095E,09,5E,0,1109,4,1105,966,139,inf,0.0036068530207394047,0.9963931469792606,0.8710550045085663,0.12533814247069433
096A,09,6A,0,1339,9,1330,837,493,inf,0.006721433905899925,0.9932785660941,0.6250933532486931,0.368185212845407
096B,09,6B,0,1376,13,1363,851,512,inf,0.00944767441860465,0.9905523255813954,0.6184593023255814,0.37209302325581395
096C,09,6C,0,1148,1,1147,640,507,inf,0.0008710801393728223,0.9991289198606271,0.5574912891986062,0.4416376306620209
096D,09,6D,0,1193,15,1178,622,556,inf,0.012573344509639563,0.9874266554903605,0.5213746856663872,0.4660519698239732
096E,09,6E,0,1502,5,1497,1129,368,inf,0.003328894806924101,0.9966711051930759,0.751664447403462,0.24500665778961384
101A,10,1A,0,386,2,384,190,194,inf,0.0051813471502590676,0.9948186528497409,0.49222797927461137,0.5025906735751295
101B,10,1B,0,321,0,321,177,144,inf,0.0,1.0,0.5514018691588785,0.4485981308411215
101C,10,1C,0,454,3,451,240,211,inf,0.006607929515418502,0.9933920704845814,0.5286343612334802,0.4647577092511013
101D,10,1D,0,438,1,437,216,221,inf,0.00228310502283105,0.997716894977169,0.4931506849315068,0.5045662100456622
101E,10,1E,0,640,11,629,321,308,inf,0.0171875,0.9828125,0.5015625,0.48125
101F,10,1F,0,570,1,569,286,283,inf,0.0017543859649122807,0.9982456140350877,0.5017543859649123,0.4964912280701754
101G,10,1G,0,315,0,315,151,164,inf,0.0,1.0,0.4793650793650794,0.5206349206349207
101H,10,1H,0,396,3,393,221,172,inf,0.007575757575757576,0.9924242424242424,0.5580808080808081,0.43434343434343436
102A,10,2A,0,515,0,515,281,234,inf,0.0,1.0,0.545631067961165,0.45436893203883494
102B,10,2B,0,495,6,489,236,253,inf,0.012121212121212121,0.9878787878787879,0.4767676767676768,0.5111111111111111
102C,10,2C,0,400,2,398,202,196,inf,0.005,0.995,0.505,0.49
102D,10,2D,0,513,3,510,239,271,inf,0.005847953216374269,0.9941520467836257,0.46588693957115007,0.5282651072124757
102E,10,2E,0,372,4,368,193,175,inf,0.010752688172043012,0.989247311827957,0.5188172043010753,0.47043010752688175
102F,10,2F,0,412,3,409,186,223,inf,0.007281553398058253,0.9927184466019418,0.45145631067961167,0.5412621359223301
102G,10,2G,0,501,3,498,230,268,inf,0.005988023952095809,0.9940119760479041,0.4590818363273453,0.5349301397205589
102H,10,2H,0,277,2,275,101,174,inf,0.007220216606498195,0.9927797833935018,0.36462093862815886,0.628158844765343
102J,10,2J,0,295,2,293,153,140,inf,0.006779661016949152,0.9932203389830508,0.5186440677966102,0.4745762711864407
102K,10,2K,0,325,4,321,149,172,inf,0.012307692307692308,0.9876923076923076,0.4584615384615385,0.5292307692307693
102L,10,2L,0,426,0,426,218,208,inf,0.0,1.0,0.5117370892018779,0.48826291079812206
102M,10,2M,0,343,1,342,183,159,inf,0.0029154518950437317,0.9970845481049563,0.5335276967930029,0.46355685131195334
103A,10,3A,0,360,1,359,188,171,inf,0.002777777777777778,0.9972222222222222,0.5222222222222223,0.475
103B,10,3B,0,306,3,303,186,117,inf,0.00980392156862745,0.9901960784313726,0.6078431372549019,0.38235294117647056
103C,10,3C,0,448,0,448,233,215,inf,0.0,1.0,0.5200892857142857,0.4799107142857143
103D,10,3D,0,390,3,387,216,171,inf,0.007692307692307693,0.9923076923076923,0.5538461538461539,0.43846153846153846
103E,10,3E,0,473,0,473,275,198,inf,0.0,1.0,0.5813953488372093,0.4186046511627907
103F,10,3F,0,482,2,480,260,220,inf,0.004149377593360996,0.995850622406639,0.5394190871369294,0.45643153526970953
103G,10,3G,0,515,9,506,263,243,inf,0.017475728155339806,0.9825242718446602,0.5106796116504855,0.47184466019417476
103H,10,3H,0,556,2,554,310,244,inf,0.0035971223021582736,0.9964028776978417,0.5575539568345323,0.43884892086330934
104A,10,4A,0,276,3,273,122,151,inf,0.010869565217391304,0.9891304347826086,0.4420289855072464,0.5471014492753623
104B,10,4B,0,576,9,567,300,267,inf,0.015625,0.984375,0.5208333333333334,0.4635416666666667
104C,10,4C,0,323,2,321,151,170,inf,0.006191950464396285,0.9938080495356038,0.4674922600619195,0.5263157894736842
104D,10,4D,0,513,7,506,223,283,inf,0.01364522417153996,0.98635477582846,0.4346978557504873,0.5516569200779727
104E,10,4E,0,337,2,335,126,209,inf,0.005934718100890208,0.9940652818991098,0.37388724035608306,0.6201780415430267
104F,10,4F,0,406,2,404,167,237,inf,0.0049261083743842365,0.9950738916256158,0.41133004926108374,0.583743842364532
104G,10,4G,0,529,2,527,246,281,inf,0.003780718336483932,0.996219281663516,0.46502835538752363,0.5311909262759924
104H,10,4H,0,448,0,448,190,258,inf,0.0,1.0,0.42410714285714285,0.5758928571428571
104J,10,4J,0,443,8,435,215,220,inf,0.01805869074492099,0.981941309255079,0.4853273137697517,0.4966139954853273
104K,10,4K,0,574,10,564,288,276,inf,0.017421602787456445,0.9825783972125436,0.5017421602787456,0.4808362369337979
104L,10,4L,0,458,4,454,193,261,inf,0.008733624454148471,0.9912663755458515,0.42139737991266374,0.5698689956331878
104M,10,4M,0,441,4,437,191,246,inf,0.009070294784580499,0.9909297052154195,0.4331065759637188,0.5578231292517006
104N,10,4N,0,425,3,422,182,240,inf,0.007058823529411765,0.9929411764705882,0.42823529411764705,0.5647058823529412
104P,10,4P,0,537,1,536,260,276,inf,0.00186219739292365,0.9981378026070763,0.48417132216014896,0.5139664804469274
105A,10,5A,0,443,6,437,213,224,inf,0.013544018058690745,0.9864559819413092,0.48081264108352145,0.5056433408577878
105B,10,5B,0,480,2,478,204,274,inf,0.004166666666666667,0.9958333333333333,0.425,0.5708333333333333
105C,10,5C,0,407,3,404,194,210,inf,0.007371007371007371,0.9926289926289926,0.47665847665847666,0.515970515970516
105D,10,5D,0,453,0,453,191,262,inf,0.0,1.0,0.4216335540838852,0.5783664459161147
105E,10,5E,0,399,1,398,191,207,inf,0.002506265664160401,0.9974937343358395,0.47869674185463656,0.518796992481203
105F,10,5F,0,410,7,403,179,224,inf,0.01707317073170732,0.9829268292682927,0.43658536585365854,0.5463414634146342
105G,10,5G,0,335,5,330,159,171,inf,0.014925373134328358,0.9850746268656716,0.4746268656716418,0.5104477611940299
105H,10,5H,0,333,0,333,157,176,inf,0.0,1.0,0.47147147147147145,0.5285285285285285
105J,10,5J,0,349,3,346,186,160,inf,0.008595988538681949,0.9914040114613181,0.5329512893982808,0.4584527220630373
105K,10,5K,0,399,1,398,182,216,inf,0.002506265664160401,0.9974937343358395,0.45614035087719296,0.5413533834586466
105L,10,5L,0,443,1,442,212,230,inf,0.002257336343115124,0.9977426636568849,0.4785553047404063,0.5191873589164786
105M,10,5M,0,319,2,317,135,182,inf,0.006269592476489028,0.9937304075235109,0.4231974921630094,0.5705329153605015
105N,10,5N,0,423,4,419,175,244,inf,0.009456264775413711,0.9905437352245863,0.41371158392434987,0.5768321513002365
105P,10,5P,0,516,5,511,279,232,inf,0.009689922480620155,0.9903100775193798,0.5406976744186046,0.4496124031007752
105Q,10,5Q,0,461,1,460,216,244,inf,0.0021691973969631237,0.9978308026030369,0.4685466377440347,0.5292841648590022
105R,10,5R,0,425,3,422,186,236,inf,0.007058823529411765,0.9929411764705882,0.4376470588235294,0.5552941176470588
105S,10,5S,0,507,4,503,202,301,inf,0.007889546351084813,0.9921104536489151,0.398422090729783,0.5936883629191322
106A,10,6A,0,360,5,355,204,151,inf,0.013888888888888888,0.9861111111111112,0.5666666666666667,0.41944444444444445
106B,10,6B,0,547,7,540,318,222,inf,0.012797074954296161,0.9872029250457038,0.5813528336380256,0.40585009140767825
106C,10,6C,0,320,5,315,153,162,inf,0.015625,0.984375,0.478125,0.50625
106D,10,6D,0,636,0,636,315,321,inf,0.0,1.0,0.49528301886792453,0.5047169811320755
106E,10,6E,0,405,2,403,199,204,inf,0.0049382716049382715,0.9950617283950617,0.49135802469135803,0.5037037037037037
106F,10,6F,0,296,6,290,140,150,inf,0.02027027027027027,0.9797297297297297,0.47297297297297297,0.5067567567567568
106G,10,6G,0,655,6,649,307,342,inf,0.00916030534351145,0.9908396946564886,0.4687022900763359,0.5221374045801527
106H,10,6H,0,482,2,480,192,288,inf,0.004149377593360996,0.995850622406639,0.3983402489626556,0.5975103734439834
106J,10,6J,0,420,6,414,231,183,inf,0.014285714285714285,0.9857142857142858,0.55,0.4357142857142857
106K,10,6K,0,396,5,391,222,169,inf,0.012626262626262626,0.9873737373737373,0.5606060606060606,0.42676767676767674
111A,11,1A,0,394,2,392,136,256,inf,0.005076142131979695,0.9949238578680203,0.34517766497461927,0.649746192893401
111B,11,1B,0,774,0,774,192,582,inf,0.0,1.0,0.24806201550387597,0.751937984496124
111C,11,1C,0,474,2,472,181,291,inf,0.004219409282700422,0.9957805907172996,0.3818565400843882,0.6139240506329114
111D,11,1D,0,582,5,577,247,330,inf,0.00859106529209622,0.9914089347079038,0.42439862542955326,0.5670103092783505
111E,11,1E,0,538,2,536,239,297,inf,0.0037174721189591076,0.9962825278810409,0.44423791821561337,0.5520446096654275
111F,11,1F,0,489,1,488,201,287,inf,0.002044989775051125,0.9979550102249489,0.4110429447852761,0.5869120654396728
111G,11,1G,0,473,2,471,220,251,inf,0.004228329809725159,0.9957716701902748,0.46511627906976744,0.5306553911205074
111H,11,1H,0,579,8,571,260,311,inf,0.013816925734024179,0.9861830742659758,0.44905008635578586,0.5371329879101899
112A,11,2A,0,514,1,513,165,348,inf,0.0019455252918287938,0.9980544747081712,0.321011673151751,0.6770428015564203
112B,11,2B,0,430,0,430,186,244,inf,0.0,1.0,0.4325581395348837,0.5674418604651162
112C,11,2C,0,323,0,323,152,171,inf,0.0,1.0,0.47058823529411764,0.5294117647058824
112D,11,2D,0,550,1,549,273,276,inf,0.0018181818181818182,0.9981818181818182,0.49636363636363634,0.5018181818181818
112E,11,2E,0,761,5,756,230,526,inf,0.006570302233902759,0.9934296977660972,0.30223390275952694,0.6911957950065704
112F,11,2F,0,604,7,597,268,329,inf,0.011589403973509934,0.9884105960264901,0.44370860927152317,0.5447019867549668
112G,11,2G,0,696,6,690,274,416,inf,0.008620689655172414,0.9913793103448276,0.3936781609195402,0.5977011494252874
112H,11,2H,0,483,1,482,209,273,inf,0.002070393374741201,0.9979296066252588,0.432712215320911,0.5652173913043478
112I,11,2I,0,369,4,365,184,181,inf,0.01084010840108401,0.989159891598916,0.4986449864498645,0.4905149051490515
112J,11,2J,0,473,2,471,253,218,inf,0.004228329809725159,0.9957716701902748,0.5348837209302325,0.4608879492600423
113A,11,3A,0,536,22,514,294,220,inf,0.041044776119402986,0.9589552238805971,0.5485074626865671,0.41044776119402987
113B,11,3B,0,542,4,538,266,272,inf,0.007380073800738007,0.992619926199262,0.4907749077490775,0.5018450184501845
113C,11,3C,0,382,1,381,203,178,inf,0.002617801047120419,0.9973821989528796,0.5314136125654451,0.46596858638743455
113D,11,3D,0,346,3,343,175,168,inf,0.008670520231213872,0.9913294797687862,0.5057803468208093,0.48554913294797686
113E,11,3E,0,462,1,461,231,230,inf,0.0021645021645021645,0.9978354978354979,0.5,0.49783549783549785
113F,11,3F,0,505,2,503,235,268,inf,0.0039603960396039604,0.996039603960396,0.46534653465346537,0.5306930693069307
113G,11,3G,0,511,6,505,236,269,inf,0.011741682974559686,0.9882583170254403,0.461839530332681,0.5264187866927593
113H,11,3H,0,579,2,577,293,284,inf,0.0034542314335060447,0.9965457685664939,0.5060449050086355,0.4905008635578584
113I,11,3I,0,478,0,478,249,229,inf,0.0,1.0,0.5209205020920502,0.4790794979079498
113J,11,3J,0,390,6,384,208,176,inf,0.015384615384615385,0.9846153846153847,0.5333333333333333,0.4512820512820513
113K,11,3K,0,520,1,519,250,269,inf,0.0019230769230769232,0.9980769230769231,0.4807692307692308,0.5173076923076924
114A,11,4A,0,654,5,649,320,329,inf,0.00764525993883792,0.9923547400611621,0.4892966360856269,0.5030581039755352
114B,11,4B,0,606,0,606,265,341,inf,0.0,1.0,0.4372937293729373,0.5627062706270627
114C,11,4C,0,613,5,608,318,290,inf,0.008156606851549755,0.9918433931484503,0.5187601957585645,0.4730831973898858
114D,11,4D,0,722,7,715,354,361,inf,0.009695290858725761,0.9903047091412742,0.4903047091412742,0.5
114E,11,4E,0,663,9,654,295,359,inf,0.013574660633484163,0.9864253393665159,0.444947209653092,0.5414781297134238
114F,11,4F,0,712,9,703,370,333,inf,0.012640449438202247,0.9873595505617978,0.5196629213483146,0.46769662921348315
114G,11,4G,0,722,7,715,337,378,inf,0.009695290858725761,0.9903047091412742,0.4667590027700831,0.5235457063711911
114H,11,4H,0,670,6,664,342,322,inf,0.008955223880597015,0.991044776119403,0.5104477611940299,0.48059701492537316
114I,11,4I,0,481,4,477,234,243,inf,0.008316008316008316,0.9916839916839917,0.4864864864864865,0.5051975051975052
114J,11,4J,0,517,5,512,244,268,inf,0.009671179883945842,0.9903288201160542,0.47195357833655704,0.5183752417794971
115A,11,5A,0,363,5,358,193,165,inf,0.013774104683195593,0.9862258953168044,0.5316804407713499,0.45454545454545453
115B,11,5B,0,390,2,388,207,181,inf,0.005128205128205128,0.9948717948717949,0.5307692307692308,0.4641025641025641
115C,11,5C,0,593,4,589,293,296,inf,0.006745362563237774,0.9932546374367622,0.49409780775716694,0.4991568296795953
115D,11,5D,0,458,4,454,231,223,inf,0.008733624454148471,0.9912663755458515,0.5043668122270742,0.4868995633187773
115E,11,5E,0,680,4,676,324,352,inf,0.0058823529411764705,0.9941176470588236,0.4764705882352941,0.5176470588235295
115F,11,5F,0,598,3,595,321,274,inf,0.005016722408026756,0.9949832775919732,0.5367892976588629,0.45819397993311034
115G,11,5G,0,620,6,614,290,324,inf,0.00967741935483871,0.9903225806451613,0.46774193548387094,0.5225806451612903
115H,11,5H,0,662,6,656,313,343,inf,0.00906344410876133,0.9909365558912386,0.472809667673716,0.5181268882175226
115I,11,5I,0,800,7,793,327,466,inf,0.00875,0.99125,0.40875,0.5825
115J,11,5J,0,666,4,662,324,338,inf,0.006006006006006006,0.993993993993994,0.4864864864864865,0.5075075075075075
116A,11,6A,0,418,4,414,189,225,inf,0.009569377990430622,0.9904306220095693,0.45215311004784686,0.5382775119617225
116B,11,6B,0,446,4,442,176,266,inf,0.008968609865470852,0.9910313901345291,0.39461883408071746,0.5964125560538116
116C,11,6C,0,350,4,346,155,191,inf,0.011428571428571429,0.9885714285714285,0.44285714285714284,0.5457142857142857
116D,11,6D,0,518,4,514,213,301,inf,0.007722007722007722,0.9922779922779923,0.4111969111969112,0.581081081081081
116E,11,6E,0,454,4,450,200,250,inf,0.00881057268722467,0.9911894273127754,0.44052863436123346,0.5506607929515418
116F,11,6F,0,350,5,345,165,180,inf,0.014285714285714285,0.9857142857142858,0.4714285714285714,0.5142857142857142
116G,11,6G,0,498,2,496,209,287,inf,0.004016064257028112,0.9959839357429718,0.41967871485943775,0.5763052208835341
116H,11,6H,0,505,5,500,267,233,inf,0.009900990099009901,0.9900990099009901,0.5287128712871287,0.4613861386138614
116I,11,6I,0,421,0,421,186,235,inf,0.0,1.0,0.4418052256532066,0.5581947743467933
116J,11,6J,0,498,4,494,204,290,inf,0.008032128514056224,0.9919678714859438,0.40963855421686746,0.5823293172690763
116K,11,6K,0,736,5,731,298,433,inf,0.006793478260869565,0.9932065217391305,0.4048913043478261,0.5883152173913043
116L,11,6L,0,407,4,403,163,240,inf,0.009828009828009828,0.9901719901719902,0.4004914004914005,0.5896805896805897
116M,11,6M,0,533,8,525,194,331,inf,0.0150093808630394,0.9849906191369606,0.36397748592870544,0.6210131332082551
116N,11,6N,0,753,8,745,281,464,inf,0.010624169986719787,0.9893758300132802,0.37317397078353254,0.6162018592297477
121A,12,1A,0,795,7,788,441,347,inf,0.00880503144654088,0.9911949685534591,0.5547169811320755,0.43647798742138366
121B,12,1B,0,907,5,902,480,422,inf,0.005512679162072767,0.9944873208379272,0.5292171995589857,0.4652701212789416
121C,12,1C,0,748,3,745,412,333,inf,0.004010695187165776,0.9959893048128342,0.5508021390374331,0.4451871657754011
121D,12,1D,0,800,3,797,398,399,inf,0.00375,0.99625,0.4975,0.49875
121E,12,1E,0,777,6,771,366,405,inf,0.007722007722007722,0.9922779922779923,0.47104247104247104,0.5212355212355212
121F,12,1F,0,848,0,848,461,387,inf,0.0,1.0,0.5436320754716981,0.4563679245283019
122A,12,2A,0,793,17,776,455,321,inf,0.021437578814627996,0.978562421185372,0.5737704918032787,0.4047919293820933
122B,12,2B,0,693,2,691,316,375,inf,0.002886002886002886,0.9971139971139971,0.455988455988456,0.5411255411255411
122C,12,2C,0,750,5,745,453,292,inf,0.006666666666666667,0.9933333333333333,0.604,0.3893333333333333
122D,12,2D,0,667,2,665,345,320,inf,0.0029985007496251873,0.9970014992503748,0.5172413793103449,0.47976011994003
122E,12,2E,0,574,2,572,331,241,inf,0.003484320557491289,0.9965156794425087,0.5766550522648084,0.41986062717770034
122F,12,2F,0,697,0,697,370,327,inf,0.0,1.0,0.5308464849354376,0.46915351506456243
122G,12,2G,0,579,1,578,293,285,inf,0.0017271157167530224,0.998272884283247,0.5060449050086355,0.49222797927461137
122H,12,2H,0,798,0,798,426,372,inf,0.0,1.0,0.5338345864661654,0.46616541353383456
123A,12,3A,0,843,2,841,612,229,inf,0.002372479240806643,0.9976275207591934,0.7259786476868327,0.27164887307236063
123B,12,3B,0,718,5,713,487,226,inf,0.006963788300835654,0.9930362116991643,0.6782729805013927,0.3147632311977716
123C,12,3C,0,715,3,712,491,221,inf,0.004195804195804196,0.9958041958041958,0.6867132867132867,0.3090909090909091
123D,12,3D,0,1144,0,1144,741,403,inf,0.0,1.0,0.6477272727272727,0.3522727272727273
123E,12,3E,0,696,6,690,405,285,inf,0.008620689655172414,0.9913793103448276,0.5818965517241379,0.40948275862068967
123F,12,3F,0,1084,5,1079,675,404,inf,0.004612546125461255,0.9953874538745388,0.6226937269372693,0.3726937269372694
123G,12,3G,0,583,4,579,405,174,inf,0.00686106346483705,0.9931389365351629,0.6946826758147513,0.29845626072041165
123H,12,3H,0,587,1,586,398,188,inf,0.0017035775127768314,0.9982964224872232,0.6780238500851788,0.3202725724020443
123I,12,3I,0,1090,3,1087,555,532,inf,0.0027522935779816515,0.9972477064220183,0.5091743119266054,0.48807339449541287
124A,12,4A,0,612,1,611,388,223,inf,0.0016339869281045752,0.9983660130718954,0.6339869281045751,0.36437908496732024
124B,12,4B,0,829,4,825,583,242,inf,0.0048250904704463205,0.9951749095295537,0.7032569360675512,0.29191797346200243
124C,12,4C,0,637,0,637,429,208,inf,0.0,1.0,0.673469387755102,0.32653061224489793
124D,12,4D,0,798,5,793,565,228,inf,0.006265664160401002,0.993734335839599,0.7080200501253133,0.2857142857142857
124E,12,4E,0,931,1,930,609,321,inf,0.0010741138560687433,0.9989258861439313,0.6541353383458647,0.3447905477980666
124F,12,4F,0,863,6,857,536,321,inf,0.006952491309385863,0.9930475086906141,0.6210892236384704,0.3719582850521437
124G,12,4G,0,718,0,718,476,242,inf,0.0,1.0,0.6629526462395543,0.3370473537604457
124H,12,4H,0,953,3,950,609,341,inf,0.0031479538300104933,0.9968520461699895,0.6390346274921301,0.3578174186778594
124I,12,4I,0,719,3,716,472,244,inf,0.004172461752433936,0.9958275382475661,0.6564673157162726,0.33936022253129344
125A,12,5A,0,760,6,754,548,206,inf,0.007894736842105263,0.9921052631578947,0.7210526315789474,0.2710526315789474
125B,12,5B,0,789,3,786,565,221,inf,0.0038022813688212928,0.9961977186311787,0.7160963244613435,0.28010139416983526
125C,12,5C,0,772,4,768,606,162,inf,0.0051813471502590676,0.9948186528497409,0.7849740932642487,0.20984455958549222
125D,12,5D,0,886,4,882,664,218,inf,0.004514672686230248,0.9954853273137697,0.7494356659142212,0.24604966139954854
125E,12,5E,0,698,2,696,524,172,inf,0.0028653295128939827,0.997134670487106,0.7507163323782235,0.24641833810888253
126A,12,6A,0,723,2,721,505,216,inf,0.0027662517289073307,0.9972337482710927,0.6984785615491009,0.2987551867219917
126B,12,6B,0,929,5,924,666,258,inf,0.005382131324004306,0.9946178686759957,0.7168998923573735,0.27771797631862216
126C,12,6C,0,643,3,640,428,212,inf,0.004665629860031105,0.995334370139969,0.6656298600311042,0.3297045101088647
126D,12,6D,0,759,2,757,567,190,inf,0.002635046113306983,0.997364953886693,0.7470355731225297,0.2503293807641634
126E,12,6E,0,597,0,597,441,156,inf,0.0,1.0,0.7386934673366834,0.2613065326633166
126F,12,6F,0,779,7,772,526,246,inf,0.008985879332477536,0.9910141206675225,0.675224646983312,0.3157894736842105
126G,12,6G,0,1025,3,1022,751,271,inf,0.002926829268292683,0.9970731707317073,0.7326829268292683,0.26439024390243904
126H,12,6H,0,853,8,845,579,266,inf,0.009378663540445486,0.9906213364595545,0.6787807737397421,0.3118405627198124
126I,12,6I,0,931,2,929,642,287,inf,0.0021482277121374865,0.9978517722878625,0.6895810955961332,0.3082706766917293
126J,12,6J,0,815,4,811,539,272,inf,0.0049079754601227,0.9950920245398773,0.6613496932515337,0.3337423312883436
