id,district_id,electoral_district_id,eligible_voters,voters,invalid_votes,valid_votes,vote_yes,vote_no,voter_turnout,invalid_votes_percentage,valid_votes_percentage,vote_yes_percentage,vote_no_percentage
01100,01,100,1621,519,11,508,299,209,0.32017273288093767,0.02119460500963391,0.9788053949903661,0.5761078998073218,0.4026974951830443
01101,01,101,953,366,6,360,182,178,0.38405036726128017,0.01639344262295082,0.9836065573770492,0.4972677595628415,0.48633879781420764
01102,01,102,1283,406,8,398,217,181,0.31644583008573657,0.019704433497536946,0.9802955665024631,0.5344827586206896,0.4458128078817734
01103,01,103,1011,329,9,320,159,161,0.3254203758654797,0.02735562310030395,0.9726443768996961,0.48328267477203646,0.48936170212765956
01104,01,104,1277,522,10,512,263,249,0.40877055599060297,0.019157088122605363,0.9808429118773946,0.5038314176245211,0.47701149425287354
01105,01,105,1010,425,6,419,273,146,0.4207920792079208,0.01411764705882353,0.9858823529411764,0.6423529411764706,0.34352941176470586
01106,01,106,1428,536,10,526,248,278,0.3753501400560224,0.018656716417910446,0.9813432835820896,0.4626865671641791,0.5186567164179104
01107,01,107,1100,423,9,414,265,149,0.3845454545454545,0.02127659574468085,0.9787234042553191,0.6264775413711584,0.35224586288416077
01108,01,108,1047,363,4,359,186,173,0.3467048710601719,0.011019283746556474,0.9889807162534435,0.512396694214876,0.4765840220385675
01109,01,109,1094,359,15,344,227,117,0.3281535648994516,0.04178272980501393,0.958217270194986,0.6323119777158774,0.32590529247910865
01110,01,110,1253,568,11,557,308,249,0.4533120510774142,0.01936619718309859,0.9806338028169014,0.5422535211267606,0.43838028169014087
01111,01,111,1003,422,12,410,238,172,0.42073778664007977,0.02843601895734597,0.9715639810426541,0.5639810426540285,0.4075829383886256
01112,01,112,1153,481,8,473,300,173,0.417172593235039,0.016632016632016633,0.9833679833679834,0.6237006237006237,0.3596673596673597
01113,01,113,1415,612,15,597,396,201,0.43250883392226147,0.024509803921568627,0.9754901960784313,0.6470588235294118,0.3284313725490196
01114,01,114,1431,630,21,609,412,197,0.44025157232704404,0.03333333333333333,0.9666666666666667,0.653968253968254,0.3126984126984127
01115,01,115,839,380,12,368,251,117,0.45292014302741357,0.031578947368421054,0.968421052631579,0.6605263157894737,0.3078947368421053
01116,01,116,688,288,4,284,164,120,0.4186046511627907,0.013888888888888888,0.9861111111111112,0.5694444444444444,0.4166666666666667
01117,01,117,1331,598,24,574,363,211,0.4492862509391435,0.04013377926421405,0.959866220735786,0.6070234113712375,0.3528428093645485
01118,01,118,1298,597,8,589,364,225,0.45993836671802774,0.01340033500837521,0.9865996649916248,0.609715242881072,0.3768844221105528
01119,01,119,916,411,8,403,229,174,0.44868995633187775,0.019464720194647202,0.9805352798053528,0.5571776155717761,0.4233576642335766
01120,01,120,1023,448,6,442,296,146,0.43792766373411535,0.013392857142857142,0.9866071428571429,0.6607142857142857,0.32589285714285715
01121,01,121,1042,426,14,412,245,167,0.4088291746641075,0.03286384976525822,0.9671361502347418,0.5751173708920188,0.392018779342723
01122,01,122,1134,479,7,472,278,194,0.42239858906525574,0.014613778705636743,0.9853862212943633,0.5803757828810021,0.40501043841336115
01123,01,123,947,424,8,416,236,180,0.4477296726504752,0.018867924528301886,0.9811320754716981,0.5566037735849056,0.42452830188679247
01124,01,124,1271,465,13,452,303,149,0.36585365853658536,0.02795698924731183,0.9720430107526882,0.6516129032258065,0.3204301075268817
01125,01,125,1507,553,15,538,296,242,0.3669542136695421,0.027124773960216998,0.972875226039783,0.5352622061482821,0.4376130198915009
01200,01,200,865,345,7,338,218,120,0.3988439306358382,0.020289855072463767,0.9797101449275363,0.6318840579710145,0.34782608695652173
01201,01,201,1183,465,13,452,244,208,0.39306846999154693,0.02795698924731183,0.9720430107526882,0.524731182795699,0.44731182795698926
01202,01,202,1159,431,11,420,242,178,0.3718723037100949,0.025522041763341066,0.974477958236659,0.5614849187935035,0.41299303944315546
01203,01,203,1535,506,8,498,298,200,0.32964169381107494,0.015810276679841896,0.9841897233201581,0.5889328063241107,0.3952569169960474
01204,01,204,1528,522,11,511,233,278,0.3416230366492147,0.0210727969348659,0.9789272030651341,0.446360153256705,0.5325670498084292
01205,01,205,1214,453,12,441,311,130,0.3731466227347611,0.026490066225165563,0.9735099337748344,0.6865342163355408,0.2869757174392936
01206,01,206,1310,486,13,473,305,168,0.3709923664122137,0.026748971193415638,0.9732510288065843,0.6275720164609053,0.345679012345679
01207,01,207,1066,429,10,419,314,105,0.4024390243902439,0.023310023310023312,0.9766899766899767,0.7319347319347319,0.24475524475524477
01208,01,208,903,356,16,340,209,131,0.39424141749723146,0.0449438202247191,0.9550561797752809,0.5870786516853933,0.36797752808988765
01209,01,209,1128,484,11,473,324,149,0.42907801418439717,0.022727272727272728,0.9772727272727273,0.6694214876033058,0.30785123966942146
01210,01,210,1137,465,12,453,282,171,0.40897097625329815,0.025806451612903226,0.9741935483870968,0.6064516129032258,0.36774193548387096
01211,01,211,877,382,11,371,276,95,0.43557582668187,0.028795811518324606,0.9712041884816754,0.7225130890052356,0.2486910994764398
01212,01,212,866,371,13,358,217,141,0.4284064665127021,0.03504043126684636,0.9649595687331537,0.5849056603773585,0.38005390835579517
01213,01,213,602,231,14,217,143,74,0.38372093023255816,0.06060606060606061,0.9393939393939394,0.6190476190476191,0.3203463203463203
01214,01,214,827,282,13,269,166,103,0.34099153567110035,0.04609929078014184,0.9539007092198581,0.5886524822695035,0.36524822695035464
01215,01,215,982,421,21,400,262,138,0.4287169042769857,0.0498812351543943,0.9501187648456056,0.6223277909738717,0.32779097387173395
01216,01,216,945,363,11,352,241,111,0.38412698412698415,0.030303030303030304,0.9696969696969697,0.6639118457300276,0.30578512396694213
01217,01,217,1007,349,11,338,248,90,0.34657398212512414,0.03151862464183381,0.9684813753581661,0.7106017191977078,0.25787965616045844
01218,01,218,974,412,20,392,256,136,0.42299794661190965,0.04854368932038835,0.9514563106796117,0.6213592233009708,0.3300970873786408
01219,01,219,764,303,20,283,203,80,0.39659685863874344,0.066006600660066,0.933993399339934,0.66996699669967,0.264026402640264
01220,01,220,1026,370,5,365,245,120,0.36062378167641324,0.013513513513513514,0.9864864864864865,0.6621621621621622,0.32432432432432434
01221,01,221,1435,542,12,530,246,284,0.37770034843205574,0.02214022140221402,0.977859778597786,0.45387453874538747,0.5239852398523985
01222,01,222,843,344,6,338,251,87,0.4080664294187426,0.01744186046511628,0.9825581395348837,0.7296511627906976,0.25290697674418605
01223,01,223,1518,606,11,595,297,298,0.39920948616600793,0.018151815181518153,0.9818481848184818,0.4900990099009901,0.49174917491749176
01224,01,224,1290,480,6,474,256,218,0.37209302325581395,0.0125,0.9875,0.5333333333333333,0.45416666666666666
01225,01,225,1344,449,25,424,211,213,0.33407738095238093,0.0556792873051225,0.9443207126948775,0.46993318485523383,0.47438752783964366
01226,01,226,719,250,7,243,165,78,0.3477051460361613,0.028,0.972,0.66,0.312
01227,01,227,1461,541,12,529,305,224,0.3702943189596167,0.022181146025878003,0.977818853974122,0.5637707948243993,0.41404805914972276
01228,01,228,1183,435,17,418,234,184,0.36770921386306,0.03908045977011494,0.960919540229885,0.5379310344827586,0.42298850574712643
01229,01,229,1065,395,12,383,232,151,0.37089201877934275,0.030379746835443037,0.9696202531645569,0.5873417721518988,0.3822784810126582
01300,01,300,1199,473,14,459,342,117,0.3944954128440367,0.02959830866807611,0.9704016913319239,0.7230443974630021,0.24735729386892177
01301,01,301,936,370,5,365,261,104,0.3952991452991453,0.013513513513513514,0.9864864864864865,0.7054054054054054,0.2810810810810811
01302,01,302,1135,489,25,464,337,127,0.43083700440528633,0.05112474437627812,0.9488752556237219,0.689161554192229,0.25971370143149286
01303,01,303,893,351,12,339,261,78,0.393057110862262,0.03418803418803419,0.9658119658119658,0.7435897435897436,0.2222222222222222
01304,01,304,897,423,8,415,266,149,0.47157190635451507,0.018912529550827423,0.9810874704491725,0.6288416075650118,0.35224586288416077
01305,01,305,1033,420,10,410,229,181,0.40658276863504356,0.023809523809523808,0.9761904761904762,0.5452380952380952,0.430952380952381
01306,01,306,1313,579,17,562,368,194,0.44097486671744096,0.02936096718480138,0.9706390328151986,0.6355785837651122,0.33506044905008636
01307,01,307,1128,439,16,423,264,159,0.3891843971631206,0.03644646924829157,0.9635535307517085,0.6013667425968109,0.3621867881548975
01308,01,308,1141,456,10,446,293,153,0.39964943032427697,0.021929824561403508,0.9780701754385965,0.6425438596491229,0.3355263157894737
01309,01,309,1239,563,25,538,351,187,0.4543987086359968,0.04440497335701599,0.955595026642984,0.6234458259325044,0.3321492007104796
01310,01,310,924,355,15,340,237,103,0.3841991341991342,0.04225352112676056,0.9577464788732394,0.6676056338028169,0.29014084507042254
01311,01,311,1015,397,14,383,235,148,0.39113300492610836,0.03526448362720403,0.964735516372796,0.5919395465994962,0.37279596977329976
01312,01,312,774,318,12,306,197,109,0.4108527131782946,0.03773584905660377,0.9622641509433962,0.6194968553459119,0.34276729559748426
01313,01,313,833,336,8,328,192,136,0.40336134453781514,0.023809523809523808,0.9761904761904762,0.5714285714285714,0.40476190476190477
01314,01,314,1066,461,17,444,290,154,0.4324577861163227,0.0368763557483731,0.9631236442516269,0.6290672451193059,0.33405639913232105
01315,01,315,789,337,13,324,236,88,0.42712294043092525,0.03857566765578635,0.9614243323442137,0.7002967359050445,0.26112759643916916
01316,01,316,1293,498,27,471,327,144,0.3851508120649652,0.05421686746987952,0.9457831325301205,0.6566265060240963,0.2891566265060241
01317,01,317,861,370,10,360,264,96,0.429732868757259,0.02702702702702703,0.972972972972973,0.7135135135135136,0.2594594594594595
01318,01,318,1064,433,23,410,229,181,0.4069548872180451,0.053117782909930716,0.9468822170900693,0.5288683602771362,0.418013856812933
01319,01,319,991,366,12,354,191,163,0.3693239152371342,0.03278688524590164,0.9672131147540983,0.5218579234972678,0.4453551912568306
01320,01,320,569,271,5,266,138,128,0.47627416520210897,0.01845018450184502,0.981549815498155,0.5092250922509225,0.47232472324723246
01321,01,321,1056,421,15,406,223,183,0.39867424242424243,0.035629453681710214,0.9643705463182898,0.5296912114014252,0.4346793349168646
01322,01,322,1081,392,16,376,229,147,0.36262719703977797,0.04081632653061224,0.9591836734693877,0.5841836734693877,0.375
01323,01,323,1129,486,12,474,239,235,0.4304694419840567,0.024691358024691357,0.9753086419753086,0.49176954732510286,0.4835390946502058
01324,01,324,1455,486,16,470,265,205,0.334020618556701,0.03292181069958848,0.9670781893004116,0.5452674897119342,0.4218106995884774
01325,01,325,1022,394,20,374,228,146,0.38551859099804303,0.050761421319796954,0.949238578680203,0.5786802030456852,0.37055837563451777
01326,01,326,1374,569,19,550,348,202,0.4141193595342067,0.033391915641476276,0.9666080843585237,0.6115992970123023,0.35500878734622143
01327,01,327,1466,573,23,550,371,179,0.3908594815825375,0.04013961605584642,0.9598603839441536,0.6474694589877836,0.31239092495637
01400,01,400,1246,476,20,456,330,126,0.38202247191011235,0.04201680672268908,0.957983193277311,0.6932773109243697,0.2647058823529412
01401,01,401,906,379,5,374,289,85,0.41832229580573954,0.013192612137203167,0.9868073878627969,0.762532981530343,0.22427440633245382
01402,01,402,1311,536,34,502,394,108,0.4088482074752098,0.06343283582089553,0.9365671641791045,0.7350746268656716,0.20149253731343283
01403,01,403,938,389,5,384,274,110,0.4147121535181237,0.012853470437017995,0.987146529562982,0.7043701799485861,0.2827763496143959
01404,01,404,709,294,13,281,231,50,0.4146685472496474,0.04421768707482993,0.95578231292517,0.7857142857142857,0.17006802721088435
01405,01,405,785,317,17,300,202,98,0.40382165605095544,0.05362776025236593,0.9463722397476341,0.637223974763407,0.30914826498422715
01406,01,406,829,364,9,355,272,83,0.4390832328106152,0.024725274725274724,0.9752747252747253,0.7472527472527473,0.22802197802197802
01407,01,407,1158,510,16,494,357,137,0.44041450777202074,0.03137254901960784,0.9686274509803922,0.7,0.26862745098039215
01408,01,408,973,423,15,408,284,124,0.434737923946557,0.03546099290780142,0.9645390070921985,0.6713947990543735,0.29314420803782504
01409,01,409,921,412,16,396,286,110,0.44733984799131377,0.038834951456310676,0.9611650485436893,0.6941747572815534,0.2669902912621359
01410,01,410,1278,540,10,530,391,139,0.4225352112676056,0.018518518518518517,0.9814814814814815,0.7240740740740741,0.2574074074074074
01411,01,411,1020,438,15,423,306,117,0.4294117647058823,0.03424657534246575,0.9657534246575342,0.6986301369863014,0.2671232876712329
01412,01,412,874,369,11,358,254,104,0.42219679633867274,0.02981029810298103,0.9701897018970189,0.6883468834688347,0.28184281842818426
01413,01,413,816,325,4,321,236,85,0.39828431372549017,0.012307692307692308,0.9876923076923076,0.7261538461538461,0.26153846153846155
01414,01,414,804,358,7,351,272,79,0.44527363184079605,0.019553072625698324,0.9804469273743017,0.7597765363128491,0.2206703910614525
01415,01,415,838,397,16,381,292,89,0.4737470167064439,0.04030226700251889,0.9596977329974811,0.7355163727959698,0.22418136020151133
01416,01,416,1016,441,16,425,300,125,0.4340551181102362,0.036281179138321996,0.963718820861678,0.6802721088435374,0.2834467120181406
01417,01,417,1140,447,17,430,309,121,0.39210526315789473,0.03803131991051454,0.9619686800894854,0.6912751677852349,0.27069351230425054
01418,01,418,1116,408,11,397,295,102,0.3655913978494624,0.02696078431372549,0.9730392156862745,0.7230392156862745,0.25
01419,01,419,1269,574,12,562,421,141,0.4523246650906225,0.020905923344947737,0.9790940766550522,0.7334494773519163,0.2456445993031359
01420,01,420,919,374,9,365,265,100,0.40696409140369966,0.02406417112299465,0.9759358288770054,0.7085561497326203,0.26737967914438504
01421,01,421,782,362,23,339,240,99,0.4629156010230179,0.06353591160220995,0.93646408839779,0.6629834254143646,0.27348066298342544
01422,01,422,979,391,10,381,291,90,0.39938712972420837,0.02557544757033248,0.9744245524296675,0.7442455242966752,0.23017902813299232
01423,01,423,906,391,7,384,249,135,0.4315673289183223,0.017902813299232736,0.9820971867007673,0.6368286445012787,0.3452685421994885
01424,01,424,1232,490,11,479,350,129,0.3977272727272727,0.022448979591836733,0.9775510204081632,0.7142857142857143,0.26326530612244897
01425,01,425,1256,558,13,545,426,119,0.4442675159235669,0.023297491039426525,0.9767025089605734,0.7634408602150538,0.2132616487455197
01426,01,426,1243,495,15,480,394,86,0.39823008849557523,0.030303030303030304,0.9696969696969697,0.795959595959596,0.17373737373737375
01427,01,427,927,365,11,354,255,99,0.39374325782092773,0.030136986301369864,0.9698630136986301,0.6986301369863014,0.27123287671232876
01428,01,428,795,317,5,312,233,79,0.3987421383647799,0.015772870662460567,0.9842271293375394,0.7350157728706624,0.24921135646687698
01500,01,500,963,361,11,350,219,131,0.37487019730010385,0.030470914127423823,0.9695290858725761,0.6066481994459834,0.3628808864265928
01501,01,501,787,370,17,353,237,116,0.4701397712833545,0.04594594594594595,0.9540540540540541,0.6405405405405405,0.31351351351351353
01502,01,502,471,178,16,162,126,36,0.37791932059447986,0.0898876404494382,0.9101123595505618,0.7078651685393258,0.20224719101123595
01503,01,503,981,405,25,380,206,174,0.41284403669724773,0.06172839506172839,0.9382716049382716,0.508641975308642,0.42962962962962964
01504,01,504,646,250,5,245,191,54,0.38699690402476783,0.02,0.98,0.764,0.216
01505,01,505,878,365,17,348,260,88,0.4157175398633257,0.04657534246575343,0.9534246575342465,0.7123287671232876,0.2410958904109589
01506,01,506,943,386,18,368,216,152,0.4093319194061506,0.046632124352331605,0.9533678756476683,0.5595854922279793,0.39378238341968913
01507,01,507,1383,495,14,481,313,168,0.3579175704989154,0.028282828282828285,0.9717171717171718,0.6323232323232323,0.3393939393939394
01508,01,508,1145,501,17,484,325,159,0.4375545851528384,0.033932135728542916,0.9660678642714571,0.6487025948103793,0.31736526946107785
01509,01,509,1051,425,11,414,282,132,0.4043767840152236,0.02588235294117647,0.9741176470588235,0.6635294117647059,0.31058823529411766
01510,01,510,1006,424,23,401,254,147,0.42147117296222664,0.054245283018867926,0.9457547169811321,0.5990566037735849,0.3466981132075472
01511,01,511,1082,372,18,354,226,128,0.3438077634011091,0.04838709677419355,0.9516129032258065,0.6075268817204301,0.34408602150537637
01512,01,512,1041,363,13,350,275,75,0.34870317002881845,0.03581267217630854,0.9641873278236914,0.7575757575757576,0.2066115702479339
01513,01,513,1331,533,10,523,401,122,0.4004507888805409,0.01876172607879925,0.9812382739212008,0.7523452157598499,0.22889305816135083
01514,01,514,967,381,10,371,279,92,0.3940020682523268,0.026246719160104987,0.973753280839895,0.7322834645669292,0.24146981627296588
01515,01,515,1298,485,23,462,339,123,0.3736517719568567,0.04742268041237113,0.9525773195876288,0.6989690721649484,0.2536082474226804
01516,01,516,941,355,14,341,264,77,0.37725823591923485,0.03943661971830986,0.9605633802816902,0.7436619718309859,0.21690140845070421
01517,01,517,1316,509,29,480,343,137,0.38677811550151975,0.05697445972495088,0.9430255402750491,0.6738703339882122,0.2691552062868369
01518,01,518,1251,465,16,449,363,86,0.37170263788968827,0.034408602150537634,0.9655913978494624,0.7806451612903226,0.18494623655913978
01519,01,519,1309,592,27,565,445,120,0.452253628724217,0.04560810810810811,0.9543918918918919,0.7516891891891891,0.20270270270270271
01520,01,520,1323,492,20,472,378,94,0.37188208616780044,0.04065040650406504,0.959349593495935,0.7682926829268293,0.1910569105691057
01521,01,521,1022,349,41,308,213,95,0.34148727984344424,0.1174785100286533,0.8825214899713467,0.6103151862464183,0.2722063037249284
01522,01,522,864,343,11,332,228,104,0.39699074074074076,0.03206997084548105,0.967930029154519,0.6647230320699709,0.3032069970845481
01523,01,523,637,199,10,189,129,60,0.31240188383045525,0.05025125628140704,0.949748743718593,0.6482412060301508,0.3015075376884422
01524,01,524,844,313,4,309,238,71,0.3708530805687204,0.012779552715654952,0.987220447284345,0.7603833865814696,0.2268370607028754
01525,01,525,787,317,8,309,249,60,0.4027954256670902,0.025236593059936908,0.9747634069400631,0.7854889589905363,0.1892744479495268
01526,01,526,1420,567,11,556,451,105,0.39929577464788735,0.019400352733686066,0.9805996472663139,0.7954144620811288,0.18518518518518517
01600,01,600,1380,513,18,495,373,122,0.3717391304347826,0.03508771929824561,0.9649122807017544,0.7270955165692008,0.2378167641325536
01601,01,601,816,346,12,334,236,98,0.42401960784313725,0.03468208092485549,0.9653179190751445,0.6820809248554913,0.2832369942196532
01602,01,602,1125,505,13,492,363,129,0.4488888888888889,0.02574257425742574,0.9742574257425742,0.7188118811881188,0.25544554455445545
01603,01,603,844,350,7,343,281,62,0.4146919431279621,0.02,0.98,0.8028571428571428,0.17714285714285713
01604,01,604,804,307,20,287,222,65,0.3818407960199005,0.06514657980456026,0.9348534201954397,0.7231270358306189,0.21172638436482086
01605,01,605,1019,404,11,393,297,96,0.39646712463199213,0.027227722772277228,0.9727722772277227,0.7351485148514851,0.2376237623762376
01606,01,606,801,323,14,309,239,70,0.40324594257178525,0.043343653250773995,0.9566563467492261,0.739938080495356,0.21671826625386997
01607,01,607,800,283,11,272,230,42,0.35375,0.038869257950530034,0.9611307420494699,0.8127208480565371,0.14840989399293286
01608,01,608,1016,363,16,347,291,56,0.3572834645669291,0.0440771349862259,0.9559228650137741,0.8016528925619835,0.15426997245179064
01609,01,609,1133,433,30,403,342,61,0.382171226831421,0.06928406466512702,0.930715935334873,0.789838337182448,0.14087759815242495
01610,01,610,1078,390,14,376,311,65,0.36178107606679033,0.035897435897435895,0.9641025641025641,0.7974358974358975,0.16666666666666666
01611,01,611,1286,490,12,478,392,86,0.3810264385692068,0.024489795918367346,0.9755102040816327,0.8,0.17551020408163265
01612,01,612,1000,334,10,324,272,52,0.334,0.029940119760479042,0.9700598802395209,0.8143712574850299,0.15568862275449102
01613,01,613,1345,490,16,474,398,76,0.3643122676579926,0.0326530612244898,0.9673469387755103,0.8122448979591836,0.15510204081632653
01614,01,614,1155,491,19,472,330,142,0.4251082251082251,0.038696537678207736,0.9613034623217923,0.6720977596741344,0.2892057026476578
01615,01,615,872,275,5,270,230,40,0.31536697247706424,0.01818181818181818,0.9818181818181818,0.8363636363636363,0.14545454545454545
01616,01,616,1072,423,8,415,332,83,0.394589552238806,0.018912529550827423,0.9810874704491725,0.7848699763593381,0.19621749408983452
01617,01,617,998,408,8,400,330,70,0.4088176352705411,0.0196078431372549,0.9803921568627451,0.8088235294117647,0.1715686274509804
01618,01,618,1462,561,28,533,418,115,0.38372093023255816,0.049910873440285206,0.9500891265597148,0.7450980392156863,0.20499108734402852
01619,01,619,1118,444,12,432,317,115,0.39713774597495527,0.02702702702702703,0.972972972972973,0.713963963963964,0.25900900900900903
01620,01,620,1009,334,13,321,269,52,0.33102081268582756,0.038922155688622756,0.9610778443113772,0.8053892215568862,0.15568862275449102
01621,01,621,990,286,12,274,225,49,0.28888888888888886,0.04195804195804196,0.958041958041958,0.7867132867132867,0.17132867132867133
01622,01,622,643,224,7,217,160,57,0.3483670295489891,0.03125,0.96875,0.7142857142857143,0.2544642857142857
01623,01,623,910,333,8,325,256,69,0.3659340659340659,0.024024024024024024,0.975975975975976,0.7687687687687688,0.2072072072072072
01624,01,624,1280,443,25,418,338,80,0.34609375,0.056433408577878104,0.9435665914221218,0.7629796839729119,0.18058690744920994
01625,01,625,978,405,21,384,305,79,0.41411042944785276,0.05185185185185185,0.9481481481481482,0.7530864197530864,0.19506172839506172
01700,01,700,884,346,6,340,275,65,0.3914027149321267,0.017341040462427744,0.9826589595375722,0.7947976878612717,0.18786127167630057
01701,01,701,1218,460,11,449,367,82,0.37766830870279144,0.02391304347826087,0.9760869565217392,0.7978260869565217,0.1782608695652174
01702,01,702,1041,368,12,356,273,83,0.35350624399615754,0.03260869565217391,0.967391304347826,0.7418478260869565,0.22554347826086957
01703,01,703,1071,456,15,441,330,111,0.4257703081232493,0.03289473684210526,0.9671052631578947,0.7236842105263158,0.24342105263157895
01704,01,704,816,303,10,293,233,60,0.3713235294117647,0.033003300330033,0.966996699669967,0.768976897689769,0.19801980198019803
01705,01,705,957,404,4,400,318,82,0.4221525600835946,0.009900990099009901,0.9900990099009901,0.7871287128712872,0.20297029702970298
01706,01,706,1165,469,4,465,354,111,0.4025751072961373,0.008528784648187633,0.9914712153518124,0.7547974413646056,0.23667377398720682
01707,01,707,1153,490,13,477,376,101,0.424978317432784,0.026530612244897958,0.9734693877551021,0.7673469387755102,0.20612244897959184
01708,01,708,1065,437,21,416,318,98,0.4103286384976526,0.04805491990846682,0.9519450800915332,0.7276887871853547,0.2242562929061785
01709,01,709,1128,462,19,443,345,98,0.4095744680851064,0.04112554112554113,0.9588744588744589,0.7467532467532467,0.21212121212121213
01710,01,710,1316,493,18,475,368,107,0.37462006079027355,0.036511156186612576,0.9634888438133874,0.7464503042596349,0.21703853955375255
01711,01,711,1140,455,24,431,339,92,0.3991228070175439,0.05274725274725275,0.9472527472527472,0.7450549450549451,0.2021978021978022
01712,01,712,1255,497,18,479,366,113,0.3960159362549801,0.03621730382293763,0.9637826961770624,0.7364185110663984,0.22736418511066397
01713,01,713,876,281,7,274,192,82,0.3207762557077626,0.02491103202846975,0.9750889679715302,0.6832740213523132,0.2918149466192171
01714,01,714,1061,385,16,369,257,112,0.36286522148916117,0.04155844155844156,0.9584415584415584,0.6675324675324675,0.2909090909090909
01715,01,715,1103,389,18,371,273,98,0.3526745240253853,0.04627249357326478,0.9537275064267352,0.7017994858611826,0.2519280205655527
01716,01,716,951,373,3,370,279,91,0.3922187171398528,0.00804289544235925,0.9919571045576407,0.7479892761394102,0.24396782841823056
01717,01,717,1125,468,22,446,335,111,0.416,0.04700854700854701,0.9529914529914529,0.7158119658119658,0.23717948717948717
01718,01,718,859,363,21,342,62,280,0.42258440046565776,0.05785123966942149,0.9421487603305785,0.17079889807162535,0.7713498622589532
01719,01,719,951,367,28,339,252,87,0.38590956887486855,0.07629427792915532,0.9237057220708447,0.6866485013623979,0.23705722070844687
01720,01,720,1301,569,33,536,369,167,0.43735588009223675,0.05799648506151142,0.9420035149384886,0.648506151142355,0.29349736379613356
01721,01,721,1468,544,7,537,372,165,0.37057220708446864,0.012867647058823529,0.9871323529411765,0.6838235294117647,0.30330882352941174
01722,01,722,1013,429,12,417,311,106,0.42349457058242845,0.027972027972027972,0.972027972027972,0.7249417249417249,0.24708624708624707
01723,01,723,1316,574,28,546,422,124,0.43617021276595747,0.04878048780487805,0.9512195121951219,0.735191637630662,0.21602787456445993
01724,01,724,841,360,5,355,269,86,0.4280618311533888,0.013888888888888888,0.9861111111111112,0.7472222222222222,0.2388888888888889
01725,01,725,1067,402,22,380,282,98,0.3767572633552015,0.05472636815920398,0.945273631840796,0.7014925373134329,0.24378109452736318
011A,01,1A,0,1078,2,1076,565,511,inf,0.0018552875695732839,0.9981447124304267,0.5241187384044527,0.474025974025974
011B,01,1B,0,1061,13,1048,458,590,inf,0.012252591894439209,0.9877474081055608,0.43166823751178135,0.5560791705937794
011C,01,1C,0,1177,11,1166,617,549,inf,0.009345794392523364,0.9906542056074766,0.524214103653356,0.46644010195412067
011D,01,1D,0,961,5,956,513,443,inf,0.005202913631633715,0.9947970863683663,0.5338189386056191,0.46097814776274715
011E,01,1E,0,1133,12,1121,534,587,inf,0.01059135039717564,0.9894086496028244,0.471315092674316,0.5180935569285083
011F,01,1F,0,795,10,785,421,364,inf,0.012578616352201259,0.9874213836477987,0.529559748427673,0.4578616352201258
011G,01,1G,0,840,6,834,461,373,inf,0.007142857142857143,0.9928571428571429,0.5488095238095239,0.444047619047619
011H,01,1H,0,961,7,954,587,367,inf,0.007284079084287201,0.9927159209157128,0.6108220603537982,0.38189386056191466
011I,01,1I,0,1101,10,1091,641,450,inf,0.009082652134423252,0.9909173478655767,0.5821980018165305,0.4087193460490463
011J,01,1J,0,569,5,564,316,248,inf,0.008787346221441126,0.9912126537785588,0.5553602811950791,0.4358523725834798
011K,01,1K,0,899,13,886,566,320,inf,0.014460511679644048,0.985539488320356,0.6295884315906563,0.3559510567296997
011L,01,1L,0,850,7,843,541,302,inf,0.00823529411764706,0.991764705882353,0.6364705882352941,0.3552941176470588
011M,01,1M,0,839,12,827,436,391,inf,0.014302741358760428,0.9856972586412396,0.5196662693682956,0.466030989272944
012A,01,2A,0,753,8,745,415,330,inf,0.010624169986719787,0.9893758300132802,0.5511288180610889,0.43824701195219123
012B,01,2B,0,1065,13,1052,568,484,inf,0.012206572769953052,0.9877934272300469,0.5333333333333333,0.4544600938967136
012C,01,2C,0,1053,13,1040,544,496,inf,0.012345679012345678,0.9876543209876543,0.51661918328585,0.4710351377018044
012D,01,2D,0,868,19,849,578,271,inf,0.021889400921658985,0.978110599078341,0.6658986175115207,0.3122119815668203
012E,01,2E,0,826,5,821,493,328,inf,0.006053268765133172,0.9939467312348669,0.5968523002421308,0.39709443099273606
012F,01,2F,0,737,6,731,474,257,inf,0.008141112618724558,0.9918588873812755,0.6431478968792401,0.3487109905020353
012G,01,2G,0,889,6,883,512,371,inf,0.006749156355455568,0.9932508436445444,0.5759280089988752,0.41732283464566927
012H,01,2H,0,711,6,705,448,257,inf,0.008438818565400843,0.9915611814345991,0.630098452883263,0.36146272855133615
012I,01,2I,0,801,5,796,555,241,inf,0.006242197253433208,0.9937578027465668,0.6928838951310862,0.30087390761548066
012J,01,2J,0,640,3,637,390,247,inf,0.0046875,0.9953125,0.609375,0.3859375
012K,01,2K,0,885,14,871,473,398,inf,0.015819209039548022,0.984180790960452,0.5344632768361582,0.4497175141242938
012L,01,2L,0,1229,12,1217,568,649,inf,0.009764035801464606,0.9902359641985354,0.46216436126932464,0.5280716029292107
012M,01,2M,0,1103,23,1080,529,551,inf,0.02085222121486854,0.9791477787851315,0.4796010879419764,0.499546690843155
012N,01,2N,0,1091,24,1067,603,464,inf,0.021998166819431713,0.9780018331805683,0.5527039413382218,0.42529789184234645
013A,01,3A,0,664,9,655,486,169,inf,0.01355421686746988,0.9864457831325302,0.7319277108433735,0.2545180722891566
013B,01,3B,0,828,7,821,562,259,inf,0.008454106280193236,0.9915458937198067,0.678743961352657,0.31280193236714976
013C,01,3C,0,861,8,853,500,353,inf,0.009291521486643438,0.9907084785133565,0.5807200929152149,0.4099883855981417
013D,01,3D,0,987,13,974,616,358,inf,0.013171225937183385,0.9868287740628167,0.624113475177305,0.36271529888551163
013E,01,3E,0,867,5,862,544,318,inf,0.0057670126874279125,0.994232987312572,0.6274509803921569,0.36678200692041524
013F,01,3F,0,1099,10,1089,642,447,inf,0.009099181073703366,0.9909008189262967,0.5841674249317561,0.4067333939945405
013G,01,3G,0,541,6,535,347,188,inf,0.011090573012939002,0.988909426987061,0.6414048059149723,0.34750462107208874
013H,01,3H,0,730,7,723,398,325,inf,0.009589041095890411,0.9904109589041096,0.5452054794520548,0.4452054794520548
013I,01,3I,0,979,20,959,512,447,inf,0.020429009193054137,0.9795709908069459,0.5229826353421859,0.45658835546475995
013J,01,3J,0,951,12,939,494,445,inf,0.012618296529968454,0.9873817034700315,0.519453207150368,0.4679284963196635
013K,01,3K,0,1045,5,1040,512,528,inf,0.004784688995215311,0.9952153110047847,0.48995215311004786,0.5052631578947369
013L,01,3L,0,831,18,813,481,332,inf,0.021660649819494584,0.9783393501805054,0.5788206979542719,0.39951865222623345
014A,01,4A,0,634,12,622,477,145,inf,0.01892744479495268,0.9810725552050473,0.7523659305993691,0.22870662460567823
014B,01,4B,0,540,10,530,394,136,inf,0.018518518518518517,0.9814814814814815,0.7296296296296296,0.2518518518518518
014C,01,4C,0,791,7,784,550,234,inf,0.008849557522123894,0.9911504424778761,0.695322376738306,0.29582806573957016
014D,01,4D,0,616,7,609,424,185,inf,0.011363636363636364,0.9886363636363636,0.6883116883116883,0.3003246753246753
014E,01,4E,0,830,10,820,569,251,inf,0.012048192771084338,0.9879518072289156,0.6855421686746987,0.3024096385542169
014F,01,4F,0,862,10,852,604,248,inf,0.01160092807424594,0.988399071925754,0.7006960556844548,0.2877030162412993
014G,01,4G,0,568,3,565,416,149,inf,0.00528169014084507,0.9947183098591549,0.7323943661971831,0.2623239436619718
014H,01,4H,0,673,3,670,474,196,inf,0.004457652303120356,0.9955423476968797,0.7043090638930164,0.2912332838038633
014I,01,4I,0,606,4,602,417,185,inf,0.006600660066006601,0.9933993399339934,0.6881188118811881,0.30528052805280526
014J,01,4J,0,536,15,521,350,171,inf,0.027985074626865673,0.9720149253731343,0.6529850746268657,0.31902985074626866
014K,01,4K,0,515,3,512,345,167,inf,0.005825242718446602,0.9941747572815534,0.6699029126213593,0.32427184466019415
014L,01,4L,0,985,14,971,765,206,inf,0.014213197969543147,0.9857868020304569,0.7766497461928934,0.20913705583756345
014M,01,4M,0,843,10,833,652,181,inf,0.011862396204033215,0.9881376037959668,0.7734282325029656,0.2147093712930012
015A,01,5A,0,601,5,596,379,217,inf,0.008319467554076539,0.9916805324459235,0.6306156405990017,0.3610648918469218
015B,01,5B,0,627,12,615,386,229,inf,0.019138755980861243,0.9808612440191388,0.6156299840510366,0.3652312599681021
015C,01,5C,0,675,9,666,360,306,inf,0.013333333333333334,0.9866666666666667,0.5333333333333333,0.4533333333333333
015D,01,5D,0,611,2,609,360,249,inf,0.0032733224222585926,0.9967266775777414,0.5891980360065466,0.4075286415711948
015E,01,5E,0,581,4,577,367,210,inf,0.0068846815834767644,0.9931153184165232,0.6316695352839932,0.3614457831325301
015F,01,5F,0,732,8,724,531,193,inf,0.01092896174863388,0.9890710382513661,0.7254098360655737,0.26366120218579236
015G,01,5G,0,405,5,400,292,108,inf,0.012345679012345678,0.9876543209876543,0.7209876543209877,0.26666666666666666
015H,01,5H,0,658,7,651,493,158,inf,0.010638297872340425,0.9893617021276596,0.7492401215805471,0.24012158054711247
015I,01,5I,0,573,10,563,421,142,inf,0.017452006980802792,0.9825479930191972,0.7347294938917975,0.24781849912739964
015J,01,5J,0,649,5,644,523,121,inf,0.007704160246533128,0.9922958397534669,0.8058551617873652,0.1864406779661017
015K,01,5K,0,810,10,800,477,323,inf,0.012345679012345678,0.9876543209876543,0.5888888888888889,0.3987654320987654
015L,01,5L,0,803,5,798,629,169,inf,0.0062266500622665,0.9937733499377335,0.7833125778331258,0.21046077210460773
016A,01,6A,0,569,4,565,446,119,inf,0.007029876977152899,0.9929701230228472,0.7838312829525483,0.20913884007029876
016B,01,6B,0,561,3,558,389,169,inf,0.0053475935828877,0.9946524064171123,0.6934046345811051,0.30124777183600715
016C,01,6C,0,392,6,386,328,58,inf,0.015306122448979591,0.9846938775510204,0.8367346938775511,0.14795918367346939
016D,01,6D,0,457,6,451,325,126,inf,0.01312910284463895,0.986870897155361,0.7111597374179431,0.27571115973741794
016E,01,6E,0,417,6,411,326,85,inf,0.014388489208633094,0.9856115107913669,0.7817745803357314,0.2038369304556355
016F,01,6F,0,560,3,557,441,116,inf,0.005357142857142857,0.9946428571428572,0.7875,0.20714285714285716
016G,01,6G,0,543,6,537,406,131,inf,0.011049723756906077,0.988950276243094,0.7476979742173112,0.24125230202578268
016H,01,6H,0,773,26,747,555,192,inf,0.03363518758085381,0.9663648124191462,0.7179818887451488,0.24838292367399742
016I,01,6I,0,578,8,570,465,105,inf,0.01384083044982699,0.986159169550173,0.8044982698961938,0.18166089965397925
016J,01,6J,0,709,7,702,499,203,inf,0.009873060648801129,0.9901269393511989,0.7038081805359662,0.2863187588152327
016K,01,6K,0,497,5,492,412,80,inf,0.01006036217303823,0.9899396378269618,0.8289738430583501,0.16096579476861167
016L,01,6L,0,441,6,435,324,111,inf,0.013605442176870748,0.9863945578231292,0.7346938775510204,0.25170068027210885
016M,01,6M,0,472,6,466,352,114,inf,0.012711864406779662,0.9872881355932204,0.7457627118644068,0.24152542372881355
017A,01,7A,0,683,7,676,510,166,inf,0.010248901903367497,0.9897510980966325,0.746705710102489,0.2430453879941435
017B,01,7B,0,582,3,579,386,193,inf,0.005154639175257732,0.9948453608247423,0.6632302405498282,0.3316151202749141
017C,01,7C,0,638,6,632,469,163,inf,0.009404388714733543,0.9905956112852664,0.7351097178683386,0.2554858934169279
017D,01,7D,0,769,3,766,578,188,inf,0.0039011703511053317,0.9960988296488946,0.7516254876462939,0.2444733420026008
017E,01,7E,0,623,7,616,483,133,inf,0.011235955056179775,0.9887640449438202,0.7752808988764045,0.21348314606741572
017F,01,7F,0,697,7,690,532,158,inf,0.010043041606886656,0.9899569583931134,0.763271162123386,0.2266857962697274
017G,01,7G,0,548,9,539,354,185,inf,0.016423357664233577,0.9835766423357665,0.6459854014598541,0.3375912408759124
017H,01,7H,0,503,8,495,356,139,inf,0.015904572564612324,0.9840954274353877,0.7077534791252486,0.27634194831013914
017I,01,7I,0,454,6,448,313,135,inf,0.013215859030837005,0.986784140969163,0.6894273127753304,0.2973568281938326
017J,01,7J,0,425,4,421,276,145,inf,0.009411764705882352,0.9905882352941177,0.6494117647058824,0.3411764705882353
017K,01,7K,0,306,3,303,216,87,inf,0.00980392156862745,0.9901960784313726,0.7058823529411765,0.28431372549019607
017L,01,7L,0,531,5,526,353,173,inf,0.009416195856873822,0.9905838041431262,0.664783427495292,0.3258003766478343
017M,01,7M,0,505,4,501,347,154,inf,0.007920792079207921,0.9920792079207921,0.6871287128712872,0.30495049504950494
02101,02,101,1103,487,18,469,358,111,0.44152311876699907,0.03696098562628337,0.9630390143737166,0.7351129363449692,0.22792607802874743
02102,02,102,1225,488,2,486,365,121,0.3983673469387755,0.004098360655737705,0.9959016393442623,0.7479508196721312,0.24795081967213115
02103,02,103,1047,441,37,404,301,103,0.42120343839541546,0.08390022675736962,0.9160997732426304,0.6825396825396826,0.23356009070294784
02104,02,104,707,268,4,264,198,66,0.37906647807637905,0.014925373134328358,0.9850746268656716,0.7388059701492538,0.2462686567164179
02105,02,105,1011,396,14,382,309,73,0.3916913946587537,0.03535353535353535,0.9646464646464646,0.7803030303030303,0.18434343434343434
02106,02,106,1467,541,29,512,395,117,0.36877982276755283,0.053604436229205174,0.9463955637707948,0.7301293900184843,0.21626617375231053
02107,02,107,599,271,12,259,173,86,0.4524207011686144,0.04428044280442804,0.955719557195572,0.6383763837638377,0.3173431734317343
02108,02,108,661,259,6,253,128,125,0.3918305597579425,0.023166023166023165,0.9768339768339769,0.4942084942084942,0.4826254826254826
02109,02,109,1211,544,18,526,369,157,0.44921552436003304,0.03308823529411765,0.9669117647058824,0.6783088235294118,0.28860294117647056
02110,02,110,1090,443,11,432,282,150,0.40642201834862385,0.024830699774266364,0.9751693002257337,0.636568848758465,0.33860045146726864
02111,02,111,1149,484,13,471,382,89,0.4212358572671889,0.026859504132231406,0.9731404958677686,0.7892561983471075,0.18388429752066116
02112,02,112,1290,529,9,520,386,134,0.41007751937984493,0.017013232514177693,0.9829867674858223,0.7296786389413988,0.2533081285444234
02113,02,113,946,407,7,400,305,95,0.43023255813953487,0.0171990171990172,0.9828009828009828,0.7493857493857494,0.2334152334152334
02114,02,114,817,355,10,345,261,84,0.43451652386780903,0.028169014084507043,0.971830985915493,0.7352112676056338,0.23661971830985915
02115,02,115,804,372,14,358,287,71,0.4626865671641791,0.03763440860215054,0.9623655913978495,0.771505376344086,0.19086021505376344
02116,02,116,1039,471,15,456,351,105,0.45332050048123196,0.03184713375796178,0.9681528662420382,0.7452229299363057,0.2229299363057325
02117,02,117,1055,430,10,420,334,86,0.4075829383886256,0.023255813953488372,0.9767441860465116,0.7767441860465116,0.2
02118,02,118,668,259,5,254,188,66,0.38772455089820357,0.019305019305019305,0.9806949806949807,0.7258687258687259,0.2548262548262548
02119,02,119,828,350,5,345,270,75,0.4227053140096618,0.014285714285714285,0.9857142857142858,0.7714285714285715,0.21428571428571427
02120,02,120,824,362,11,351,279,72,0.4393203883495146,0.03038674033149171,0.9696132596685083,0.7707182320441989,0.19889502762430938
02121,02,121,869,387,3,384,296,88,0.44533947065592633,0.007751937984496124,0.9922480620155039,0.7648578811369509,0.22739018087855298
02122,02,122,1048,457,10,447,292,155,0.4360687022900763,0.02188183807439825,0.9781181619256017,0.6389496717724289,0.33916849015317285
02123,02,123,690,289,6,283,221,62,0.41884057971014493,0.020761245674740483,0.9792387543252595,0.7647058823529411,0.21453287197231835
02124,02,124,1284,574,17,557,402,155,0.4470404984423676,0.029616724738675958,0.9703832752613241,0.7003484320557491,0.2700348432055749
02125,02,125,1304,554,13,541,422,119,0.42484662576687116,0.023465703971119134,0.9765342960288809,0.7617328519855595,0.2148014440433213
02126,02,126,912,444,13,431,313,118,0.4868421052631579,0.02927927927927928,0.9707207207207207,0.704954954954955,0.26576576576576577
02127,02,127,862,373,7,366,267,99,0.43271461716937354,0.01876675603217158,0.9812332439678284,0.7158176943699732,0.26541554959785524
02128,02,128,1199,492,14,478,381,97,0.4103419516263553,0.028455284552845527,0.9715447154471545,0.774390243902439,0.19715447154471544
02129,02,129,1240,475,9,466,250,216,0.38306451612903225,0.018947368421052633,0.9810526315789474,0.5263157894736842,0.45473684210526316
02201,02,201,870,395,10,385,328,57,0.4540229885057471,0.02531645569620253,0.9746835443037974,0.830379746835443,0.14430379746835442
02202,02,202,1068,487,17,470,403,67,0.4559925093632959,0.03490759753593429,0.9650924024640657,0.8275154004106776,0.1375770020533881
02203,02,203,894,411,3,408,342,66,0.4597315436241611,0.0072992700729927005,0.9927007299270073,0.8321167883211679,0.16058394160583941
02204,02,204,1035,446,18,428,377,51,0.43091787439613527,0.04035874439461883,0.9596412556053812,0.8452914798206278,0.11434977578475336
02205,02,205,1001,453,5,448,386,62,0.45254745254745254,0.011037527593818985,0.9889624724061811,0.8520971302428256,0.1368653421633554
02206,02,206,953,424,9,415,335,80,0.44491080797481636,0.02122641509433962,0.9787735849056604,0.7900943396226415,0.18867924528301888
02207,02,207,1351,590,15,575,491,84,0.43671354552183567,0.025423728813559324,0.9745762711864406,0.8322033898305085,0.1423728813559322
02208,02,208,1115,515,18,497,388,109,0.4618834080717489,0.03495145631067961,0.9650485436893204,0.7533980582524272,0.21165048543689322
02209,02,209,1103,444,6,438,358,80,0.40253853127833183,0.013513513513513514,0.9864864864864865,0.8063063063063063,0.18018018018018017
02210,02,210,1103,454,8,446,383,63,0.41160471441523117,0.01762114537444934,0.9823788546255506,0.8436123348017621,0.13876651982378854
02211,02,211,1101,448,8,440,352,88,0.4069028156221617,0.017857142857142856,0.9821428571428571,0.7857142857142857,0.19642857142857142
02212,02,212,920,434,11,423,339,84,0.4717391304347826,0.02534562211981567,0.9746543778801844,0.7811059907834101,0.1935483870967742
02213,02,213,1117,472,13,459,385,74,0.42256042972247093,0.02754237288135593,0.972457627118644,0.815677966101695,0.15677966101694915
02214,02,214,913,348,6,342,285,57,0.38116100766703176,0.017241379310344827,0.9827586206896551,0.8189655172413793,0.16379310344827586
02215,02,215,891,390,15,375,325,50,0.4377104377104377,0.038461538461538464,0.9615384615384616,0.8333333333333334,0.1282051282051282
02216,02,216,839,399,4,395,321,74,0.4755661501787843,0.010025062656641603,0.9899749373433584,0.8045112781954887,0.18546365914786966
02217,02,217,1057,449,11,438,355,83,0.4247871333964049,0.024498886414253896,0.9755011135857461,0.7906458797327395,0.18485523385300667
02218,02,218,1133,508,8,500,387,113,0.44836716681376876,0.015748031496062992,0.984251968503937,0.7618110236220472,0.22244094488188976
02219,02,219,951,388,8,380,315,65,0.40799158780231337,0.020618556701030927,0.979381443298969,0.8118556701030928,0.16752577319587628
02220,02,220,1121,472,8,464,362,102,0.42105263157894735,0.01694915254237288,0.9830508474576272,0.7669491525423728,0.21610169491525424
02221,02,221,869,364,6,358,305,53,0.4188722669735328,0.016483516483516484,0.9835164835164835,0.8379120879120879,0.14560439560439561
02222,02,222,1074,462,16,446,364,82,0.4301675977653631,0.03463203463203463,0.9653679653679653,0.7878787878787878,0.1774891774891775
02223,02,223,817,323,11,312,272,40,0.3953488372093023,0.034055727554179564,0.9659442724458205,0.8421052631578947,0.1238390092879257
02224,02,224,935,386,7,379,302,77,0.4128342245989305,0.018134715025906734,0.9818652849740933,0.7823834196891192,0.19948186528497408
02225,02,225,689,274,6,268,194,74,0.397677793904209,0.021897810218978103,0.9781021897810219,0.708029197080292,0.27007299270072993
02226,02,226,1296,544,5,539,399,140,0.41975308641975306,0.009191176470588236,0.9908088235294118,0.7334558823529411,0.25735294117647056
02301,02,301,1104,526,17,509,385,124,0.47644927536231885,0.03231939163498099,0.967680608365019,0.7319391634980988,0.23574144486692014
02302,02,302,1175,515,14,501,344,157,0.43829787234042555,0.027184466019417475,0.9728155339805825,0.6679611650485436,0.3048543689320388
02303,02,303,1192,506,16,490,383,107,0.42449664429530204,0.03162055335968379,0.9683794466403162,0.7569169960474308,0.21146245059288538
02304,02,304,1072,478,10,468,364,104,0.4458955223880597,0.02092050209205021,0.9790794979079498,0.7615062761506276,0.2175732217573222
02305,02,305,1098,497,15,482,381,101,0.45264116575591984,0.030181086519114688,0.9698189134808853,0.7665995975855131,0.20321931589537223
02306,02,306,1068,461,5,456,355,101,0.43164794007490637,0.010845986984815618,0.9891540130151844,0.7700650759219089,0.21908893709327548
02307,02,307,800,352,7,345,293,52,0.44,0.019886363636363636,0.9801136363636364,0.8323863636363636,0.14772727272727273
02308,02,308,1206,472,27,445,352,93,0.3913764510779436,0.057203389830508475,0.9427966101694916,0.7457627118644068,0.19703389830508475
02309,02,309,776,304,9,295,238,57,0.3917525773195876,0.029605263157894735,0.9703947368421053,0.7828947368421053,0.1875
02310,02,310,1199,514,14,500,377,123,0.4286905754795663,0.027237354085603113,0.9727626459143969,0.7334630350194552,0.23929961089494164
02311,02,311,1152,493,10,483,399,84,0.4279513888888889,0.02028397565922921,0.9797160243407708,0.8093306288032455,0.17038539553752535
02312,02,312,740,309,11,298,235,63,0.4175675675675676,0.03559870550161812,0.9644012944983819,0.7605177993527508,0.20388349514563106
02313,02,313,809,324,17,307,247,60,0.4004944375772559,0.05246913580246913,0.9475308641975309,0.7623456790123457,0.18518518518518517
02314,02,314,1195,450,21,429,325,104,0.37656903765690375,0.04666666666666667,0.9533333333333334,0.7222222222222222,0.2311111111111111
02315,02,315,945,339,21,318,262,56,0.35873015873015873,0.061946902654867256,0.9380530973451328,0.7728613569321534,0.16519174041297935
02316,02,316,1220,408,13,395,314,81,0.3344262295081967,0.031862745098039214,0.9681372549019608,0.7696078431372549,0.19852941176470587
02317,02,317,1241,499,12,487,424,63,0.40209508460918614,0.02404809619238477,0.9759519038076152,0.8496993987975952,0.12625250501002003
02318,02,318,903,418,2,416,241,175,0.4629014396456257,0.004784688995215311,0.9952153110047847,0.5765550239234449,0.41866028708133973
02319,02,319,979,466,13,453,383,70,0.4759959141981614,0.027896995708154508,0.9721030042918455,0.8218884120171673,0.15021459227467812
02320,02,320,1041,426,10,416,372,44,0.4092219020172911,0.023474178403755867,0.9765258215962441,0.8732394366197183,0.10328638497652583
02321,02,321,906,413,14,399,354,45,0.45584988962472406,0.03389830508474576,0.9661016949152542,0.8571428571428571,0.1089588377723971
02322,02,322,999,429,17,412,345,67,0.4294294294294294,0.039627039627039624,0.9603729603729604,0.8041958041958042,0.1561771561771562
02323,02,323,1107,540,0,540,454,86,0.4878048780487805,0.0,1.0,0.8407407407407408,0.15925925925925927
02324,02,324,1151,489,23,466,390,76,0.42484795829713295,0.04703476482617587,0.9529652351738241,0.7975460122699386,0.1554192229038855
02325,02,325,1114,473,18,455,368,87,0.4245960502692998,0.03805496828752643,0.9619450317124736,0.7780126849894292,0.1839323467230444
02326,02,326,1085,522,4,518,452,66,0.48110599078341015,0.007662835249042145,0.9923371647509579,0.8659003831417624,0.12643678160919541
02327,02,327,892,351,11,340,284,56,0.39349775784753366,0.03133903133903134,0.9686609686609686,0.8091168091168092,0.15954415954415954
02401,02,401,1110,362,16,346,259,87,0.3261261261261261,0.04419889502762431,0.9558011049723757,0.7154696132596685,0.24033149171270718
02402,02,402,1124,479,21,458,327,131,0.4261565836298932,0.04384133611691023,0.9561586638830898,0.6826722338204593,0.27348643006263046
02403,02,403,1264,435,32,403,296,107,0.34414556962025317,0.0735632183908046,0.9264367816091954,0.6804597701149425,0.24597701149425288
02404,02,404,1089,432,18,414,283,131,0.39669421487603307,0.041666666666666664,0.9583333333333334,0.6550925925925926,0.30324074074074076
02405,02,405,889,320,6,314,196,118,0.35995500562429694,0.01875,0.98125,0.6125,0.36875
02406,02,406,963,384,11,373,281,92,0.3987538940809969,0.028645833333333332,0.9713541666666666,0.7317708333333334,0.23958333333333334
02407,02,407,797,333,8,325,232,93,0.4178168130489335,0.024024024024024024,0.975975975975976,0.6966966966966966,0.27927927927927926
02408,02,408,805,319,9,310,214,96,0.39627329192546584,0.02821316614420063,0.9717868338557993,0.670846394984326,0.30094043887147337
02409,02,409,1100,421,13,408,281,127,0.38272727272727275,0.030878859857482184,0.9691211401425178,0.667458432304038,0.3016627078384798
02410,02,410,1005,410,12,398,243,155,0.4079601990049751,0.02926829268292683,0.9707317073170731,0.5926829268292683,0.3780487804878049
02411,02,411,1156,496,22,474,360,114,0.4290657439446367,0.04435483870967742,0.9556451612903226,0.7258064516129032,0.22983870967741934
02412,02,412,1096,427,13,414,307,107,0.3895985401459854,0.03044496487119438,0.9695550351288056,0.7189695550351288,0.2505854800936768
02413,02,413,907,371,3,368,284,84,0.40904079382579933,0.008086253369272238,0.9919137466307277,0.7654986522911051,0.22641509433962265
02414,02,414,915,338,6,332,228,104,0.3693989071038251,0.01775147928994083,0.9822485207100592,0.6745562130177515,0.3076923076923077
02415,02,415,1159,507,5,502,376,126,0.4374460742018982,0.009861932938856016,0.9901380670611439,0.7416173570019724,0.2485207100591716
02416,02,416,1312,519,9,510,349,161,0.3955792682926829,0.017341040462427744,0.9826589595375722,0.6724470134874759,0.31021194605009633
02417,02,417,1081,432,15,417,325,92,0.3996299722479186,0.034722222222222224,0.9652777777777778,0.7523148148148148,0.21296296296296297
02418,02,418,1176,421,25,396,304,92,0.35799319727891155,0.05938242280285035,0.9406175771971497,0.7220902612826603,0.21852731591448932
02419,02,419,1300,473,30,443,326,117,0.3638461538461538,0.06342494714587738,0.9365750528541226,0.6892177589852009,0.24735729386892177
02420,02,420,828,330,8,322,220,102,0.39855072463768115,0.024242424242424242,0.9757575757575757,0.6666666666666666,0.3090909090909091
02421,02,421,935,362,16,346,250,96,0.3871657754010695,0.04419889502762431,0.9558011049723757,0.6906077348066298,0.26519337016574585
02422,02,422,847,333,2,331,207,124,0.39315230224321135,0.006006006006006006,0.993993993993994,0.6216216216216216,0.37237237237237236
02423,02,423,1153,457,12,445,334,111,0.396357328707719,0.0262582056892779,0.973741794310722,0.7308533916849015,0.24288840262582057
02424,02,424,864,348,0,348,240,108,0.4027777777777778,0.0,1.0,0.6896551724137931,0.3103448275862069
02425,02,425,1157,478,7,471,351,120,0.4131374243733794,0.014644351464435146,0.9853556485355649,0.7343096234309623,0.2510460251046025
02426,02,426,1154,440,5,435,323,112,0.38128249566724437,0.011363636363636364,0.9886363636363636,0.7340909090909091,0.2545454545454545
02427,02,427,1032,423,9,414,309,105,0.40988372093023256,0.02127659574468085,0.9787234042553191,0.7304964539007093,0.24822695035460993
02501,02,501,934,385,2,383,300,83,0.41220556745182013,0.005194805194805195,0.9948051948051948,0.7792207792207793,0.21558441558441557
02502,02,502,1281,460,13,447,334,113,0.3590944574551132,0.02826086956521739,0.9717391304347827,0.7260869565217392,0.24565217391304348
02503,02,503,1238,512,19,493,390,103,0.4135702746365105,0.037109375,0.962890625,0.76171875,0.201171875
02504,02,504,1083,448,13,435,301,134,0.4136657433056325,0.029017857142857144,0.9709821428571429,0.671875,0.29910714285714285
02505,02,505,1218,550,14,536,394,142,0.451559934318555,0.025454545454545455,0.9745454545454545,0.7163636363636363,0.2581818181818182
02506,02,506,1151,467,8,459,345,114,0.40573414422241527,0.017130620985010708,0.9828693790149893,0.7387580299785867,0.24411134903640258
02507,02,507,1205,486,19,467,346,121,0.4033195020746888,0.03909465020576132,0.9609053497942387,0.7119341563786008,0.24897119341563786
02508,02,508,1269,455,9,446,340,106,0.35855003940110325,0.01978021978021978,0.9802197802197802,0.7472527472527473,0.23296703296703297
02509,02,509,1036,448,11,437,347,90,0.43243243243243246,0.024553571428571428,0.9754464285714286,0.7745535714285714,0.20089285714285715
02510,02,510,977,331,13,318,239,79,0.33879222108495394,0.03927492447129909,0.9607250755287009,0.7220543806646526,0.23867069486404835
02511,02,511,796,286,4,282,184,98,0.3592964824120603,0.013986013986013986,0.986013986013986,0.6433566433566433,0.34265734265734266
02512,02,512,958,429,6,423,324,99,0.44780793319415446,0.013986013986013986,0.986013986013986,0.7552447552447552,0.23076923076923078
02513,02,513,1181,487,6,481,371,110,0.4123624047417443,0.012320328542094456,0.9876796714579056,0.7618069815195072,0.22587268993839835
02514,02,514,991,405,7,398,307,91,0.40867810292633705,0.01728395061728395,0.9827160493827161,0.7580246913580246,0.22469135802469137
02515,02,515,1019,384,2,382,315,67,0.37684003925417076,0.005208333333333333,0.9947916666666666,0.8203125,0.17447916666666666
02516,02,516,1018,377,9,368,268,100,0.3703339882121807,0.023872679045092837,0.9761273209549072,0.7108753315649867,0.26525198938992045
02517,02,517,1275,527,15,512,385,127,0.41333333333333333,0.028462998102466792,0.9715370018975332,0.7305502846299811,0.2409867172675522
02518,02,518,1208,476,13,463,328,135,0.39403973509933776,0.0273109243697479,0.9726890756302521,0.6890756302521008,0.28361344537815125
02519,02,519,1040,406,7,399,280,119,0.3903846153846154,0.017241379310344827,0.9827586206896551,0.6896551724137931,0.29310344827586204
02520,02,520,1224,519,11,508,403,105,0.42401960784313725,0.02119460500963391,0.9788053949903661,0.7764932562620424,0.2023121387283237
02521,02,521,1033,432,3,429,298,131,0.4181994191674734,0.006944444444444444,0.9930555555555556,0.6898148148148148,0.30324074074074076
02522,02,522,1227,491,14,477,384,93,0.4001629991850041,0.028513238289205704,0.9714867617107943,0.7820773930753564,0.1894093686354379
02523,02,523,1073,444,13,431,340,91,0.41379310344827586,0.02927927927927928,0.9707207207207207,0.7657657657657657,0.20495495495495494
02524,02,524,1052,379,17,362,280,82,0.3602661596958175,0.044854881266490766,0.9551451187335093,0.7387862796833773,0.21635883905013192
02525,02,525,989,429,9,420,322,98,0.43377148634984836,0.02097902097902098,0.9790209790209791,0.7505827505827506,0.22843822843822845
02526,02,526,1187,507,7,500,389,111,0.42712721145745575,0.013806706114398421,0.9861932938856016,0.7672583826429981,0.21893491124260356
02601,02,601,1249,530,18,512,216,296,0.4243394715772618,0.033962264150943396,0.9660377358490566,0.4075471698113208,0.5584905660377358
02602,02,602,909,444,7,437,241,196,0.4884488448844885,0.015765765765765764,0.9842342342342343,0.5427927927927928,0.44144144144144143
02603,02,603,1094,447,8,439,260,179,0.4085923217550274,0.017897091722595078,0.9821029082774049,0.5816554809843401,0.4004474272930649
02604,02,604,1045,434,14,420,307,113,0.415311004784689,0.03225806451612903,0.967741935483871,0.7073732718894009,0.26036866359447003
02605,02,605,1246,501,3,498,385,113,0.40208667736757625,0.005988023952095809,0.9940119760479041,0.7684630738522954,0.22554890219560877
02606,02,606,805,340,5,335,270,65,0.422360248447205,0.014705882352941176,0.9852941176470589,0.7941176470588235,0.19117647058823528
02607,02,607,843,408,5,403,227,176,0.48398576512455516,0.012254901960784314,0.9877450980392157,0.5563725490196079,0.43137254901960786
02608,02,608,1184,496,10,486,398,88,0.4189189189189189,0.020161290322580645,0.9798387096774194,0.8024193548387096,0.1774193548387097
02609,02,609,1106,462,7,455,364,91,0.4177215189873418,0.015151515151515152,0.9848484848484849,0.7878787878787878,0.19696969696969696
02610,02,610,1266,555,8,547,424,123,0.43838862559241704,0.014414414414414415,0.9855855855855856,0.7639639639639639,0.22162162162162163
02611,02,611,967,398,5,393,292,101,0.41158221302998965,0.01256281407035176,0.9874371859296482,0.7336683417085427,0.2537688442211055
02612,02,612,1067,448,4,444,346,98,0.4198687910028116,0.008928571428571428,0.9910714285714286,0.7723214285714286,0.21875
02613,02,613,1033,392,4,388,263,125,0.37947725072604066,0.01020408163265306,0.9897959183673469,0.6709183673469388,0.31887755102040816
02614,02,614,1207,572,16,556,428,128,0.4739022369511185,0.027972027972027972,0.972027972027972,0.7482517482517482,0.22377622377622378
02615,02,615,698,298,3,295,225,70,0.4269340974212034,0.010067114093959731,0.9899328859060402,0.7550335570469798,0.2348993288590604
02616,02,616,1189,517,7,510,401,109,0.4348191757779647,0.013539651837524178,0.9864603481624759,0.7756286266924565,0.21083172147001933
02617,02,617,1141,485,10,475,385,90,0.42506573181419804,0.020618556701030927,0.979381443298969,0.7938144329896907,0.18556701030927836
02618,02,618,1003,404,19,385,312,73,0.40279162512462613,0.04702970297029703,0.9529702970297029,0.7722772277227723,0.1806930693069307
02619,02,619,821,335,4,331,262,69,0.40803897685749085,0.011940298507462687,0.9880597014925373,0.7820895522388059,0.20597014925373133
02620,02,620,1058,409,5,404,334,70,0.38657844990548207,0.012224938875305624,0.9877750611246944,0.8166259168704156,0.17114914425427874
02621,02,621,784,289,4,285,231,54,0.36862244897959184,0.01384083044982699,0.986159169550173,0.7993079584775087,0.18685121107266436
02622,02,622,1025,393,9,384,284,100,0.38341463414634147,0.022900763358778626,0.9770992366412213,0.72264631043257,0.2544529262086514
02623,02,623,889,341,4,337,265,72,0.38357705286839144,0.011730205278592375,0.9882697947214076,0.7771260997067448,0.21114369501466276
02624,02,624,912,367,3,364,281,83,0.4024122807017544,0.008174386920980926,0.9918256130790191,0.7656675749318801,0.22615803814713897
02625,02,625,707,294,3,291,244,47,0.4158415841584158,0.01020408163265306,0.9897959183673469,0.8299319727891157,0.1598639455782313
02626,02,626,997,367,12,355,264,91,0.36810431293881646,0.0326975476839237,0.9673024523160763,0.7193460490463215,0.24795640326975477
02627,02,627,751,382,6,376,266,110,0.5086551264980027,0.015706806282722512,0.9842931937172775,0.6963350785340314,0.2879581151832461
02628,02,628,891,335,8,327,206,121,0.3759820426487093,0.023880597014925373,0.9761194029850746,0.6149253731343284,0.3611940298507463
021A,02,1A,0,273,2,271,189,82,inf,0.007326007326007326,0.9926739926739927,0.6923076923076923,0.30036630036630035
021AA,02,1AA,0,461,4,457,337,120,inf,0.008676789587852495,0.9913232104121475,0.7310195227765727,0.2603036876355748
021AB,02,1AB,0,576,8,568,307,261,inf,0.013888888888888888,0.9861111111111112,0.5329861111111112,0.453125
021B,02,1B,0,241,0,241,155,86,inf,0.0,1.0,0.6431535269709544,0.35684647302904565
021C,02,1C,0,202,5,197,134,63,inf,0.024752475247524754,0.9752475247524752,0.6633663366336634,0.3118811881188119
021D,02,1D,0,156,2,154,96,58,inf,0.01282051282051282,0.9871794871794872,0.6153846153846154,0.3717948717948718
021E,02,1E,0,210,1,209,160,49,inf,0.004761904761904762,0.9952380952380953,0.7619047619047619,0.23333333333333334
021F,02,1F,0,330,1,329,208,121,inf,0.0030303030303030303,0.996969696969697,0.6303030303030303,0.36666666666666664
021G,02,1G,0,473,4,469,220,249,inf,0.008456659619450317,0.9915433403805497,0.46511627906976744,0.5264270613107822
021H,02,1H,0,432,9,423,297,126,inf,0.020833333333333332,0.9791666666666666,0.6875,0.2916666666666667
021J,02,1J,0,448,6,442,343,99,inf,0.013392857142857142,0.9866071428571429,0.765625,0.22098214285714285
021K,02,1K,0,382,3,379,297,82,inf,0.007853403141361256,0.9921465968586387,0.7774869109947644,0.21465968586387435
021L,02,1L,0,467,6,461,346,115,inf,0.01284796573875803,0.987152034261242,0.7408993576017131,0.2462526766595289
021M,02,1M,0,412,9,403,280,123,inf,0.021844660194174758,0.9781553398058253,0.6796116504854369,0.29854368932038833
021N,02,1N,0,622,7,615,471,144,inf,0.011254019292604502,0.9887459807073955,0.7572347266881029,0.2315112540192926
021P,02,1P,0,350,3,347,270,77,inf,0.008571428571428572,0.9914285714285714,0.7714285714285715,0.22
021Q,02,1Q,0,378,2,376,292,84,inf,0.005291005291005291,0.9947089947089947,0.7724867724867724,0.2222222222222222
021R,02,1R,0,506,4,502,370,132,inf,0.007905138339920948,0.9920948616600791,0.7312252964426877,0.2608695652173913
021S,02,1S,0,320,4,316,238,78,inf,0.0125,0.9875,0.74375,0.24375
021T,02,1T,0,301,1,300,228,72,inf,0.0033222591362126247,0.9966777408637874,0.7574750830564784,0.23920265780730898
021U,02,1U,0,291,3,288,218,70,inf,0.010309278350515464,0.9896907216494846,0.7491408934707904,0.24054982817869416
021V,02,1V,0,360,3,357,270,87,inf,0.008333333333333333,0.9916666666666667,0.75,0.24166666666666667
021W,02,1W,0,469,5,464,327,137,inf,0.010660980810234541,0.9893390191897654,0.697228144989339,0.2921108742004264
021X,02,1X,0,621,8,613,463,150,inf,0.01288244766505636,0.9871175523349437,0.7455716586151369,0.24154589371980675
021Y,02,1Y,0,318,4,314,208,106,inf,0.012578616352201259,0.9874213836477987,0.6540880503144654,0.3333333333333333
021Z,02,1Z,0,321,2,319,223,96,inf,0.006230529595015576,0.9937694704049844,0.6947040498442367,0.29906542056074764
022A,02,2A,0,328,2,326,267,59,inf,0.006097560975609756,0.9939024390243902,0.8140243902439024,0.1798780487804878
022B,02,2B,0,372,5,367,330,37,inf,0.013440860215053764,0.9865591397849462,0.8870967741935484,0.09946236559139784
022C,02,2C,0,341,4,337,296,41,inf,0.011730205278592375,0.9882697947214076,0.8680351906158358,0.12023460410557185
022D,02,2D,0,334,1,333,286,47,inf,0.0029940119760479044,0.9970059880239521,0.8562874251497006,0.1407185628742515
022E,02,2E,0,320,3,317,273,44,inf,0.009375,0.990625,0.853125,0.1375
022F,02,2F,0,305,2,303,259,44,inf,0.006557377049180328,0.9934426229508196,0.8491803278688524,0.14426229508196722
022G,02,2G,0,438,0,438,342,96,inf,0.0,1.0,0.7808219178082192,0.2191780821917808
022H,02,2H,0,422,1,421,281,140,inf,0.002369668246445498,0.9976303317535545,0.6658767772511849,0.33175355450236965
022J,02,2J,0,361,1,360,291,69,inf,0.002770083102493075,0.997229916897507,0.8060941828254847,0.19113573407202217
022K,02,2K,0,368,4,364,309,55,inf,0.010869565217391304,0.9891304347826086,0.8396739130434783,0.14945652173913043
022L,02,2L,0,385,2,383,307,76,inf,0.005194805194805195,0.9948051948051948,0.7974025974025974,0.1974025974025974
022M,02,2M,0,333,1,332,273,59,inf,0.003003003003003003,0.996996996996997,0.8198198198198198,0.17717717717717718
022N,02,2N,0,337,2,335,267,68,inf,0.005934718100890208,0.9940652818991098,0.7922848664688428,0.20178041543026706
022P,02,2P,0,245,1,244,195,49,inf,0.004081632653061225,0.9959183673469387,0.7959183673469388,0.2
022Q,02,2Q,0,465,2,463,375,88,inf,0.004301075268817204,0.9956989247311828,0.8064516129032258,0.18924731182795698
022R,02,2R,0,378,4,374,297,77,inf,0.010582010582010581,0.9894179894179894,0.7857142857142857,0.2037037037037037
022S,02,2S,0,446,8,438,357,81,inf,0.017937219730941704,0.9820627802690582,0.8004484304932735,0.18161434977578475
022T,02,2T,0,287,2,285,225,60,inf,0.006968641114982578,0.9930313588850174,0.7839721254355401,0.20905923344947736
022U,02,2U,0,406,6,400,325,75,inf,0.014778325123152709,0.9852216748768473,0.8004926108374384,0.18472906403940886
022V,02,2V,0,288,16,272,238,34,inf,0.05555555555555555,0.9444444444444444,0.8263888888888888,0.11805555555555555
022W,02,2W,0,350,2,348,295,53,inf,0.005714285714285714,0.9942857142857143,0.8428571428571429,0.15142857142857144
022X,02,2X,0,145,3,142,124,18,inf,0.020689655172413793,0.9793103448275862,0.8551724137931035,0.12413793103448276
022Y,02,2Y,0,617,4,613,478,135,inf,0.006482982171799027,0.993517017828201,0.7747163695299838,0.2188006482982172
022Z,02,2Z,0,565,5,560,395,165,inf,0.008849557522123894,0.9911504424778761,0.6991150442477876,0.2920353982300885
023A,02,3A,0,430,5,425,296,129,inf,0.011627906976744186,0.9883720930232558,0.6883720930232559,0.3
023AA,02,3AA,0,384,3,381,318,63,inf,0.0078125,0.9921875,0.828125,0.1640625
023AB,02,3AB,0,342,3,339,262,77,inf,0.008771929824561403,0.9912280701754386,0.7660818713450293,0.22514619883040934
023B,02,3B,0,485,3,482,312,170,inf,0.006185567010309278,0.9938144329896907,0.643298969072165,0.35051546391752575
023C,02,3C,0,403,5,398,300,98,inf,0.01240694789081886,0.9875930521091811,0.7444168734491315,0.24317617866004962
023D,02,3D,0,377,0,377,291,86,inf,0.0,1.0,0.7718832891246684,0.22811671087533156
023E,02,3E,0,382,2,380,303,77,inf,0.005235602094240838,0.9947643979057592,0.7931937172774869,0.20157068062827224
023F,02,3F,0,351,2,349,265,84,inf,0.005698005698005698,0.9943019943019943,0.7549857549857549,0.23931623931623933
023G,02,3G,0,137,1,136,119,17,inf,0.0072992700729927005,0.9927007299270073,0.8686131386861314,0.12408759124087591
023H,02,3H,0,265,8,257,172,85,inf,0.03018867924528302,0.969811320754717,0.6490566037735849,0.32075471698113206
023J,02,3J,0,186,0,186,151,35,inf,0.0,1.0,0.8118279569892473,0.1881720430107527
023K,02,3K,0,335,9,326,214,112,inf,0.026865671641791045,0.9731343283582089,0.6388059701492538,0.33432835820895523
023L,02,3L,0,239,1,238,180,58,inf,0.0041841004184100415,0.99581589958159,0.7531380753138075,0.24267782426778242
023M,02,3M,0,298,3,295,248,47,inf,0.010067114093959731,0.9899328859060402,0.8322147651006712,0.15771812080536912
023N,02,3N,0,238,2,236,163,73,inf,0.008403361344537815,0.9915966386554622,0.6848739495798319,0.3067226890756303
023P,02,3P,0,212,12,200,162,38,inf,0.05660377358490566,0.9433962264150944,0.7641509433962265,0.1792452830188679
023Q,02,3Q,0,230,2,228,187,41,inf,0.008695652173913044,0.991304347826087,0.8130434782608695,0.1782608695652174
023R,02,3R,0,327,2,325,279,46,inf,0.0061162079510703364,0.9938837920489296,0.8532110091743119,0.14067278287461774
023S,02,3S,0,222,0,222,176,46,inf,0.0,1.0,0.7927927927927928,0.2072072072072072
023T,02,3T,0,310,2,308,261,47,inf,0.0064516129032258064,0.9935483870967742,0.8419354838709677,0.15161290322580645
023U,02,3U,0,311,3,308,278,30,inf,0.00964630225080386,0.9903536977491961,0.8938906752411575,0.09646302250803858
023V,02,3V,0,252,0,252,227,25,inf,0.0,1.0,0.9007936507936508,0.0992063492063492
023W,02,3W,0,204,2,202,179,23,inf,0.00980392156862745,0.9901960784313726,0.8774509803921569,0.11274509803921569
023X,02,3X,0,297,4,293,247,46,inf,0.013468013468013467,0.9865319865319865,0.8316498316498316,0.15488215488215487
023Y,02,3Y,0,397,1,396,314,82,inf,0.0025188916876574307,0.9974811083123426,0.7909319899244333,0.20654911838790932
023Z,02,3Z,0,259,5,254,196,58,inf,0.019305019305019305,0.9806949806949807,0.7567567567567568,0.22393822393822393
024A,02,4A,0,356,2,354,273,81,inf,0.0056179775280898875,0.9943820224719101,0.7668539325842697,0.22752808988764045
024AA,02,4AA,0,495,3,492,388,104,inf,0.006060606060606061,0.9939393939393939,0.7838383838383839,0.2101010101010101
024AB,02,4AB,0,576,3,573,424,149,inf,0.005208333333333333,0.9947916666666666,0.7361111111111112,0.2586805555555556
024AC,02,4AC,0,325,5,320,228,92,inf,0.015384615384615385,0.9846153846153847,0.7015384615384616,0.28307692307692306
024B,02,4B,0,378,27,351,266,85,inf,0.07142857142857142,0.9285714285714286,0.7037037037037037,0.22486772486772486
024C,02,4C,0,369,2,367,273,94,inf,0.005420054200542005,0.994579945799458,0.7398373983739838,0.25474254742547425
024D,02,4D,0,354,2,352,254,98,inf,0.005649717514124294,0.9943502824858758,0.7175141242937854,0.2768361581920904
024E,02,4E,0,406,5,401,282,119,inf,0.012315270935960592,0.9876847290640394,0.6945812807881774,0.29310344827586204
024F,02,4F,0,361,7,354,261,93,inf,0.019390581717451522,0.9806094182825484,0.7229916897506925,0.25761772853185594
024G,02,4G,0,298,3,295,214,81,inf,0.010067114093959731,0.9899328859060402,0.7181208053691275,0.27181208053691275
024H,02,4H,0,260,0,260,165,95,inf,0.0,1.0,0.6346153846153846,0.36538461538461536
024J,02,4J,0,428,9,419,298,121,inf,0.02102803738317757,0.9789719626168224,0.6962616822429907,0.2827102803738318
024K,02,4K,0,487,2,485,276,209,inf,0.004106776180698152,0.9958932238193019,0.5667351129363449,0.42915811088295686
024L,02,4L,0,421,6,415,320,95,inf,0.014251781472684086,0.9857482185273159,0.7600950118764845,0.22565320665083136
024M,02,4M,0,557,5,552,392,160,inf,0.008976660682226212,0.9910233393177738,0.703770197486535,0.2872531418312388
024N,02,4N,0,360,5,355,267,88,inf,0.013888888888888888,0.9861111111111112,0.7416666666666667,0.24444444444444444
024P,02,4P,0,409,3,406,263,143,inf,0.007334963325183374,0.9926650366748166,0.6430317848410758,0.34963325183374083
024Q,02,4Q,0,382,5,377,289,88,inf,0.013089005235602094,0.9869109947643979,0.756544502617801,0.23036649214659685
024R,02,4R,0,475,6,469,344,125,inf,0.01263157894736842,0.9873684210526316,0.7242105263157895,0.2631578947368421
024S,02,4S,0,371,1,370,278,92,inf,0.0026954177897574125,0.9973045822102425,0.7493261455525606,0.24797843665768193
024T,02,4T,0,371,6,365,276,89,inf,0.016172506738544475,0.9838274932614556,0.7439353099730458,0.2398921832884097
024U,02,4U,0,427,3,424,299,125,inf,0.00702576112412178,0.9929742388758782,0.7002341920374707,0.2927400468384075
024V,02,4V,0,243,1,242,174,68,inf,0.00411522633744856,0.9958847736625515,0.7160493827160493,0.27983539094650206
024W,02,4W,0,277,2,275,178,97,inf,0.007220216606498195,0.9927797833935018,0.6425992779783394,0.35018050541516244
024X,02,4X,0,300,3,297,168,129,inf,0.01,0.99,0.56,0.43
024Y,02,4Y,0,342,3,339,265,74,inf,0.008771929824561403,0.9912280701754386,0.7748538011695907,0.21637426900584794
024Z,02,4Z,0,322,1,321,221,100,inf,0.003105590062111801,0.9968944099378882,0.6863354037267081,0.3105590062111801
025A,02,5A,0,392,2,390,307,83,inf,0.00510204081632653,0.9948979591836735,0.7831632653061225,0.21173469387755103
025AA,02,5AA,0,497,6,491,353,138,inf,0.012072434607645875,0.9879275653923542,0.710261569416499,0.2776659959758551
025B,02,5B,0,563,11,552,418,134,inf,0.019538188277087035,0.9804618117229129,0.7424511545293073,0.23801065719360567
025C,02,5C,0,438,4,434,338,96,inf,0.0091324200913242,0.9908675799086758,0.771689497716895,0.2191780821917808
025D,02,5D,0,395,7,388,279,109,inf,0.017721518987341773,0.9822784810126582,0.7063291139240506,0.2759493670886076
025E,02,5E,0,483,2,481,350,131,inf,0.004140786749482402,0.9958592132505176,0.7246376811594203,0.2712215320910973
025F,02,5F,0,457,1,456,348,108,inf,0.002188183807439825,0.9978118161925602,0.7614879649890591,0.2363238512035011
025G,02,5G,0,453,11,442,373,69,inf,0.024282560706401765,0.9757174392935982,0.8233995584988962,0.152317880794702
025H,02,5H,0,441,2,439,324,115,inf,0.0045351473922902496,0.9954648526077098,0.7346938775510204,0.26077097505668934
025J,02,5J,0,383,6,377,301,76,inf,0.015665796344647518,0.9843342036553525,0.7859007832898173,0.19843342036553524
025K,02,5K,0,379,1,378,289,89,inf,0.002638522427440633,0.9973614775725593,0.762532981530343,0.23482849604221637
025L,02,5L,0,749,3,746,538,208,inf,0.004005340453938585,0.9959946595460614,0.7182910547396528,0.27770360480640854
025M,02,5M,0,515,7,508,385,123,inf,0.013592233009708738,0.9864077669902913,0.7475728155339806,0.23883495145631067
025N,02,5N,0,392,5,387,305,82,inf,0.012755102040816327,0.9872448979591837,0.7780612244897959,0.20918367346938777
025P,02,5P,0,359,3,356,272,84,inf,0.008356545961002786,0.9916434540389972,0.7576601671309192,0.233983286908078
025Q,02,5Q,0,455,4,451,314,137,inf,0.008791208791208791,0.9912087912087912,0.6901098901098901,0.3010989010989011
025R,02,5R,0,531,3,528,404,124,inf,0.005649717514124294,0.9943502824858758,0.7608286252354048,0.2335216572504708
025S,02,5S,0,495,4,491,356,135,inf,0.00808080808080808,0.9919191919191919,0.7191919191919192,0.2727272727272727
025T,02,5T,0,475,2,473,318,155,inf,0.004210526315789474,0.9957894736842106,0.6694736842105263,0.3263157894736842
025U,02,5U,0,417,3,414,332,82,inf,0.007194244604316547,0.9928057553956835,0.7961630695443646,0.19664268585131894
025V,02,5V,0,476,8,468,296,172,inf,0.01680672268907563,0.9831932773109243,0.6218487394957983,0.36134453781512604
025W,02,5W,0,439,1,438,343,95,inf,0.002277904328018223,0.9977220956719818,0.7813211845102506,0.2164009111617312
025X,02,5X,0,403,3,400,292,108,inf,0.007444168734491315,0.9925558312655087,0.7245657568238213,0.2679900744416873
025Y,02,5Y,0,414,2,412,315,97,inf,0.004830917874396135,0.9951690821256038,0.7608695652173914,0.23429951690821257
025Z,02,5Z,0,375,2,373,308,65,inf,0.005333333333333333,0.9946666666666667,0.8213333333333334,0.17333333333333334
026A,02,6A,0,529,4,525,253,272,inf,0.007561436672967864,0.9924385633270322,0.4782608695652174,0.5141776937618148
026AA,02,6AA,0,748,9,739,558,181,inf,0.012032085561497326,0.9879679144385026,0.7459893048128342,0.24197860962566844
026AB,02,6AB,0,397,5,392,218,174,inf,0.012594458438287154,0.9874055415617129,0.5491183879093199,0.43828715365239296
026B,02,6B,0,359,4,355,198,157,inf,0.011142061281337047,0.9888579387186629,0.5515320334261838,0.4373259052924791
026C,02,6C,0,398,2,396,249,147,inf,0.005025125628140704,0.9949748743718593,0.6256281407035176,0.3693467336683417
026D,02,6D,0,326,6,320,232,88,inf,0.018404907975460124,0.9815950920245399,0.7116564417177914,0.26993865030674846
026E,02,6E,0,449,1,448,341,107,inf,0.0022271714922048997,0.9977728285077951,0.7594654788418709,0.2383073496659243
026F,02,6F,0,316,2,314,230,84,inf,0.006329113924050633,0.9936708860759493,0.7278481012658228,0.26582278481012656
026G,02,6G,0,581,9,572,354,218,inf,0.01549053356282272,0.9845094664371773,0.6092943201376936,0.37521514629948366
026H,02,6H,0,487,2,485,377,108,inf,0.004106776180698152,0.9958932238193019,0.7741273100616016,0.22176591375770022
026J,02,6J,0,461,6,455,332,123,inf,0.013015184381778741,0.9869848156182213,0.720173535791757,0.2668112798264642
026K,02,6K,0,482,5,477,377,100,inf,0.01037344398340249,0.9896265560165975,0.7821576763485477,0.2074688796680498
026L,02,6L,0,399,2,397,306,91,inf,0.005012531328320802,0.9949874686716792,0.7669172932330827,0.22807017543859648
026M,02,6M,0,501,5,496,407,89,inf,0.00998003992015968,0.9900199600798403,0.812375249500998,0.17764471057884232
026N,02,6N,0,488,4,484,310,174,inf,0.00819672131147541,0.9918032786885246,0.6352459016393442,0.35655737704918034
026P,02,6P,0,312,11,301,192,109,inf,0.035256410256410256,0.9647435897435898,0.6153846153846154,0.34935897435897434
026Q,02,6Q,0,263,2,261,192,69,inf,0.0076045627376425855,0.9923954372623575,0.7300380228136882,0.2623574144486692
026R,02,6R,0,445,5,440,336,104,inf,0.011235955056179775,0.9887640449438202,0.755056179775281,0.23370786516853934
026S,02,6S,0,446,4,442,337,105,inf,0.008968609865470852,0.9910313901345291,0.7556053811659192,0.23542600896860988
026T,02,6T,0,393,5,388,327,61,inf,0.01272264631043257,0.9872773536895675,0.8320610687022901,0.15521628498727735
026U,02,6U,0,336,2,334,239,95,inf,0.005952380952380952,0.9940476190476191,0.7113095238095238,0.28273809523809523
026V,02,6V,0,470,5,465,368,97,inf,0.010638297872340425,0.9893617021276596,0.7829787234042553,0.20638297872340425
026W,02,6W,0,315,3,312,257,55,inf,0.009523809523809525,0.9904761904761905,0.8158730158730159,0.1746031746031746
026X,02,6X,0,429,1,428,252,176,inf,0.002331002331002331,0.9976689976689976,0.5874125874125874,0.41025641025641024
026Y,02,6Y,0,386,3,383,296,87,inf,0.007772020725388601,0.9922279792746114,0.7668393782383419,0.22538860103626943
026Z,02,6Z,0,389,3,386,304,82,inf,0.007712082262210797,0.9922879177377892,0.781491002570694,0.21079691516709512
03100,03,100,1277,515,14,501,297,204,0.4032889584964761,0.027184466019417475,0.9728155339805825,0.5766990291262136,0.39611650485436894
03101,03,101,902,367,5,362,215,147,0.40687361419068735,0.013623978201634877,0.9863760217983651,0.5858310626702997,0.40054495912806537
03102,03,102,1677,630,15,615,380,235,0.3756708407871199,0.023809523809523808,0.9761904761904762,0.6031746031746031,0.373015873015873
03103,03,103,1534,500,30,470,300,170,0.3259452411994785,0.06,0.94,0.6,0.34
03104,03,104,1443,528,19,509,312,197,0.3659043659043659,0.03598484848484849,0.9640151515151515,0.5909090909090909,0.3731060606060606
03105,03,105,1059,490,6,484,315,169,0.4627006610009443,0.012244897959183673,0.9877551020408163,0.6428571428571429,0.3448979591836735
03106,03,106,1339,531,28,503,340,163,0.3965646004480956,0.05273069679849341,0.9472693032015066,0.64030131826742,0.3069679849340866
03107,03,107,884,381,19,362,250,112,0.4309954751131222,0.049868766404199474,0.9501312335958005,0.6561679790026247,0.29396325459317585
03108,03,108,1347,614,31,583,386,197,0.45582776540460285,0.050488599348534204,0.9495114006514658,0.6286644951140065,0.32084690553745926
03109,03,109,1487,713,34,679,332,347,0.47948890383322124,0.047685834502103785,0.9523141654978962,0.46563814866760167,0.48667601683029454
03110,03,110,1433,621,22,599,425,174,0.4333565945568737,0.03542673107890499,0.964573268921095,0.6843800322061192,0.28019323671497587
03111,03,111,1363,639,14,625,339,286,0.46881878209831257,0.02190923317683881,0.9780907668231612,0.5305164319248826,0.4475743348982786
03112,03,112,1227,511,17,494,258,236,0.41646291768541155,0.033268101761252444,0.9667318982387475,0.5048923679060665,0.461839530332681
03113,03,113,1486,653,22,631,309,322,0.43943472409152085,0.033690658499234305,0.9663093415007658,0.47320061255742724,0.49310872894333846
03114,03,114,1007,443,18,425,173,252,0.4399205561072492,0.040632054176072234,0.9593679458239278,0.3905191873589165,0.5688487584650113
03115,03,115,978,417,10,407,205,202,0.4263803680981595,0.023980815347721823,0.9760191846522782,0.49160671462829736,0.4844124700239808
03116,03,116,1544,606,22,584,346,238,0.39248704663212436,0.036303630363036306,0.9636963696369637,0.570957095709571,0.3927392739273927
03117,03,117,1427,619,15,604,411,193,0.4337771548703574,0.024232633279483037,0.975767366720517,0.6639741518578353,0.31179321486268174
03118,03,118,1362,604,12,592,264,328,0.4434654919236417,0.019867549668874173,0.9801324503311258,0.4370860927152318,0.543046357615894
03119,03,119,1384,553,22,531,248,283,0.3995664739884393,0.039783001808318265,0.9602169981916817,0.4484629294755877,0.5117540687160941
03120,03,120,1159,507,15,492,210,282,0.4374460742018982,0.029585798816568046,0.9704142011834319,0.41420118343195267,0.5562130177514792
03121,03,121,1238,595,19,576,262,314,0.4806138933764136,0.031932773109243695,0.9680672268907563,0.4403361344537815,0.5277310924369748
03122,03,122,1271,531,22,509,158,351,0.4177812745869394,0.04143126177024482,0.9585687382297552,0.2975517890772128,0.6610169491525424
03123,03,123,1255,593,33,560,263,297,0.47250996015936253,0.05564924114671164,0.9443507588532883,0.44350758853288363,0.5008431703204047
03124,03,124,1127,527,13,514,234,280,0.4676131322094055,0.024667931688804556,0.9753320683111955,0.444022770398482,0.5313092979127134
03125,03,125,1275,578,22,556,263,293,0.4533333333333333,0.03806228373702422,0.9619377162629758,0.45501730103806226,0.5069204152249135
03126,03,126,1133,496,14,482,224,258,0.43777581641659313,0.028225806451612902,0.9717741935483871,0.45161290322580644,0.5201612903225806
03200,03,200,1417,544,14,530,215,315,0.38390966831333806,0.025735294117647058,0.9742647058823529,0.3952205882352941,0.5790441176470589
03201,03,201,636,352,19,333,133,200,0.5534591194968553,0.05397727272727273,0.9460227272727273,0.3778409090909091,0.5681818181818182
03202,03,202,865,450,25,425,208,217,0.5202312138728323,0.05555555555555555,0.9444444444444444,0.4622222222222222,0.4822222222222222
03203,03,203,1386,579,11,568,343,225,0.41774891774891776,0.018998272884283247,0.9810017271157168,0.5924006908462867,0.38860103626943004
03204,03,204,1187,500,31,469,289,180,0.42122999157540014,0.062,0.938,0.578,0.36
03205,03,205,1457,589,23,566,278,288,0.40425531914893614,0.03904923599320883,0.9609507640067911,0.47198641765704585,0.48896434634974534
03206,03,206,1419,640,39,601,275,326,0.4510218463706836,0.0609375,0.9390625,0.4296875,0.509375
03207,03,207,1201,529,15,514,271,243,0.440466278101582,0.02835538752362949,0.9716446124763705,0.5122873345935728,0.45935727788279773
03208,03,208,1502,626,8,618,355,263,0.4167776298268975,0.012779552715654952,0.987220447284345,0.5670926517571885,0.42012779552715657
03209,03,209,1524,631,14,617,368,249,0.4140419947506562,0.022187004754358162,0.9778129952456418,0.5832012678288431,0.39461172741679873
03210,03,210,1219,480,11,469,238,231,0.3937653814602133,0.022916666666666665,0.9770833333333333,0.49583333333333335,0.48125
03211,03,211,1393,588,15,573,260,313,0.4221105527638191,0.025510204081632654,0.9744897959183674,0.4421768707482993,0.532312925170068
03212,03,212,1437,551,9,542,314,228,0.38343771746694505,0.016333938294010888,0.9836660617059891,0.5698729582577132,0.41379310344827586
03213,03,213,1399,595,16,579,324,255,0.4253037884203002,0.02689075630252101,0.973109243697479,0.5445378151260504,0.42857142857142855
03214,03,214,1352,515,10,505,296,209,0.3809171597633136,0.019417475728155338,0.9805825242718447,0.574757281553398,0.4058252427184466
03215,03,215,1344,484,8,476,225,251,0.3601190476190476,0.01652892561983471,0.9834710743801653,0.46487603305785125,0.518595041322314
03216,03,216,1539,627,13,614,338,276,0.4074074074074074,0.02073365231259968,0.9792663476874003,0.5390749601275917,0.44019138755980863
03217,03,217,1375,619,18,601,321,280,0.4501818181818182,0.029079159935379646,0.9709208400646203,0.518578352180937,0.45234248788368336
03218,03,218,1255,500,8,492,257,235,0.398406374501992,0.016,0.984,0.514,0.47
03219,03,219,1477,658,11,647,360,287,0.44549763033175355,0.016717325227963525,0.9832826747720365,0.547112462006079,0.43617021276595747
03220,03,220,1439,608,10,598,300,298,0.4225156358582349,0.01644736842105263,0.9835526315789473,0.4934210526315789,0.4901315789473684
03221,03,221,1220,458,17,441,221,220,0.37540983606557377,0.03711790393013101,0.962882096069869,0.48253275109170307,0.48034934497816595
03222,03,222,1319,502,6,496,305,191,0.38059135708870356,0.01195219123505976,0.9880478087649402,0.6075697211155379,0.3804780876494024
03223,03,223,1392,550,18,532,278,254,0.39511494252873564,0.03272727272727273,0.9672727272727273,0.5054545454545455,0.4618181818181818
03224,03,224,1229,510,14,496,275,221,0.4149715215622457,0.027450980392156862,0.9725490196078431,0.5392156862745098,0.43333333333333335
03300,03,300,1313,531,5,526,240,286,0.4044173648134044,0.009416195856873822,0.9905838041431262,0.4519774011299435,0.5386064030131826
03301,03,301,1297,494,11,483,216,267,0.3808789514263685,0.022267206477732792,0.9777327935222672,0.43724696356275305,0.5404858299595142
03302,03,302,1582,622,27,595,431,164,0.393173198482933,0.04340836012861737,0.9565916398713826,0.6929260450160771,0.26366559485530544
03303,03,303,1364,513,18,495,324,171,0.37609970674486803,0.03508771929824561,0.9649122807017544,0.631578947368421,0.3333333333333333
03304,03,304,1372,617,18,599,339,260,0.44970845481049565,0.029173419773095625,0.9708265802269044,0.5494327390599676,0.4213938411669368
03305,03,305,1505,631,19,612,372,240,0.4192691029900332,0.030110935023771792,0.9698890649762282,0.589540412044374,0.3803486529318542
03306,03,306,1793,658,17,641,330,311,0.36698271054099274,0.025835866261398176,0.9741641337386018,0.5015197568389058,0.4726443768996961
03307,03,307,1393,643,17,626,410,216,0.46159368269921036,0.026438569206842923,0.973561430793157,0.6376360808709176,0.3359253499222395
03308,03,308,1468,630,12,618,405,213,0.42915531335149865,0.01904761904761905,0.9809523809523809,0.6428571428571429,0.3380952380952381
03309,03,309,1353,579,13,566,382,184,0.4279379157427938,0.022452504317789293,0.9775474956822107,0.6597582037996546,0.3177892918825561
03310,03,310,1372,620,16,604,427,177,0.4518950437317784,0.025806451612903226,0.9741935483870968,0.6887096774193548,0.2854838709677419
03311,03,311,1492,600,9,591,376,215,0.40214477211796246,0.015,0.985,0.6266666666666667,0.35833333333333334
03312,03,312,1364,630,29,601,418,183,0.46187683284457476,0.046031746031746035,0.953968253968254,0.6634920634920635,0.2904761904761905
03313,03,313,1445,649,12,637,344,293,0.4491349480968858,0.01848998459167951,0.9815100154083205,0.5300462249614792,0.4514637904468413
03314,03,314,1418,464,10,454,271,183,0.32722143864598024,0.021551724137931036,0.978448275862069,0.584051724137931,0.39439655172413796
03315,03,315,1216,582,5,577,417,160,0.4786184210526316,0.00859106529209622,0.9914089347079038,0.7164948453608248,0.27491408934707906
03316,03,316,1250,598,9,589,390,199,0.4784,0.015050167224080268,0.9849498327759197,0.6521739130434783,0.33277591973244147
03317,03,317,1604,636,13,623,423,200,0.39650872817955113,0.020440251572327043,0.9795597484276729,0.6650943396226415,0.31446540880503143
03318,03,318,1225,570,3,567,384,183,0.46530612244897956,0.005263157894736842,0.9947368421052631,0.6736842105263158,0.32105263157894737
03319,03,319,1418,550,26,524,368,156,0.38787023977433005,0.04727272727272727,0.9527272727272728,0.6690909090909091,0.28363636363636363
03320,03,320,1327,533,6,527,280,247,0.40165787490580257,0.01125703564727955,0.9887429643527205,0.525328330206379,0.4634146341463415
03321,03,321,1247,592,15,577,405,172,0.4747393744987971,0.02533783783783784,0.9746621621621622,0.6841216216216216,0.2905405405405405
03322,03,322,1206,540,10,530,364,166,0.44776119402985076,0.018518518518518517,0.9814814814814815,0.674074074074074,0.3074074074074074
03323,03,323,1109,496,7,489,286,203,0.4472497745716862,0.014112903225806451,0.9858870967741935,0.5766129032258065,0.4092741935483871
03400,03,400,1357,565,13,552,298,254,0.4163596168017686,0.023008849557522124,0.9769911504424779,0.5274336283185841,0.4495575221238938
03401,03,401,1480,616,14,602,455,147,0.41621621621621624,0.022727272727272728,0.9772727272727273,0.7386363636363636,0.23863636363636365
03402,03,402,1455,653,18,635,404,231,0.44879725085910654,0.027565084226646247,0.9724349157733537,0.6186830015313936,0.3537519142419602
03403,03,403,1527,619,19,600,402,198,0.40537000654878846,0.030694668820678513,0.9693053311793215,0.6494345718901454,0.3198707592891761
03404,03,404,1531,568,10,558,333,225,0.37099934683213587,0.017605633802816902,0.9823943661971831,0.5862676056338029,0.3961267605633803
03405,03,405,1562,630,26,604,417,187,0.4033290653008963,0.04126984126984127,0.9587301587301588,0.6619047619047619,0.2968253968253968
03406,03,406,1729,715,18,697,398,299,0.41353383458646614,0.025174825174825177,0.9748251748251748,0.5566433566433566,0.41818181818181815
03407,03,407,1588,663,16,647,418,229,0.41750629722921917,0.024132730015082957,0.975867269984917,0.6304675716440422,0.3453996983408748
03408,03,408,1716,713,21,692,359,333,0.4155011655011655,0.029453015427769985,0.97054698457223,0.5035063113604488,0.4670406732117812
03409,03,409,1642,673,18,655,368,287,0.40986601705237513,0.02674591381872214,0.9732540861812778,0.5468053491827637,0.4264487369985141
03410,03,410,1334,554,10,544,364,180,0.41529235382308843,0.018050541516245487,0.9819494584837545,0.6570397111913358,0.3249097472924188
03411,03,411,1655,724,30,694,321,373,0.43746223564954684,0.04143646408839779,0.9585635359116023,0.44337016574585636,0.5151933701657458
03412,03,412,1529,587,10,577,250,327,0.3839110529758012,0.017035775127768313,0.9829642248722317,0.42589437819420783,0.5570698466780238
03413,03,413,1473,622,3,619,266,353,0.4222674813306178,0.00482315112540193,0.9951768488745981,0.42765273311897106,0.567524115755627
03414,03,414,1517,610,11,599,229,370,0.4021094264996704,0.018032786885245903,0.9819672131147541,0.37540983606557377,0.6065573770491803
03415,03,415,1360,621,11,610,273,337,0.4566176470588235,0.017713365539452495,0.9822866344605475,0.4396135265700483,0.5426731078904992
03416,03,416,1353,522,13,509,277,232,0.3858093126385809,0.02490421455938697,0.975095785440613,0.5306513409961686,0.4444444444444444
03417,03,417,1563,596,25,571,182,389,0.38131797824696095,0.04194630872483222,0.9580536912751678,0.3053691275167785,0.6526845637583892
03418,03,418,1437,533,12,521,210,311,0.3709116214335421,0.0225140712945591,0.9774859287054409,0.39399624765478425,0.5834896810506567
03500,03,500,1336,520,7,513,337,176,0.38922155688622756,0.013461538461538462,0.9865384615384616,0.6480769230769231,0.3384615384615385
03501,03,501,1608,628,7,621,410,211,0.39054726368159204,0.011146496815286623,0.9888535031847133,0.6528662420382165,0.3359872611464968
03502,03,502,1281,623,16,607,430,177,0.48633879781420764,0.025682182985553772,0.9743178170144462,0.6902086677367576,0.2841091492776886
03503,03,503,1411,606,9,597,372,225,0.4294826364280652,0.01485148514851485,0.9851485148514851,0.6138613861386139,0.3712871287128713
03504,03,504,1393,621,22,599,427,172,0.4458004307250538,0.03542673107890499,0.964573268921095,0.6876006441223832,0.27697262479871176
03505,03,505,1414,459,9,450,288,162,0.3246110325318246,0.0196078431372549,0.9803921568627451,0.6274509803921569,0.35294117647058826
03506,03,506,1744,614,10,604,375,229,0.35206422018348627,0.016286644951140065,0.9837133550488599,0.6107491856677525,0.3729641693811075
03507,03,507,1488,573,13,560,347,213,0.3850806451612903,0.02268760907504363,0.9773123909249564,0.6055846422338569,0.3717277486910995
03508,03,508,1429,562,18,544,386,158,0.3932820153953814,0.03202846975088968,0.9679715302491103,0.6868327402135231,0.28113879003558717
03509,03,509,1496,512,21,491,328,163,0.3422459893048128,0.041015625,0.958984375,0.640625,0.318359375
03510,03,510,1436,581,22,559,372,187,0.40459610027855153,0.0378657487091222,0.9621342512908778,0.6402753872633391,0.3218588640275387
03511,03,511,1332,565,13,552,367,185,0.4241741741741742,0.023008849557522124,0.9769911504424779,0.6495575221238938,0.3274336283185841
03512,03,512,1480,630,11,619,433,186,0.42567567567567566,0.01746031746031746,0.9825396825396825,0.6873015873015873,0.29523809523809524
03513,03,513,1418,665,23,642,389,253,0.4689703808180536,0.03458646616541353,0.9654135338345865,0.5849624060150376,0.3804511278195489
03514,03,514,1501,576,26,550,385,165,0.38374417055296467,0.04513888888888889,0.9548611111111112,0.6684027777777778,0.2864583333333333
03515,03,515,1374,634,10,624,326,298,0.46142649199417757,0.015772870662460567,0.9842271293375394,0.5141955835962145,0.47003154574132494
03516,03,516,1639,712,21,691,323,368,0.4344112263575351,0.02949438202247191,0.9705056179775281,0.45365168539325845,0.5168539325842697
03517,03,517,1432,614,16,598,297,301,0.42877094972067037,0.026058631921824105,0.9739413680781759,0.4837133550488599,0.49022801302931596
03518,03,518,1278,560,11,549,367,182,0.4381846635367762,0.019642857142857142,0.9803571428571428,0.6553571428571429,0.325
03519,03,519,1364,529,11,518,349,169,0.3878299120234604,0.020793950850661626,0.9792060491493384,0.6597353497164461,0.31947069943289225
03520,03,520,1366,516,12,504,342,162,0.37774524158125916,0.023255813953488372,0.9767441860465116,0.6627906976744186,0.313953488372093
03600,03,600,1221,505,10,495,339,156,0.4135954135954136,0.019801980198019802,0.9801980198019802,0.6712871287128713,0.3089108910891089
03601,03,601,1350,495,9,486,342,144,0.36666666666666664,0.01818181818181818,0.9818181818181818,0.6909090909090909,0.2909090909090909
03602,03,602,1527,595,8,587,427,160,0.389652914210871,0.013445378151260505,0.9865546218487395,0.7176470588235294,0.2689075630252101
03603,03,603,1137,515,7,508,367,141,0.4529463500439754,0.013592233009708738,0.9864077669902913,0.7126213592233009,0.2737864077669903
03604,03,604,1410,640,10,630,450,180,0.45390070921985815,0.015625,0.984375,0.703125,0.28125
03605,03,605,1135,505,15,490,386,104,0.44493392070484583,0.0297029702970297,0.9702970297029703,0.7643564356435644,0.20594059405940593
03606,03,606,1225,512,6,506,341,165,0.4179591836734694,0.01171875,0.98828125,0.666015625,0.322265625
03607,03,607,1348,569,8,561,386,175,0.422106824925816,0.014059753954305799,0.9859402460456942,0.6783831282952548,0.30755711775043937
03608,03,608,1571,662,11,651,462,189,0.4213876511775939,0.01661631419939577,0.9833836858006042,0.6978851963746223,0.2854984894259819
03609,03,609,946,455,11,444,329,115,0.4809725158562368,0.024175824175824177,0.9758241758241758,0.7230769230769231,0.25274725274725274
03610,03,610,1097,514,10,504,366,138,0.46855059252506837,0.019455252918287938,0.980544747081712,0.7120622568093385,0.26848249027237353
03611,03,611,1213,472,6,466,357,109,0.3891178895300907,0.012711864406779662,0.9872881355932204,0.7563559322033898,0.2309322033898305
03612,03,612,1295,533,8,525,360,165,0.4115830115830116,0.0150093808630394,0.9849906191369606,0.6754221388367729,0.30956848030018763
03613,03,613,1485,588,12,576,418,158,0.39595959595959596,0.02040816326530612,0.9795918367346939,0.7108843537414966,0.2687074829931973
03614,03,614,1216,487,10,477,345,132,0.4004934210526316,0.02053388090349076,0.9794661190965093,0.7084188911704312,0.27104722792607805
03615,03,615,873,342,6,336,240,96,0.3917525773195876,0.017543859649122806,0.9824561403508771,0.7017543859649122,0.2807017543859649
03616,03,616,772,360,10,350,271,79,0.46632124352331605,0.027777777777777776,0.9722222222222222,0.7527777777777778,0.21944444444444444
03617,03,617,1581,642,11,631,448,183,0.4060721062618596,0.017133956386292833,0.9828660436137072,0.6978193146417445,0.2850467289719626
03618,03,618,841,361,5,356,236,120,0.4292508917954816,0.013850415512465374,0.9861495844875346,0.6537396121883656,0.33240997229916897
03619,03,619,936,387,4,383,297,86,0.41346153846153844,0.0103359173126615,0.9896640826873385,0.7674418604651163,0.2222222222222222
03620,03,620,1387,550,11,539,389,150,0.3965392934390771,0.02,0.98,0.7072727272727273,0.2727272727272727
03621,03,621,1309,534,12,522,388,134,0.4079449961802903,0.02247191011235955,0.9775280898876404,0.7265917602996255,0.250936329588015
03622,03,622,1190,443,10,433,297,136,0.3722689075630252,0.022573363431151242,0.9774266365688488,0.6704288939051919,0.30699774266365687
03623,03,623,1202,510,9,501,348,153,0.4242928452579035,0.01764705882352941,0.9823529411764705,0.6823529411764706,0.3
03624,03,624,1354,520,9,511,371,140,0.38404726735598227,0.01730769230769231,0.9826923076923076,0.7134615384615385,0.2692307692307692
03700,03,700,1249,562,9,553,364,189,0.4499599679743795,0.01601423487544484,0.9839857651245552,0.6476868327402135,0.33629893238434166
03701,03,701,1366,536,2,534,384,150,0.3923865300146413,0.0037313432835820895,0.996268656716418,0.7164179104477612,0.2798507462686567
03702,03,702,1124,472,9,463,292,171,0.4199288256227758,0.019067796610169493,0.9809322033898306,0.6186440677966102,0.3622881355932203
03703,03,703,1381,574,11,563,388,175,0.41564083997103546,0.01916376306620209,0.980836236933798,0.6759581881533101,0.3048780487804878
03704,03,704,1384,550,13,537,381,156,0.39739884393063585,0.023636363636363636,0.9763636363636363,0.6927272727272727,0.28363636363636363
03705,03,705,1086,525,16,509,330,179,0.48342541436464087,0.030476190476190476,0.9695238095238096,0.6285714285714286,0.34095238095238095
03706,03,706,1351,493,15,478,347,131,0.3649148778682457,0.030425963488843813,0.9695740365111561,0.7038539553752535,0.2657200811359026
03707,03,707,1478,517,8,509,356,153,0.3497970230040595,0.015473887814313346,0.9845261121856866,0.688588007736944,0.29593810444874274
03708,03,708,1350,505,12,493,355,138,0.37407407407407406,0.023762376237623763,0.9762376237623762,0.7029702970297029,0.2732673267326733
03709,03,709,1383,598,11,587,450,137,0.43239334779464933,0.01839464882943144,0.9816053511705686,0.7525083612040134,0.22909698996655517
03710,03,710,1591,595,15,580,423,157,0.3739786297925833,0.025210084033613446,0.9747899159663865,0.7109243697478992,0.2638655462184874
03711,03,711,1482,549,20,529,363,166,0.37044534412955465,0.03642987249544627,0.9635701275045537,0.6612021857923497,0.302367941712204
03712,03,712,1505,556,11,545,433,112,0.36943521594684386,0.019784172661870502,0.9802158273381295,0.7787769784172662,0.2014388489208633
03713,03,713,1149,497,12,485,302,183,0.43255004351610093,0.02414486921529175,0.9758551307847082,0.607645875251509,0.3682092555331992
03714,03,714,1172,474,12,462,297,165,0.4044368600682594,0.02531645569620253,0.9746835443037974,0.6265822784810127,0.34810126582278483
03715,03,715,1063,426,15,411,306,105,0.4007525870178739,0.035211267605633804,0.9647887323943662,0.7183098591549296,0.24647887323943662
03716,03,716,1331,579,10,569,401,168,0.43501126972201354,0.017271157167530225,0.9827288428324698,0.6925734024179621,0.29015544041450775
03717,03,717,1288,506,5,501,352,149,0.39285714285714285,0.009881422924901186,0.9901185770750988,0.6956521739130435,0.29446640316205536
03718,03,718,1366,596,10,586,370,216,0.4363103953147877,0.016778523489932886,0.9832214765100671,0.6208053691275168,0.3624161073825503
03719,03,719,1297,575,8,567,412,155,0.4433307632999229,0.01391304347826087,0.9860869565217392,0.7165217391304348,0.26956521739130435
03720,03,720,1334,531,9,522,392,130,0.3980509745127436,0.01694915254237288,0.9830508474576272,0.7382297551789078,0.2448210922787194
03721,03,721,1133,418,8,410,305,105,0.36893203883495146,0.019138755980861243,0.9808612440191388,0.7296650717703349,0.2511961722488038
03722,03,722,996,383,6,377,268,109,0.3845381526104418,0.015665796344647518,0.9843342036553525,0.6997389033942559,0.2845953002610966
03800,03,800,1650,684,26,658,482,176,0.41454545454545455,0.038011695906432746,0.9619883040935673,0.7046783625730995,0.2573099415204678
03801,03,801,1064,411,8,403,257,146,0.38627819548872183,0.019464720194647202,0.9805352798053528,0.6253041362530414,0.35523114355231145
03802,03,802,1125,464,11,453,338,115,0.41244444444444445,0.023706896551724137,0.9762931034482759,0.728448275862069,0.2478448275862069
03803,03,803,1262,498,13,485,351,134,0.39461172741679873,0.02610441767068273,0.9738955823293173,0.7048192771084337,0.26907630522088355
03804,03,804,765,343,5,338,246,92,0.44836601307189544,0.014577259475218658,0.9854227405247813,0.717201166180758,0.26822157434402333
03805,03,805,813,344,6,338,245,93,0.4231242312423124,0.01744186046511628,0.9825581395348837,0.7122093023255814,0.2703488372093023
03806,03,806,1334,498,7,491,313,178,0.3733133433283358,0.014056224899598393,0.9859437751004017,0.6285140562248996,0.357429718875502
03807,03,807,1064,405,6,399,266,133,0.3806390977443609,0.014814814814814815,0.9851851851851852,0.6567901234567901,0.32839506172839505
03808,03,808,1151,438,7,431,286,145,0.3805386620330148,0.01598173515981735,0.9840182648401826,0.6529680365296804,0.3310502283105023
03809,03,809,1214,318,9,309,217,92,0.26194398682042835,0.02830188679245283,0.9716981132075472,0.6823899371069182,0.2893081761006289
03810,03,810,1344,509,3,506,346,160,0.3787202380952381,0.005893909626719057,0.9941060903732809,0.6797642436149313,0.3143418467583497
03811,03,811,1374,525,10,515,365,150,0.38209606986899564,0.01904761904761905,0.9809523809523809,0.6952380952380952,0.2857142857142857
03812,03,812,1130,458,12,446,252,194,0.40530973451327434,0.026200873362445413,0.9737991266375546,0.5502183406113537,0.42358078602620086
03813,03,813,1122,435,4,431,286,145,0.3877005347593583,0.009195402298850575,0.9908045977011494,0.6574712643678161,0.3333333333333333
03814,03,814,1481,587,9,578,405,173,0.3963538149898717,0.015332197614991482,0.9846678023850085,0.6899488926746167,0.29471890971039183
03815,03,815,1580,643,5,638,437,201,0.4069620253164557,0.007776049766718507,0.9922239502332815,0.6796267496111975,0.31259720062208396
03816,03,816,1008,444,5,439,316,123,0.44047619047619047,0.01126126126126126,0.9887387387387387,0.7117117117117117,0.27702702702702703
03817,03,817,1281,461,6,455,312,143,0.3598750975800156,0.013015184381778741,0.9869848156182213,0.6767895878524945,0.31019522776572667
03818,03,818,1298,507,17,490,309,181,0.39060092449922956,0.03353057199211045,0.9664694280078896,0.6094674556213018,0.35700197238658776
03819,03,819,967,389,7,382,277,105,0.40227507755946224,0.017994858611825194,0.9820051413881749,0.712082262210797,0.2699228791773779
03820,03,820,1151,425,8,417,279,138,0.369244135534318,0.018823529411764704,0.9811764705882353,0.6564705882352941,0.3247058823529412
03821,03,821,1084,395,5,390,289,101,0.3643911439114391,0.012658227848101266,0.9873417721518988,0.7316455696202532,0.25569620253164554
03822,03,822,1263,445,10,435,267,168,0.35233570863024544,0.02247191011235955,0.9775280898876404,0.6,0.3775280898876405
03823,03,823,1305,496,8,488,340,148,0.3800766283524904,0.016129032258064516,0.9838709677419355,0.6854838709677419,0.29838709677419356
03900,03,900,1263,582,14,568,326,242,0.46080760095011875,0.024054982817869417,0.9759450171821306,0.5601374570446735,0.41580756013745707
03901,03,901,1335,627,5,622,441,181,0.4696629213483146,0.007974481658692184,0.9920255183413078,0.7033492822966507,0.2886762360446571
03902,03,902,1398,654,16,638,257,381,0.4678111587982833,0.024464831804281346,0.9755351681957186,0.3929663608562691,0.5825688073394495
03903,03,903,1255,539,9,530,334,196,0.4294820717131474,0.016697588126159554,0.9833024118738405,0.6196660482374768,0.36363636363636365
03904,03,904,1339,542,11,531,360,171,0.40477968633308437,0.02029520295202952,0.9797047970479705,0.6642066420664207,0.3154981549815498
03905,03,905,1280,435,14,421,275,146,0.33984375,0.03218390804597701,0.967816091954023,0.632183908045977,0.335632183908046
03906,03,906,1060,408,16,392,258,134,0.3849056603773585,0.0392156862745098,0.9607843137254902,0.6323529411764706,0.3284313725490196
03907,03,907,1102,440,23,417,277,140,0.3992740471869328,0.05227272727272727,0.9477272727272728,0.6295454545454545,0.3181818181818182
03908,03,908,1499,537,30,507,343,164,0.35823882588392264,0.055865921787709494,0.9441340782122905,0.638733705772812,0.3054003724394786
03909,03,909,1008,443,10,433,237,196,0.439484126984127,0.022573363431151242,0.9774266365688488,0.5349887133182845,0.44243792325056436
03910,03,910,1131,391,10,381,280,101,0.34571175950486294,0.02557544757033248,0.9744245524296675,0.7161125319693095,0.25831202046035806
03911,03,911,1362,509,9,500,367,133,0.3737151248164464,0.01768172888015717,0.9823182711198428,0.7210216110019646,0.26129666011787817
03912,03,912,1344,477,16,461,335,126,0.3549107142857143,0.033542976939203356,0.9664570230607966,0.7023060796645703,0.2641509433962264
03913,03,913,848,340,5,335,243,92,0.4009433962264151,0.014705882352941176,0.9852941176470589,0.7147058823529412,0.27058823529411763
03914,03,914,1195,428,2,426,299,127,0.3581589958158996,0.004672897196261682,0.9953271028037384,0.6985981308411215,0.2967289719626168
03915,03,915,853,317,5,312,220,92,0.3716295427901524,0.015772870662460567,0.9842271293375394,0.694006309148265,0.2902208201892745
03916,03,916,1270,496,8,488,313,175,0.3905511811023622,0.016129032258064516,0.9838709677419355,0.6310483870967742,0.3528225806451613
03917,03,917,1496,528,15,513,330,183,0.35294117647058826,0.028409090909090908,0.9715909090909091,0.625,0.3465909090909091
03918,03,918,1426,536,10,526,347,179,0.3758765778401122,0.018656716417910446,0.9813432835820896,0.6473880597014925,0.333955223880597
03919,03,919,1142,466,9,457,315,142,0.4080560420315236,0.019313304721030045,0.98068669527897,0.6759656652360515,0.30472103004291845
03920,03,920,1090,435,11,424,287,137,0.39908256880733944,0.02528735632183908,0.9747126436781609,0.6597701149425287,0.31494252873563217
03921,03,921,1117,450,7,443,313,130,0.40286481647269473,0.015555555555555555,0.9844444444444445,0.6955555555555556,0.28888888888888886
03922,03,922,1576,625,11,614,276,338,0.3965736040609137,0.0176,0.9824,0.4416,0.5408
03923,03,923,605,107,3,104,77,27,0.1768595041322314,0.028037383177570093,0.9719626168224299,0.719626168224299,0.2523364485981308
03924,03,924,1389,506,14,492,360,132,0.3642908567314615,0.02766798418972332,0.9723320158102767,0.7114624505928854,0.2608695652173913
03925,03,925,1248,486,6,480,262,218,0.3894230769230769,0.012345679012345678,0.9876543209876543,0.5390946502057613,0.448559670781893
03926,03,926,1393,527,10,517,382,135,0.3783201722900215,0.018975332068311195,0.9810246679316889,0.7248576850094877,0.25616698292220114
031A,03,1A,0,722,8,714,450,264,inf,0.0110803324099723,0.9889196675900277,0.6232686980609419,0.3656509695290859
031B,03,1B,0,597,3,594,348,246,inf,0.005025125628140704,0.9949748743718593,0.5829145728643216,0.4120603015075377
031C,03,1C,0,603,8,595,413,182,inf,0.013266998341625208,0.9867330016583747,0.6849087893864013,0.3018242122719735
031D,03,1D,0,615,5,610,392,218,inf,0.008130081300813009,0.991869918699187,0.6373983739837399,0.3544715447154472
031E,03,1E,0,398,8,390,276,114,inf,0.020100502512562814,0.9798994974874372,0.6934673366834171,0.2864321608040201
031F,03,1F,0,615,22,593,376,217,inf,0.03577235772357724,0.9642276422764228,0.6113821138211382,0.35284552845528455
031G,03,1G,0,754,10,744,496,248,inf,0.013262599469496022,0.986737400530504,0.6578249336870027,0.32891246684350134
031H,03,1H,0,1255,15,1240,578,662,inf,0.01195219123505976,0.9880478087649402,0.4605577689243028,0.5274900398406375
031I,03,1I,0,751,6,745,401,344,inf,0.007989347536617843,0.9920106524633822,0.5339547270306259,0.4580559254327563
031K,03,1K,0,834,10,824,430,394,inf,0.011990407673860911,0.988009592326139,0.5155875299760192,0.4724220623501199
031L,03,1L,0,812,9,803,435,368,inf,0.011083743842364532,0.9889162561576355,0.5357142857142857,0.45320197044334976
031M,03,1M,0,942,13,929,451,478,inf,0.013800424628450107,0.9861995753715499,0.47876857749469215,0.5074309978768577
031N,03,1N,0,1142,8,1134,516,618,inf,0.0070052539404553416,0.9929947460595446,0.45183887915936954,0.5411558669001751
032A,03,2A,0,323,4,319,189,130,inf,0.01238390092879257,0.9876160990712074,0.5851393188854489,0.4024767801857585
032B,03,2B,0,701,10,691,438,253,inf,0.014265335235378032,0.985734664764622,0.6248216833095578,0.3609129814550642
032C,03,2C,0,829,11,818,484,334,inf,0.013268998793727383,0.9867310012062727,0.5838359469240049,0.4028950542822678
032D,03,2D,0,1062,13,1049,483,566,inf,0.01224105461393597,0.987758945386064,0.4548022598870056,0.5329566854990584
032E,03,2E,0,931,10,921,509,412,inf,0.010741138560687433,0.9892588614393125,0.5467239527389903,0.44253490870032225
032F,03,2F,0,860,6,854,457,397,inf,0.0069767441860465115,0.9930232558139535,0.5313953488372093,0.46162790697674416
032G,03,2G,0,986,9,977,498,479,inf,0.009127789046653144,0.9908722109533469,0.5050709939148073,0.48580121703853957
032H,03,2H,0,1040,19,1021,628,393,inf,0.01826923076923077,0.9817307692307692,0.6038461538461538,0.3778846153846154
032I,03,2I,0,988,7,981,630,351,inf,0.00708502024291498,0.992914979757085,0.6376518218623481,0.35526315789473684
032K,03,2K,0,921,9,912,480,432,inf,0.009771986970684038,0.990228013029316,0.5211726384364821,0.46905537459283386
032L,03,2L,0,965,7,958,553,405,inf,0.007253886010362694,0.9927461139896373,0.5730569948186528,0.41968911917098445
032M,03,2M,0,1037,12,1025,541,484,inf,0.011571841851494697,0.9884281581485053,0.5216972034715526,0.46673095467695275
032N,03,2N,0,548,6,542,299,243,inf,0.010948905109489052,0.9890510948905109,0.5456204379562044,0.44343065693430656
033A,03,3A,0,1042,11,1031,516,515,inf,0.01055662188099808,0.989443378119002,0.4952015355086372,0.4942418426103647
033B,03,3B,0,968,14,954,573,381,inf,0.014462809917355372,0.9855371900826446,0.5919421487603306,0.39359504132231404
033C,03,3C,0,822,8,814,544,270,inf,0.009732360097323601,0.9902676399026764,0.6618004866180048,0.3284671532846715
033D,03,3D,0,1304,16,1288,821,467,inf,0.012269938650306749,0.9877300613496932,0.629601226993865,0.3581288343558282
033E,03,3E,0,913,10,903,642,261,inf,0.01095290251916758,0.9890470974808324,0.7031763417305587,0.2858707557502738
033F,03,3F,0,899,8,891,586,305,inf,0.008898776418242492,0.9911012235817576,0.6518353726362626,0.339265850945495
033G,03,3G,0,1032,11,1021,589,432,inf,0.01065891472868217,0.9893410852713178,0.5707364341085271,0.4186046511627907
033H,03,3H,0,1000,4,996,714,282,inf,0.004,0.996,0.714,0.282
033I,03,3I,0,882,7,875,604,271,inf,0.007936507936507936,0.9920634920634921,0.6848072562358276,0.3072562358276644
033K,03,3K,0,968,14,954,668,286,inf,0.014462809917355372,0.9855371900826446,0.6900826446280992,0.29545454545454547
033L,03,3L,0,1171,18,1153,745,408,inf,0.015371477369769428,0.9846285226302306,0.6362083689154568,0.3484201537147737
033M,03,3M,0,869,6,863,602,261,inf,0.006904487917146145,0.9930955120828538,0.6927502876869965,0.3003452243958573
034A,03,4A,0,939,5,934,438,496,inf,0.005324813631522897,0.9946751863684771,0.46645367412140576,0.5282215122470714
034B,03,4B,0,1177,15,1162,549,613,inf,0.012744265080713678,0.9872557349192863,0.46644010195412067,0.5208156329651656
034C,03,4C,0,915,14,901,540,361,inf,0.015300546448087432,0.9846994535519126,0.5901639344262295,0.3945355191256831
034D,03,4D,0,1106,9,1097,608,489,inf,0.0081374321880651,0.9918625678119349,0.5497287522603979,0.4421338155515371
034E,03,4E,0,811,14,797,540,257,inf,0.01726263871763255,0.9827373612823674,0.6658446362515413,0.31689272503082616
034F,03,4F,0,1113,15,1098,665,433,inf,0.013477088948787063,0.9865229110512129,0.5974842767295597,0.3890386343216532
034G,03,4G,0,860,10,850,587,263,inf,0.011627906976744186,0.9883720930232558,0.6825581395348838,0.3058139534883721
034H,03,4H,0,568,8,560,343,217,inf,0.014084507042253521,0.9859154929577465,0.6038732394366197,0.38204225352112675
034I,03,4I,0,571,14,557,359,198,inf,0.024518388791593695,0.9754816112084063,0.6287215411558669,0.3467600700525394
034K,03,4K,0,860,16,844,468,376,inf,0.018604651162790697,0.9813953488372092,0.5441860465116279,0.4372093023255814
034L,03,4L,0,441,5,436,277,159,inf,0.011337868480725623,0.9886621315192744,0.6281179138321995,0.36054421768707484
035A,03,5A,0,825,5,820,510,310,inf,0.006060606060606061,0.9939393939393939,0.6181818181818182,0.37575757575757573
035B,03,5B,0,1075,17,1058,605,453,inf,0.01581395348837209,0.9841860465116279,0.5627906976744186,0.4213953488372093
035C,03,5C,0,899,9,890,579,311,inf,0.010011123470522803,0.9899888765294772,0.6440489432703004,0.3459399332591769
035D,03,5D,0,989,9,980,689,291,inf,0.00910010111223458,0.9908998988877654,0.6966632962588474,0.2942366026289181
035E,03,5E,0,926,2,924,677,247,inf,0.0021598272138228943,0.9978401727861771,0.7311015118790497,0.26673866090712745
035F,03,5F,0,1063,9,1054,726,328,inf,0.008466603951081843,0.9915333960489181,0.6829727187206021,0.3085606773283161
035G,03,5G,0,526,7,519,342,177,inf,0.013307984790874524,0.9866920152091255,0.6501901140684411,0.3365019011406844
035H,03,5H,0,1009,9,1000,701,299,inf,0.008919722497522299,0.9910802775024777,0.6947472745292369,0.29633300297324083
035I,03,5I,0,997,14,983,707,276,inf,0.014042126379137413,0.9859578736208626,0.7091273821464393,0.2768304914744233
035K,03,5K,0,1070,9,1061,735,326,inf,0.008411214953271028,0.991588785046729,0.6869158878504673,0.30467289719626167
035L,03,5L,0,480,5,475,299,176,inf,0.010416666666666666,0.9895833333333334,0.6229166666666667,0.36666666666666664
035M,03,5M,0,726,11,715,466,249,inf,0.015151515151515152,0.9848484848484849,0.6418732782369146,0.34297520661157027
036A,03,6A,0,916,10,906,608,298,inf,0.010917030567685589,0.9890829694323144,0.6637554585152838,0.32532751091703055
036B,03,6B,0,964,4,960,738,222,inf,0.004149377593360996,0.995850622406639,0.7655601659751037,0.23029045643153526
036C,03,6C,0,954,5,949,682,267,inf,0.005241090146750524,0.9947589098532494,0.7148846960167715,0.279874213836478
036D,03,6D,0,622,13,609,426,183,inf,0.02090032154340836,0.9790996784565916,0.684887459807074,0.2942122186495177
036E,03,6E,0,1128,13,1115,780,335,inf,0.01152482269503546,0.9884751773049646,0.6914893617021277,0.2969858156028369
036F,03,6F,0,552,5,547,389,158,inf,0.009057971014492754,0.9909420289855072,0.7047101449275363,0.286231884057971
036G,03,6G,0,596,7,589,429,160,inf,0.01174496644295302,0.988255033557047,0.7197986577181208,0.2684563758389262
036H,03,6H,0,844,8,836,582,254,inf,0.009478672985781991,0.990521327014218,0.6895734597156398,0.3009478672985782
036I,03,6I,0,959,8,951,650,301,inf,0.008342022940563087,0.9916579770594369,0.6777893639207507,0.31386861313868614
036K,03,6K,0,1026,6,1020,758,262,inf,0.005847953216374269,0.9941520467836257,0.7387914230019493,0.2553606237816764
036L,03,6L,0,1047,12,1035,757,278,inf,0.011461318051575931,0.9885386819484241,0.723018147086915,0.26552053486150906
036M,03,6M,0,920,0,920,632,288,inf,0.0,1.0,0.6869565217391305,0.3130434782608696
036N,03,6N,0,1046,7,1039,717,322,inf,0.006692160611854685,0.9933078393881453,0.6854684512428298,0.3078393881453155
036P,03,6P,0,906,11,895,612,283,inf,0.012141280353200883,0.9878587196467992,0.6754966887417219,0.31236203090507725
037A,03,7A,0,911,8,903,598,305,inf,0.008781558726673985,0.991218441273326,0.6564215148188803,0.33479692645444564
037B,03,7B,0,958,9,949,643,306,inf,0.009394572025052192,0.9906054279749478,0.6711899791231732,0.31941544885177453
037C,03,7C,0,840,18,822,549,273,inf,0.02142857142857143,0.9785714285714285,0.6535714285714286,0.325
037D,03,7D,0,781,7,774,517,257,inf,0.008962868117797696,0.9910371318822023,0.6619718309859155,0.3290653008962868
037E,03,7E,0,989,11,978,685,293,inf,0.011122345803842264,0.9888776541961577,0.6926188068756319,0.29625884732052576
037F,03,7F,0,1023,20,1003,774,229,inf,0.019550342130987292,0.9804496578690127,0.7565982404692082,0.2238514173998045
037G,03,7G,0,997,16,981,703,278,inf,0.0160481444332999,0.9839518555667001,0.7051153460381143,0.27883650952858574
037H,03,7H,0,1046,9,1037,732,305,inf,0.008604206500956023,0.9913957934990439,0.6998087954110899,0.29158699808795413
037I,03,7I,0,1005,6,999,716,283,inf,0.005970149253731343,0.9940298507462687,0.7124378109452736,0.281592039800995
037K,03,7K,0,1009,16,993,728,265,inf,0.015857284440039643,0.9841427155599604,0.7215064420218038,0.2626362735381566
037L,03,7L,0,519,3,516,380,136,inf,0.005780346820809248,0.9942196531791907,0.7321772639691715,0.26204238921001927
037M,03,7M,0,1038,10,1028,766,262,inf,0.009633911368015413,0.9903660886319846,0.7379576107899807,0.2524084778420039
038A,03,8A,0,970,12,958,675,283,inf,0.012371134020618556,0.9876288659793815,0.6958762886597938,0.29175257731958765
038B,03,8B,0,1105,8,1097,681,416,inf,0.007239819004524887,0.9927601809954751,0.616289592760181,0.3764705882352941
038C,03,8C,0,1029,10,1019,631,388,inf,0.009718172983479106,0.9902818270165209,0.6132167152575316,0.3770651117589893
038D,03,8D,0,668,10,658,429,229,inf,0.014970059880239521,0.9850299401197605,0.6422155688622755,0.34281437125748504
038E,03,8E,0,1019,20,999,631,368,inf,0.019627085377821395,0.9803729146221786,0.619234543670265,0.36113837095191365
038F,03,8F,0,1066,11,1055,707,348,inf,0.010318949343339587,0.9896810506566605,0.6632270168855535,0.32645403377110693
038G,03,8G,0,619,2,617,410,207,inf,0.0032310177705977385,0.9967689822294022,0.6623586429725363,0.3344103392568659
038H,03,8H,0,622,12,610,329,281,inf,0.01929260450160772,0.9807073954983923,0.5289389067524116,0.4517684887459807
038I,03,8I,0,924,10,914,676,238,inf,0.010822510822510822,0.9891774891774892,0.7316017316017316,0.25757575757575757
038K,03,8K,0,1016,7,1009,660,349,inf,0.006889763779527559,0.9931102362204725,0.6496062992125984,0.343503937007874
038L,03,8L,0,999,10,989,684,305,inf,0.01001001001001001,0.98998998998999,0.6846846846846847,0.3053053053053053
038M,03,8M,0,938,7,931,616,315,inf,0.007462686567164179,0.9925373134328358,0.6567164179104478,0.3358208955223881
038N,03,8N,0,474,7,467,303,164,inf,0.014767932489451477,0.9852320675105485,0.6392405063291139,0.3459915611814346
038P,03,8P,0,1049,5,1044,675,369,inf,0.004766444232602479,0.9952335557673975,0.6434699714013346,0.3517635843660629
039A,03,9A,0,452,5,447,350,97,inf,0.011061946902654867,0.9889380530973452,0.7743362831858407,0.21460176991150443
039B,03,9B,0,957,5,952,630,322,inf,0.00522466039707419,0.9947753396029259,0.658307210031348,0.33646812957157785
039C,03,9C,0,831,9,822,456,366,inf,0.010830324909747292,0.9891696750902527,0.5487364620938628,0.4404332129963899
039D,03,9D,0,587,4,583,384,199,inf,0.0068143100511073255,0.9931856899488927,0.6541737649063032,0.3390119250425894
039E,03,9E,0,755,10,745,527,218,inf,0.013245033112582781,0.9867549668874173,0.6980132450331126,0.28874172185430463
039F,03,9F,0,620,7,613,405,208,inf,0.01129032258064516,0.9887096774193549,0.6532258064516129,0.33548387096774196
039G,03,9G,0,662,8,654,479,175,inf,0.012084592145015106,0.9879154078549849,0.7235649546827795,0.26435045317220546
039H,03,9H,0,760,5,755,516,239,inf,0.006578947368421052,0.993421052631579,0.6789473684210526,0.3144736842105263
039I,03,9I,0,913,10,903,656,247,inf,0.01095290251916758,0.9890470974808324,0.7185104052573932,0.27053669222343923
039K,03,9K,0,834,9,825,568,257,inf,0.01079136690647482,0.9892086330935251,0.6810551558752997,0.30815347721822545
039L,03,9L,0,1091,7,1084,694,390,inf,0.006416131989000917,0.9935838680109991,0.6361136571952337,0.35747021081576535
039M,03,9M,0,1152,12,1140,772,368,inf,0.010416666666666666,0.9895833333333334,0.6701388888888888,0.3194444444444444
039N,03,9N,0,1226,14,1212,771,441,inf,0.011419249592169658,0.9885807504078303,0.6288743882544862,0.35970636215334423
039P,03,9P,0,454,2,452,331,121,inf,0.004405286343612335,0.9955947136563876,0.7290748898678414,0.2665198237885463
039Q,03,9Q,0,741,9,732,359,373,inf,0.012145748987854251,0.9878542510121457,0.4844804318488529,0.5033738191632928
04101,04,101,1149,403,28,375,259,116,0.350739773716275,0.06947890818858561,0.9305210918114144,0.6426799007444168,0.2878411910669975
04102,04,102,696,229,19,210,152,58,0.3290229885057471,0.08296943231441048,0.9170305676855895,0.6637554585152838,0.25327510917030566
04103,04,103,1261,496,17,479,252,227,0.39333862014274384,0.034274193548387094,0.9657258064516129,0.5080645161290323,0.4576612903225806
04104,04,104,1021,351,14,337,234,103,0.3437806072477963,0.039886039886039885,0.9601139601139601,0.6666666666666666,0.2934472934472934
04105,04,105,1156,411,21,390,275,115,0.3555363321799308,0.051094890510948905,0.948905109489051,0.6690997566909975,0.2798053527980535
04106,04,106,1013,384,19,365,251,114,0.3790720631786772,0.049479166666666664,0.9505208333333334,0.6536458333333334,0.296875
04107,04,107,1206,441,47,394,224,170,0.3656716417910448,0.10657596371882086,0.8934240362811792,0.5079365079365079,0.3854875283446712
04108,04,108,454,192,6,186,122,64,0.42290748898678415,0.03125,0.96875,0.6354166666666666,0.3333333333333333
04109,04,109,1065,360,19,341,242,99,0.3380281690140845,0.05277777777777778,0.9472222222222222,0.6722222222222223,0.275
04110,04,110,1180,459,30,429,257,172,0.3889830508474576,0.06535947712418301,0.934640522875817,0.5599128540305011,0.3747276688453159
04111,04,111,980,386,12,374,220,154,0.39387755102040817,0.031088082901554404,0.9689119170984456,0.5699481865284974,0.39896373056994816
04112,04,112,1187,495,14,481,340,141,0.41701769165964614,0.028282828282828285,0.9717171717171718,0.6868686868686869,0.28484848484848485
04113,04,113,1344,547,27,520,341,179,0.4069940476190476,0.04936014625228519,0.9506398537477148,0.623400365630713,0.3272394881170018
04114,04,114,1173,445,13,432,272,160,0.3793691389599318,0.029213483146067417,0.9707865168539326,0.6112359550561798,0.3595505617977528
04115,04,115,1141,467,19,448,292,156,0.4092900964066608,0.04068522483940043,0.9593147751605996,0.6252676659528907,0.3340471092077088
04116,04,116,1272,530,15,515,324,191,0.4166666666666667,0.02830188679245283,0.9716981132075472,0.6113207547169811,0.360377358490566
04117,04,117,1035,411,21,390,219,171,0.39710144927536234,0.051094890510948905,0.948905109489051,0.5328467153284672,0.41605839416058393
04118,04,118,1137,401,18,383,248,135,0.3526824978012313,0.04488778054862843,0.9551122194513716,0.6184538653366584,0.33665835411471323
04119,04,119,1234,465,12,453,293,160,0.37682333873581847,0.025806451612903226,0.9741935483870968,0.6301075268817204,0.34408602150537637
04201,04,201,938,340,10,330,136,194,0.3624733475479744,0.029411764705882353,0.9705882352941176,0.4,0.5705882352941176
04202,04,202,1103,393,5,388,155,233,0.3563009972801451,0.01272264631043257,0.9872773536895675,0.3944020356234097,0.5928753180661578
04203,04,203,981,337,13,324,124,200,0.3435270132517839,0.03857566765578635,0.9614243323442137,0.36795252225519287,0.5934718100890207
04204,04,204,1332,476,39,437,228,209,0.35735735735735735,0.0819327731092437,0.9180672268907563,0.4789915966386555,0.43907563025210083
04205,04,205,921,387,14,373,135,238,0.4201954397394137,0.03617571059431524,0.9638242894056848,0.3488372093023256,0.6149870801033591
04206,04,206,1185,506,26,480,244,236,0.4270042194092827,0.05138339920948617,0.9486166007905138,0.48221343873517786,0.466403162055336
04207,04,207,1180,429,17,412,209,203,0.3635593220338983,0.039627039627039624,0.9603729603729604,0.48717948717948717,0.4731934731934732
04208,04,208,1184,312,29,283,203,80,0.2635135135135135,0.09294871794871795,0.907051282051282,0.6506410256410257,0.2564102564102564
04209,04,209,991,410,17,393,175,218,0.41372351160444,0.041463414634146344,0.9585365853658536,0.4268292682926829,0.5317073170731708
04210,04,210,1164,477,20,457,218,239,0.4097938144329897,0.041928721174004195,0.9580712788259959,0.4570230607966457,0.5010482180293501
04211,04,211,1075,448,12,436,178,258,0.41674418604651164,0.026785714285714284,0.9732142857142857,0.39732142857142855,0.5758928571428571
04212,04,212,1217,448,30,418,185,233,0.36811832374691866,0.06696428571428571,0.9330357142857143,0.41294642857142855,0.5200892857142857
04213,04,213,832,320,8,312,103,209,0.38461538461538464,0.025,0.975,0.321875,0.653125
04214,04,214,1285,497,18,479,263,216,0.3867704280155642,0.03621730382293763,0.9637826961770624,0.5291750503018109,0.4346076458752515
04215,04,215,1025,381,13,368,240,128,0.37170731707317073,0.03412073490813648,0.9658792650918635,0.6299212598425197,0.3359580052493438
04216,04,216,1304,531,20,511,212,299,0.4072085889570552,0.03766478342749529,0.9623352165725048,0.3992467043314501,0.5630885122410546
04217,04,217,1271,516,28,488,218,270,0.40597954366640443,0.05426356589147287,0.9457364341085271,0.42248062015503873,0.5232558139534884
04218,04,218,1226,492,20,472,223,249,0.401305057096248,0.04065040650406504,0.959349593495935,0.4532520325203252,0.5060975609756098
04219,04,219,1172,475,15,460,244,216,0.4052901023890785,0.031578947368421054,0.968421052631579,0.5136842105263157,0.45473684210526316
04220,04,220,1155,517,11,506,182,324,0.44761904761904764,0.02127659574468085,0.9787234042553191,0.3520309477756286,0.6266924564796905
04221,04,221,1211,482,13,469,220,249,0.39801816680429397,0.026970954356846474,0.9730290456431535,0.45643153526970953,0.516597510373444
04222,04,222,1225,457,10,447,255,192,0.3730612244897959,0.02188183807439825,0.9781181619256017,0.5579868708971554,0.4201312910284464
04223,04,223,1100,417,16,401,221,180,0.3790909090909091,0.03836930455635491,0.9616306954436451,0.5299760191846523,0.4316546762589928
04224,04,224,1063,475,13,462,131,331,0.4468485418626529,0.02736842105263158,0.9726315789473684,0.27578947368421053,0.6968421052631579
04225,04,225,1362,467,21,446,269,177,0.34287812041116006,0.044967880085653104,0.9550321199143469,0.576017130620985,0.37901498929336186
04226,04,226,1087,422,21,401,174,227,0.38822447102115915,0.04976303317535545,0.9502369668246445,0.41232227488151657,0.5379146919431279
04227,04,227,1070,457,11,446,152,294,0.42710280373831777,0.024070021881838075,0.975929978118162,0.33260393873085337,0.6433260393873085
04301,04,301,1236,429,22,407,298,109,0.3470873786407767,0.05128205128205128,0.9487179487179487,0.6946386946386947,0.2540792540792541
04302,04,302,1055,432,14,418,251,167,0.409478672985782,0.032407407407407406,0.9675925925925926,0.5810185185185185,0.38657407407407407
04303,04,303,1161,497,21,476,272,204,0.4280792420327304,0.04225352112676056,0.9577464788732394,0.5472837022132797,0.4104627766599598
04304,04,304,1038,431,10,421,226,195,0.41522157996146436,0.02320185614849188,0.9767981438515081,0.5243619489559165,0.45243619489559167
04305,04,305,952,355,10,345,242,103,0.37289915966386555,0.028169014084507043,0.971830985915493,0.6816901408450704,0.29014084507042254
04306,04,306,1053,502,17,485,334,151,0.47673314339981004,0.03386454183266932,0.9661354581673307,0.6653386454183267,0.300796812749004
04307,04,307,1186,535,14,521,347,174,0.45109612141652616,0.026168224299065422,0.9738317757009346,0.6485981308411215,0.3252336448598131
04308,04,308,776,313,11,302,167,135,0.40335051546391754,0.03514376996805112,0.9648562300319489,0.5335463258785943,0.43130990415335463
04309,04,309,1302,522,20,502,264,238,0.4009216589861751,0.038314176245210725,0.9616858237547893,0.5057471264367817,0.4559386973180077
04310,04,310,1167,502,20,482,295,187,0.4301628106255356,0.0398406374501992,0.9601593625498008,0.5876494023904383,0.37250996015936255
04311,04,311,973,394,14,380,209,171,0.40493319630010277,0.03553299492385787,0.9644670050761421,0.5304568527918782,0.434010152284264
04312,04,312,806,323,5,318,221,97,0.40074441687344914,0.015479876160990712,0.9845201238390093,0.6842105263157895,0.30030959752321984
04313,04,313,1193,460,17,443,234,209,0.38558256496227994,0.03695652173913044,0.9630434782608696,0.508695652173913,0.4543478260869565
04314,04,314,1136,413,8,405,252,153,0.363556338028169,0.01937046004842615,0.9806295399515739,0.6101694915254238,0.3704600484261501
04315,04,315,1095,456,12,444,259,185,0.41643835616438357,0.02631578947368421,0.9736842105263158,0.5679824561403509,0.4057017543859649
04316,04,316,1169,477,23,454,215,239,0.40804106073567153,0.04821802935010482,0.9517819706498952,0.45073375262054505,0.5010482180293501
04317,04,317,990,418,16,402,188,214,0.4222222222222222,0.03827751196172249,0.9617224880382775,0.44976076555023925,0.5119617224880383
04318,04,318,1127,513,14,499,302,197,0.4551907719609583,0.02729044834307992,0.9727095516569201,0.5886939571150097,0.3840155945419103
04319,04,319,907,364,14,350,194,156,0.4013230429988975,0.038461538461538464,0.9615384615384616,0.532967032967033,0.42857142857142855
04320,04,320,1035,412,12,400,241,159,0.39806763285024155,0.02912621359223301,0.970873786407767,0.5849514563106796,0.3859223300970874
04321,04,321,1112,464,23,441,260,181,0.4172661870503597,0.04956896551724138,0.9504310344827587,0.5603448275862069,0.3900862068965517
04322,04,322,1181,490,10,480,250,230,0.41490262489415747,0.02040816326530612,0.9795918367346939,0.5102040816326531,0.46938775510204084
04323,04,323,1102,443,22,421,222,199,0.40199637023593465,0.04966139954853273,0.9503386004514672,0.5011286681715575,0.4492099322799097
04324,04,324,1091,416,9,407,226,181,0.38130155820348305,0.021634615384615384,0.9783653846153846,0.5432692307692307,0.43509615384615385
04325,04,325,678,225,9,216,124,92,0.33185840707964603,0.04,0.96,0.5511111111111111,0.4088888888888889
04326,04,326,932,360,7,353,230,123,0.38626609442060084,0.019444444444444445,0.9805555555555555,0.6388888888888888,0.3416666666666667
04327,04,327,1012,414,15,399,276,123,0.4090909090909091,0.036231884057971016,0.9637681159420289,0.6666666666666666,0.2971014492753623
04328,04,328,1015,425,16,409,259,150,0.4187192118226601,0.03764705882352941,0.9623529411764706,0.6094117647058823,0.35294117647058826
04329,04,329,1193,529,15,514,325,189,0.44341994970662196,0.02835538752362949,0.9716446124763705,0.6143667296786389,0.3572778827977316
04401,04,401,1326,503,19,484,319,165,0.3793363499245852,0.03777335984095427,0.9622266401590457,0.6341948310139165,0.32803180914512925
04402,04,402,1138,441,23,418,276,142,0.3875219683655536,0.05215419501133787,0.9478458049886621,0.6258503401360545,0.3219954648526077
04403,04,403,532,166,4,162,96,66,0.31203007518796994,0.024096385542168676,0.9759036144578314,0.5783132530120482,0.39759036144578314
04404,04,404,1058,448,24,424,262,162,0.42344045368620037,0.05357142857142857,0.9464285714285714,0.5848214285714286,0.36160714285714285
04405,04,405,1109,466,14,452,264,188,0.42019837691614065,0.030042918454935622,0.9699570815450643,0.5665236051502146,0.4034334763948498
04406,04,406,1157,458,34,424,288,136,0.3958513396715644,0.07423580786026202,0.925764192139738,0.62882096069869,0.29694323144104806
04407,04,407,988,400,40,360,229,131,0.4048582995951417,0.1,0.9,0.5725,0.3275
04408,04,408,1143,408,10,398,254,144,0.3569553805774278,0.024509803921568627,0.9754901960784313,0.6225490196078431,0.35294117647058826
04409,04,409,1243,454,12,442,256,186,0.36524537409493163,0.02643171806167401,0.973568281938326,0.5638766519823789,0.40969162995594716
04410,04,410,1222,511,30,481,313,168,0.41816693944353517,0.05870841487279843,0.9412915851272016,0.6125244618395304,0.3287671232876712
04411,04,411,1153,464,7,457,238,219,0.40242844752818735,0.015086206896551725,0.9849137931034483,0.5129310344827587,0.47198275862068967
04412,04,412,1032,428,12,416,239,177,0.41472868217054265,0.028037383177570093,0.9719626168224299,0.5584112149532711,0.4135514018691589
04413,04,413,1137,481,11,470,261,209,0.4230430958663149,0.02286902286902287,0.9771309771309772,0.5426195426195426,0.43451143451143454
04414,04,414,1007,396,10,386,208,178,0.3932472691161867,0.025252525252525252,0.9747474747474747,0.5252525252525253,0.4494949494949495
04415,04,415,960,353,12,341,192,149,0.36770833333333336,0.0339943342776204,0.9660056657223796,0.5439093484419264,0.42209631728045327
04416,04,416,858,325,29,296,199,97,0.3787878787878788,0.08923076923076922,0.9107692307692308,0.6123076923076923,0.29846153846153844
04417,04,417,1112,439,15,424,226,198,0.3947841726618705,0.03416856492027335,0.9658314350797267,0.5148063781321185,0.4510250569476082
04418,04,418,846,355,10,345,163,182,0.41962174940898345,0.028169014084507043,0.971830985915493,0.4591549295774648,0.5126760563380282
04419,04,419,1234,467,13,454,247,207,0.37844408427876824,0.027837259100642397,0.9721627408993576,0.5289079229122056,0.44325481798715205
04420,04,420,781,287,16,271,139,132,0.3674775928297055,0.05574912891986063,0.9442508710801394,0.4843205574912892,0.45993031358885017
04421,04,421,942,359,9,350,194,156,0.38110403397027603,0.025069637883008356,0.9749303621169917,0.5403899721448467,0.43454038997214484
04422,04,422,1274,466,7,459,211,248,0.36577708006279436,0.015021459227467811,0.9849785407725322,0.45278969957081544,0.5321888412017167
04423,04,423,837,310,11,299,161,138,0.37037037037037035,0.035483870967741936,0.964516129032258,0.5193548387096775,0.44516129032258067
04424,04,424,1211,500,18,482,232,250,0.41288191577208916,0.036,0.964,0.464,0.5
04425,04,425,1136,416,18,398,179,219,0.36619718309859156,0.04326923076923077,0.9567307692307693,0.43028846153846156,0.5264423076923077
04426,04,426,1039,426,12,414,215,199,0.41000962463907603,0.028169014084507043,0.971830985915493,0.5046948356807511,0.4671361502347418
04427,04,427,1305,425,21,404,239,165,0.32567049808429116,0.04941176470588235,0.9505882352941176,0.5623529411764706,0.38823529411764707
04428,04,428,1213,524,27,497,274,223,0.4319868095630668,0.05152671755725191,0.9484732824427481,0.5229007633587787,0.4255725190839695
04429,04,429,882,393,9,384,202,182,0.445578231292517,0.022900763358778626,0.9770992366412213,0.5139949109414759,0.4631043256997455
04430,04,430,784,303,14,289,145,144,0.3864795918367347,0.0462046204620462,0.9537953795379538,0.47854785478547857,0.4752475247524752
04501,04,501,1144,480,5,475,127,348,0.4195804195804196,0.010416666666666666,0.9895833333333334,0.26458333333333334,0.725
04502,04,502,1075,401,18,383,92,291,0.3730232558139535,0.04488778054862843,0.9551122194513716,0.22942643391521197,0.7256857855361596
04503,04,503,1108,435,9,426,135,291,0.3925992779783393,0.020689655172413793,0.9793103448275862,0.3103448275862069,0.6689655172413793
04504,04,504,1231,475,25,450,234,216,0.38586515028432167,0.05263157894736842,0.9473684210526315,0.4926315789473684,0.45473684210526316
04505,04,505,1042,394,14,380,199,181,0.3781190019193858,0.03553299492385787,0.9644670050761421,0.5050761421319797,0.4593908629441624
04506,04,506,1139,431,22,409,214,195,0.3784021071115013,0.05104408352668213,0.9489559164733179,0.4965197215777262,0.45243619489559167
04507,04,507,922,340,14,326,174,152,0.368763557483731,0.041176470588235294,0.9588235294117647,0.5117647058823529,0.4470588235294118
04508,04,508,826,385,12,373,195,178,0.4661016949152542,0.03116883116883117,0.9688311688311688,0.5064935064935064,0.4623376623376623
04509,04,509,1171,430,14,416,207,209,0.3672075149444919,0.03255813953488372,0.9674418604651163,0.4813953488372093,0.48604651162790696
04510,04,510,1098,421,16,405,208,197,0.38342440801457195,0.03800475059382423,0.9619952494061758,0.49406175771971494,0.4679334916864608
04511,04,511,1135,381,11,370,165,205,0.3356828193832599,0.028871391076115485,0.9711286089238845,0.4330708661417323,0.5380577427821522
04512,04,512,1112,415,21,394,218,176,0.3732014388489209,0.05060240963855422,0.9493975903614458,0.5253012048192771,0.42409638554216866
04513,04,513,882,332,12,320,160,160,0.3764172335600907,0.03614457831325301,0.963855421686747,0.4819277108433735,0.4819277108433735
04514,04,514,894,292,7,285,129,156,0.32662192393736017,0.023972602739726026,0.976027397260274,0.4417808219178082,0.5342465753424658
04515,04,515,889,308,14,294,179,115,0.3464566929133858,0.045454545454545456,0.9545454545454546,0.5811688311688312,0.37337662337662336
04516,04,516,972,367,26,341,177,164,0.3775720164609053,0.07084468664850137,0.9291553133514986,0.4822888283378747,0.44686648501362397
04517,04,517,761,304,11,293,169,124,0.39947437582128775,0.03618421052631579,0.9638157894736842,0.555921052631579,0.40789473684210525
04518,04,518,989,335,10,325,183,142,0.33872598584428715,0.029850746268656716,0.9701492537313433,0.5462686567164179,0.42388059701492536
04519,04,519,1261,503,23,480,256,224,0.39888977002379067,0.04572564612326044,0.9542743538767395,0.5089463220675944,0.44532803180914515
04520,04,520,1338,508,31,477,206,271,0.3796711509715994,0.0610236220472441,0.9389763779527559,0.40551181102362205,0.5334645669291339
04521,04,521,944,361,19,342,129,213,0.3824152542372881,0.05263157894736842,0.9473684210526315,0.3573407202216066,0.590027700831025
04522,04,522,1115,454,16,438,109,329,0.40717488789237666,0.03524229074889868,0.9647577092511013,0.24008810572687225,0.724669603524229
04523,04,523,1082,445,20,425,174,251,0.411275415896488,0.0449438202247191,0.9550561797752809,0.39101123595505616,0.5640449438202247
04524,04,524,1184,395,20,375,77,298,0.33361486486486486,0.05063291139240506,0.9493670886075949,0.1949367088607595,0.7544303797468355
04525,04,525,1132,358,22,336,103,233,0.31625441696113077,0.061452513966480445,0.9385474860335196,0.2877094972067039,0.6508379888268156
04526,04,526,1073,330,11,319,147,172,0.30754892823858343,0.03333333333333333,0.9666666666666667,0.44545454545454544,0.5212121212121212
04527,04,527,808,353,19,334,205,129,0.4368811881188119,0.053824362606232294,0.9461756373937678,0.5807365439093485,0.3654390934844193
04528,04,528,802,318,9,309,138,171,0.39650872817955113,0.02830188679245283,0.9716981132075472,0.4339622641509434,0.5377358490566038
04529,04,529,1118,363,10,353,185,168,0.32468694096601075,0.027548209366391185,0.9724517906336089,0.509641873278237,0.4628099173553719
04601,04,601,1059,420,8,412,207,205,0.39660056657223797,0.01904761904761905,0.9809523809523809,0.4928571428571429,0.4880952380952381
04602,04,602,1039,438,9,429,213,216,0.4215591915303176,0.02054794520547945,0.9794520547945206,0.4863013698630137,0.4931506849315068
04603,04,603,1133,407,12,395,217,178,0.3592233009708738,0.029484029484029485,0.9705159705159705,0.5331695331695332,0.43734643734643736
04604,04,604,1016,384,19,365,207,158,0.3779527559055118,0.049479166666666664,0.9505208333333334,0.5390625,0.4114583333333333
04605,04,605,1077,418,13,405,226,179,0.3881151346332405,0.03110047846889952,0.9688995215311005,0.5406698564593302,0.42822966507177035
04606,04,606,1228,518,16,502,275,227,0.4218241042345277,0.03088803088803089,0.9691119691119691,0.5308880308880309,0.43822393822393824
04607,04,607,1126,415,10,405,209,196,0.3685612788632327,0.024096385542168676,0.9759036144578314,0.5036144578313253,0.472289156626506
04608,04,608,1186,423,19,404,219,185,0.3566610455311973,0.04491725768321513,0.9550827423167849,0.5177304964539007,0.4373522458628842
04609,04,609,1139,420,12,408,220,188,0.3687445127304653,0.02857142857142857,0.9714285714285714,0.5238095238095238,0.44761904761904764
04610,04,610,1140,475,9,466,260,206,0.4166666666666667,0.018947368421052633,0.9810526315789474,0.5473684210526316,0.4336842105263158
04611,04,611,1038,450,20,430,215,215,0.43352601156069365,0.044444444444444446,0.9555555555555556,0.4777777777777778,0.4777777777777778
04612,04,612,1356,536,46,490,279,211,0.3952802359882006,0.08582089552238806,0.914179104477612,0.5205223880597015,0.39365671641791045
04613,04,613,1267,438,11,427,234,193,0.345698500394633,0.02511415525114155,0.9748858447488584,0.5342465753424658,0.4406392694063927
04614,04,614,1118,435,10,425,220,205,0.389087656529517,0.022988505747126436,0.9770114942528736,0.5057471264367817,0.47126436781609193
04615,04,615,1126,476,21,455,253,202,0.4227353463587922,0.04411764705882353,0.9558823529411765,0.5315126050420168,0.42436974789915966
04616,04,616,1004,380,8,372,246,126,0.3784860557768924,0.021052631578947368,0.9789473684210527,0.6473684210526316,0.33157894736842103
04617,04,617,1313,479,11,468,266,202,0.3648134044173648,0.022964509394572025,0.9770354906054279,0.5553235908141962,0.42171189979123175
04618,04,618,1119,430,10,420,236,184,0.38427167113494193,0.023255813953488372,0.9767441860465116,0.5488372093023256,0.42790697674418604
04619,04,619,1068,425,12,413,227,186,0.397940074906367,0.02823529411764706,0.971764705882353,0.5341176470588235,0.4376470588235294
04620,04,620,1288,421,12,409,228,181,0.3268633540372671,0.028503562945368172,0.9714964370546318,0.5415676959619953,0.42992874109263657
04621,04,621,1246,480,16,464,268,196,0.3852327447833066,0.03333333333333333,0.9666666666666667,0.5583333333333333,0.4083333333333333
04622,04,622,1301,517,16,501,299,202,0.39738662567255956,0.030947775628626693,0.9690522243713733,0.5783365570599613,0.390715667311412
04623,04,623,1249,495,31,464,262,202,0.3963170536429143,0.06262626262626263,0.9373737373737374,0.5292929292929293,0.4080808080808081
04624,04,624,1223,570,12,558,311,247,0.4660670482420278,0.021052631578947368,0.9789473684210527,0.5456140350877193,0.43333333333333335
04625,04,625,1217,540,15,525,304,221,0.4437140509449466,0.027777777777777776,0.9722222222222222,0.562962962962963,0.40925925925925927
04626,04,626,1121,453,1,452,302,150,0.4041034790365745,0.002207505518763797,0.9977924944812362,0.6666666666666666,0.33112582781456956
04627,04,627,961,371,17,354,225,129,0.38605619146722164,0.04582210242587601,0.954177897574124,0.6064690026954178,0.3477088948787062
04701,04,701,1238,415,18,397,226,171,0.33521809369951533,0.043373493975903614,0.9566265060240964,0.5445783132530121,0.41204819277108434
04702,04,702,1126,427,21,406,262,144,0.37921847246891655,0.04918032786885246,0.9508196721311475,0.6135831381733021,0.3372365339578454
04703,04,703,1216,513,14,499,338,161,0.421875,0.02729044834307992,0.9727095516569201,0.6588693957115009,0.3138401559454191
04704,04,704,1207,456,21,435,241,194,0.37779618889809446,0.046052631578947366,0.9539473684210527,0.5285087719298246,0.42543859649122806
04705,04,705,1091,417,11,406,232,174,0.38221814848762603,0.026378896882494004,0.973621103117506,0.5563549160671463,0.4172661870503597
04706,04,706,1159,521,11,510,253,257,0.44952545297670404,0.02111324376199616,0.9788867562380038,0.4856046065259117,0.4932821497120921
04707,04,707,1041,436,26,410,259,151,0.41882804995196926,0.05963302752293578,0.9403669724770642,0.5940366972477065,0.3463302752293578
04708,04,708,1296,560,14,546,283,263,0.43209876543209874,0.025,0.975,0.5053571428571428,0.46964285714285714
04709,04,709,1302,394,20,374,194,180,0.30261136712749614,0.050761421319796954,0.949238578680203,0.49238578680203043,0.45685279187817257
04710,04,710,1280,470,12,458,211,247,0.3671875,0.02553191489361702,0.9744680851063829,0.44893617021276594,0.5255319148936171
04711,04,711,1321,439,12,427,204,223,0.33232399697199094,0.02733485193621868,0.9726651480637813,0.4646924829157175,0.5079726651480638
04712,04,712,1277,521,14,507,270,237,0.40798747063429913,0.026871401151631478,0.9731285988483686,0.5182341650671785,0.45489443378119004
04713,04,713,1229,495,32,463,236,227,0.402766476810415,0.06464646464646465,0.9353535353535354,0.4767676767676768,0.4585858585858586
04714,04,714,1292,541,11,530,332,198,0.41873065015479877,0.02033271719038817,0.9796672828096118,0.6136783733826248,0.3659889094269871
04715,04,715,1235,421,12,409,185,224,0.3408906882591093,0.028503562945368172,0.9714964370546318,0.43942992874109266,0.5320665083135392
04716,04,716,1324,525,11,514,345,169,0.39652567975830816,0.02095238095238095,0.979047619047619,0.6571428571428571,0.3219047619047619
04717,04,717,1176,519,12,507,262,245,0.4413265306122449,0.023121387283236993,0.976878612716763,0.5048169556840078,0.4720616570327553
04718,04,718,1000,400,12,388,166,222,0.4,0.03,0.97,0.415,0.555
04719,04,719,1002,352,12,340,188,152,0.35129740518962077,0.03409090909090909,0.9659090909090909,0.5340909090909091,0.4318181818181818
04720,04,720,1249,412,17,395,162,233,0.32986389111289033,0.0412621359223301,0.9587378640776699,0.3932038834951456,0.5655339805825242
04721,04,721,1266,460,18,442,244,198,0.36334913112164297,0.0391304347826087,0.9608695652173913,0.5304347826086957,0.43043478260869567
04722,04,722,1145,455,13,442,233,209,0.39737991266375544,0.02857142857142857,0.9714285714285714,0.512087912087912,0.4593406593406593
04723,04,723,1694,696,18,678,298,380,0.41086186540731995,0.02586206896551724,0.9741379310344828,0.4281609195402299,0.5459770114942529
04724,04,724,783,289,7,282,123,159,0.36909323116219667,0.02422145328719723,0.9757785467128027,0.42560553633217996,0.5501730103806228
04725,04,725,1166,526,13,513,295,218,0.451114922813036,0.024714828897338403,0.9752851711026616,0.5608365019011406,0.4144486692015209
04726,04,726,1242,550,21,529,261,268,0.4428341384863124,0.038181818181818185,0.9618181818181818,0.47454545454545455,0.48727272727272725
04727,04,727,875,331,4,327,113,214,0.3782857142857143,0.012084592145015106,0.9879154078549849,0.3413897280966767,0.6465256797583081
04801,04,801,1027,362,21,341,198,143,0.3524829600778968,0.058011049723756904,0.9419889502762431,0.5469613259668509,0.39502762430939226
04802,04,802,1315,393,16,377,231,146,0.29885931558935364,0.04071246819338423,0.9592875318066157,0.5877862595419847,0.37150127226463103
04803,04,803,1162,400,12,388,257,131,0.3442340791738382,0.03,0.97,0.6425,0.3275
04804,04,804,1043,451,18,433,260,173,0.4324065196548418,0.03991130820399113,0.9600886917960089,0.5764966740576497,0.3835920177383592
04805,04,805,973,341,23,318,216,102,0.35046248715313466,0.06744868035190615,0.9325513196480938,0.6334310850439883,0.2991202346041056
04806,04,806,1267,428,14,414,268,146,0.3378058405682715,0.03271028037383177,0.9672897196261683,0.6261682242990654,0.3411214953271028
04807,04,807,1128,375,8,367,246,121,0.3324468085106383,0.021333333333333333,0.9786666666666667,0.656,0.32266666666666666
041A,04,1A,0,333,3,330,245,85,inf,0.009009009009009009,0.990990990990991,0.7357357357357357,0.2552552552552553
041B,04,1B,0,186,4,182,115,67,inf,0.021505376344086023,0.978494623655914,0.6182795698924731,0.3602150537634409
041C,04,1C,0,362,6,356,165,191,inf,0.016574585635359115,0.9834254143646409,0.4558011049723757,0.5276243093922652
041D,04,1D,0,201,4,197,107,90,inf,0.01990049751243781,0.9800995024875622,0.5323383084577115,0.44776119402985076
041E,04,1E,0,241,7,234,150,84,inf,0.029045643153526972,0.970954356846473,0.6224066390041494,0.34854771784232363
041F,04,1F,0,247,3,244,130,114,inf,0.012145748987854251,0.9878542510121457,0.5263157894736842,0.46153846153846156
041G,04,1G,0,251,6,245,148,97,inf,0.02390438247011952,0.9760956175298805,0.5896414342629482,0.38645418326693226
041H,04,1H,0,306,2,304,169,135,inf,0.006535947712418301,0.9934640522875817,0.5522875816993464,0.4411764705882353
041I,04,1I,0,232,7,225,141,84,inf,0.03017241379310345,0.9698275862068966,0.6077586206896551,0.3620689655172414
041J,04,1J,0,309,3,306,181,125,inf,0.009708737864077669,0.9902912621359223,0.5857605177993528,0.4045307443365696
041K,04,1K,0,348,1,347,232,115,inf,0.0028735632183908046,0.9971264367816092,0.6666666666666666,0.33045977011494254
041L,04,1L,0,449,7,442,278,164,inf,0.015590200445434299,0.9844097995545658,0.6191536748329621,0.36525612472160357
041M,04,1M,0,440,7,433,256,177,inf,0.015909090909090907,0.9840909090909091,0.5818181818181818,0.4022727272727273
041N,04,1N,0,446,2,444,287,157,inf,0.004484304932735426,0.9955156950672646,0.6434977578475336,0.35201793721973096
041P,04,1P,0,466,6,460,305,155,inf,0.012875536480686695,0.9871244635193133,0.6545064377682404,0.33261802575107297
041Q,04,1Q,0,372,3,369,170,199,inf,0.008064516129032258,0.9919354838709677,0.45698924731182794,0.5349462365591398
041R,04,1R,0,417,6,411,242,169,inf,0.014388489208633094,0.9856115107913669,0.580335731414868,0.4052757793764988
041S,04,1S,0,408,9,399,248,151,inf,0.022058823529411766,0.9779411764705882,0.6078431372549019,0.3700980392156863
042A,04,2A,0,850,8,842,306,536,inf,0.009411764705882352,0.9905882352941177,0.36,0.6305882352941177
042B,04,2B,0,854,14,840,321,519,inf,0.01639344262295082,0.9836065573770492,0.3758782201405152,0.607728337236534
042C,04,2C,0,504,3,501,278,223,inf,0.005952380952380952,0.9940476190476191,0.5515873015873016,0.44246031746031744
042D,04,2D,0,406,1,405,202,203,inf,0.0024630541871921183,0.9975369458128078,0.4975369458128079,0.5
042E,04,2E,0,477,6,471,222,249,inf,0.012578616352201259,0.9874213836477987,0.46540880503144655,0.5220125786163522
042F,04,2F,0,401,7,394,259,135,inf,0.017456359102244388,0.9825436408977556,0.6458852867830424,0.33665835411471323
042G,04,2G,0,394,6,388,166,222,inf,0.015228426395939087,0.9847715736040609,0.4213197969543147,0.5634517766497462
042H,04,2H,0,458,2,456,201,255,inf,0.004366812227074236,0.9956331877729258,0.4388646288209607,0.5567685589519651
042I,04,2I,0,871,16,855,378,477,inf,0.018369690011481057,0.981630309988519,0.43398392652123996,0.547646383467279
042J,04,2J,0,557,0,557,214,343,inf,0.0,1.0,0.38420107719928187,0.6157989228007181
042K,04,2K,0,325,4,321,101,220,inf,0.012307692307692308,0.9876923076923076,0.31076923076923074,0.676923076923077
042L,04,2L,0,482,3,479,252,227,inf,0.006224066390041493,0.9937759336099585,0.5228215767634855,0.470954356846473
042M,04,2M,0,356,4,352,244,108,inf,0.011235955056179775,0.9887640449438202,0.6853932584269663,0.30337078651685395
042N,04,2N,0,497,9,488,180,308,inf,0.018108651911468814,0.9818913480885312,0.36217303822937624,0.6197183098591549
042P,04,2P,0,544,5,539,210,329,inf,0.009191176470588236,0.9908088235294118,0.3860294117647059,0.6047794117647058
042Q,04,2Q,0,459,7,452,184,268,inf,0.015250544662309368,0.9847494553376906,0.4008714596949891,0.5838779956427015
042R,04,2R,0,418,11,407,196,211,inf,0.02631578947368421,0.9736842105263158,0.4688995215311005,0.5047846889952153
042S,04,2S,0,466,3,463,141,322,inf,0.006437768240343348,0.9935622317596566,0.30257510729613735,0.6909871244635193
042T,04,2T,0,484,6,478,204,274,inf,0.012396694214876033,0.987603305785124,0.4214876033057851,0.5661157024793388
042U,04,2U,0,497,4,493,295,198,inf,0.008048289738430584,0.9919517102615694,0.5935613682092555,0.3983903420523139
042V,04,2V,0,389,6,383,183,200,inf,0.015424164524421594,0.9845758354755784,0.4704370179948586,0.5141388174807198
042W,04,2W,0,462,9,453,154,299,inf,0.01948051948051948,0.9805194805194806,0.3333333333333333,0.6471861471861472
042X,04,2X,0,480,0,480,291,189,inf,0.0,1.0,0.60625,0.39375
042Y,04,2Y,0,469,5,464,172,292,inf,0.010660980810234541,0.9893390191897654,0.36673773987206826,0.6226012793176973
043A,04,3A,0,436,9,427,299,128,inf,0.020642201834862386,0.9793577981651376,0.6857798165137615,0.29357798165137616
043B,04,3B,0,366,6,360,213,147,inf,0.01639344262295082,0.9836065573770492,0.5819672131147541,0.4016393442622951
043C,04,3C,0,402,5,397,214,183,inf,0.012437810945273632,0.9875621890547264,0.5323383084577115,0.4552238805970149
043D,04,3D,0,780,6,774,442,332,inf,0.007692307692307693,0.9923076923076923,0.5666666666666667,0.4256410256410256
043E,04,3E,0,659,3,656,426,230,inf,0.004552352048558422,0.9954476479514416,0.6464339908952959,0.3490136570561457
043F,04,3F,0,338,5,333,239,94,inf,0.014792899408284023,0.985207100591716,0.7071005917159763,0.2781065088757396
043G,04,3G,0,409,3,406,254,152,inf,0.007334963325183374,0.9926650366748166,0.6210268948655256,0.37163814180929094
043H,04,3H,0,674,3,671,326,345,inf,0.004451038575667656,0.9955489614243324,0.4836795252225519,0.5118694362017804
043I,04,3I,0,509,0,509,266,243,inf,0.0,1.0,0.5225933202357563,0.4774066797642436
043J,04,3J,0,408,2,406,216,190,inf,0.004901960784313725,0.9950980392156863,0.5294117647058824,0.46568627450980393
043K,04,3K,0,787,7,780,339,441,inf,0.008894536213468869,0.9911054637865311,0.4307496823379924,0.5603557814485387
043L,04,3L,0,497,2,495,264,231,inf,0.004024144869215292,0.9959758551307847,0.5311871227364185,0.4647887323943662
043M,04,3M,0,508,2,506,303,203,inf,0.003937007874015748,0.9960629921259843,0.5964566929133859,0.39960629921259844
043N,04,3N,0,431,7,424,241,183,inf,0.016241299303944315,0.9837587006960556,0.5591647331786543,0.4245939675174014
043P,04,3P,0,454,2,452,208,244,inf,0.004405286343612335,0.9955947136563876,0.4581497797356828,0.5374449339207048
043Q,04,3Q,0,453,3,450,274,176,inf,0.006622516556291391,0.9933774834437086,0.6048565121412803,0.38852097130242824
043R,04,3R,0,629,10,619,377,242,inf,0.01589825119236884,0.9841017488076311,0.5993640699523053,0.3847376788553259
043S,04,3S,0,763,15,748,462,286,inf,0.019659239842726082,0.9803407601572739,0.6055045871559633,0.3748361730013106
043T,04,3T,0,378,4,374,194,180,inf,0.010582010582010581,0.9894179894179894,0.5132275132275133,0.47619047619047616
043U,04,3U,0,504,5,499,275,224,inf,0.00992063492063492,0.9900793650793651,0.5456349206349206,0.4444444444444444
043V,04,3V,0,822,5,817,403,414,inf,0.006082725060827251,0.9939172749391727,0.4902676399026764,0.5036496350364964
043W,04,3W,0,437,6,431,263,168,inf,0.013729977116704805,0.9862700228832952,0.6018306636155606,0.38443935926773454
044A,04,4A,0,489,12,477,298,179,inf,0.024539877300613498,0.9754601226993865,0.6094069529652352,0.3660531697341513
044B,04,4B,0,396,9,387,217,170,inf,0.022727272727272728,0.9772727272727273,0.547979797979798,0.4292929292929293
044C,04,4C,0,546,3,543,276,267,inf,0.005494505494505495,0.9945054945054945,0.5054945054945055,0.489010989010989
044D,04,4D,0,684,8,676,382,294,inf,0.011695906432748537,0.9883040935672515,0.5584795321637427,0.4298245614035088
044E,04,4E,0,434,11,423,228,195,inf,0.02534562211981567,0.9746543778801844,0.5253456221198156,0.44930875576036866
044F,04,4F,0,354,8,346,209,137,inf,0.022598870056497175,0.9774011299435028,0.5903954802259888,0.3870056497175141
044G,04,4G,0,375,6,369,211,158,inf,0.016,0.984,0.5626666666666666,0.42133333333333334
044H,04,4H,0,527,15,512,268,244,inf,0.028462998102466792,0.9715370018975332,0.50853889943074,0.4629981024667932
044I,04,4I,0,363,4,359,230,129,inf,0.011019283746556474,0.9889807162534435,0.6336088154269972,0.35537190082644626
044J,04,4J,0,444,7,437,217,220,inf,0.015765765765765764,0.9842342342342343,0.48873873873873874,0.4954954954954955
044K,04,4K,0,643,6,637,386,251,inf,0.00933125972006221,0.9906687402799378,0.6003110419906688,0.39035769828926903
044L,04,4L,0,426,3,423,228,195,inf,0.007042253521126761,0.9929577464788732,0.5352112676056338,0.45774647887323944
044M,04,4M,0,422,3,419,234,185,inf,0.0071090047393364926,0.9928909952606635,0.5545023696682464,0.43838862559241704
044N,04,4N,0,660,4,656,355,301,inf,0.006060606060606061,0.9939393939393939,0.5378787878787878,0.45606060606060606
044P,04,4P,0,429,5,424,220,204,inf,0.011655011655011656,0.9883449883449883,0.5128205128205128,0.4755244755244755
044Q,04,4Q,0,711,7,704,381,323,inf,0.009845288326300985,0.9901547116736991,0.5358649789029536,0.4542897327707454
044R,04,4R,0,512,2,510,254,256,inf,0.00390625,0.99609375,0.49609375,0.5
044S,04,4S,0,613,6,607,281,326,inf,0.009787928221859706,0.9902120717781403,0.45840130505709625,0.531810766721044
044T,04,4T,0,551,4,547,241,306,inf,0.007259528130671506,0.9927404718693285,0.43738656987295826,0.5553539019963702
044U,04,4U,0,287,2,285,111,174,inf,0.006968641114982578,0.9930313588850174,0.3867595818815331,0.6062717770034843
044V,04,4V,0,420,3,417,180,237,inf,0.007142857142857143,0.9928571428571429,0.42857142857142855,0.5642857142857143
044W,04,4W,0,457,4,453,178,275,inf,0.0087527352297593,0.9912472647702407,0.38949671772428884,0.6017505470459519
044X,04,4X,0,511,9,502,282,220,inf,0.01761252446183953,0.9823874755381604,0.5518590998043053,0.43052837573385516
044Y,04,4Y,0,455,13,442,228,214,inf,0.02857142857142857,0.9714285714285714,0.5010989010989011,0.4703296703296703
045A,04,5A,0,413,1,412,117,295,inf,0.002421307506053269,0.9975786924939467,0.28329297820823246,0.7142857142857143
045B,04,5B,0,805,11,794,249,545,inf,0.013664596273291925,0.986335403726708,0.3093167701863354,0.6770186335403726
045C,04,5C,0,405,6,399,107,292,inf,0.014814814814814815,0.9851851851851852,0.2641975308641975,0.7209876543209877
045D,04,5D,0,391,4,387,180,207,inf,0.010230179028132993,0.989769820971867,0.46035805626598464,0.5294117647058824
045E,04,5E,0,783,11,772,401,371,inf,0.0140485312899106,0.9859514687100894,0.51213282247765,0.47381864623243936
045F,04,5F,0,448,4,444,222,222,inf,0.008928571428571428,0.9910714285714286,0.4955357142857143,0.4955357142857143
045G,04,5G,0,627,8,619,317,302,inf,0.012759170653907496,0.9872408293460925,0.5055821371610846,0.48165869218500795
045H,04,5H,0,473,7,466,219,247,inf,0.014799154334038054,0.985200845665962,0.4630021141649049,0.5221987315010571
045I,04,5I,0,427,8,419,206,213,inf,0.01873536299765808,0.9812646370023419,0.48243559718969553,0.49882903981264637
045J,04,5J,0,795,3,792,370,422,inf,0.0037735849056603774,0.9962264150943396,0.46540880503144655,0.5308176100628931
045K,04,5K,0,378,1,377,191,186,inf,0.0026455026455026454,0.9973544973544973,0.5052910052910053,0.49206349206349204
045L,04,5L,0,860,12,848,434,414,inf,0.013953488372093023,0.986046511627907,0.5046511627906977,0.4813953488372093
045M,04,5M,0,760,3,757,389,368,inf,0.003947368421052632,0.9960526315789474,0.5118421052631579,0.4842105263157895
045N,04,5N,0,507,2,505,263,242,inf,0.0039447731755424065,0.9960552268244576,0.5187376725838264,0.47731755424063116
045P,04,5P,0,415,4,411,242,169,inf,0.00963855421686747,0.9903614457831326,0.5831325301204819,0.4072289156626506
045Q,04,5Q,0,532,3,529,225,304,inf,0.005639097744360902,0.9943609022556391,0.42293233082706766,0.5714285714285714
045R,04,5R,0,412,5,407,87,320,inf,0.012135922330097087,0.9878640776699029,0.2111650485436893,0.7766990291262136
045S,04,5S,0,432,10,422,159,263,inf,0.023148148148148147,0.9768518518518519,0.3680555555555556,0.6087962962962963
045T,04,5T,0,533,6,527,91,436,inf,0.01125703564727955,0.9887429643527205,0.17073170731707318,0.8180112570356473
045U,04,5U,0,514,4,510,138,372,inf,0.007782101167315175,0.9922178988326849,0.26848249027237353,0.7237354085603113
045V,04,5V,0,445,5,440,192,248,inf,0.011235955056179775,0.9887640449438202,0.4314606741573034,0.5573033707865168
045W,04,5W,0,317,0,317,122,195,inf,0.0,1.0,0.38485804416403785,0.6151419558359621
046A,04,6A,0,836,9,827,390,437,inf,0.01076555023923445,0.9892344497607656,0.4665071770334928,0.5227272727272727
046B,04,6B,0,812,4,808,391,417,inf,0.0049261083743842365,0.9950738916256158,0.4815270935960591,0.5135467980295566
046C,04,6C,0,359,5,354,127,227,inf,0.013927576601671309,0.9860724233983287,0.35376044568245124,0.6323119777158774
046D,04,6D,0,746,12,734,392,342,inf,0.0160857908847185,0.9839142091152815,0.5254691689008043,0.4584450402144772
046E,04,6E,0,415,4,411,194,217,inf,0.00963855421686747,0.9903614457831326,0.4674698795180723,0.5228915662650603
046F,04,6F,0,460,6,454,221,233,inf,0.013043478260869565,0.9869565217391304,0.48043478260869565,0.5065217391304347
046G,04,6G,0,474,7,467,245,222,inf,0.014767932489451477,0.9852320675105485,0.5168776371308017,0.46835443037974683
046H,04,6H,0,420,6,414,197,217,inf,0.014285714285714285,0.9857142857142858,0.46904761904761905,0.5166666666666667
046I,04,6I,0,479,9,470,233,237,inf,0.018789144050104383,0.9812108559498957,0.48643006263048016,0.49478079331941544
046J,04,6J,0,584,8,576,289,287,inf,0.0136986301369863,0.9863013698630136,0.4948630136986301,0.4914383561643836
046K,04,6K,0,430,7,423,205,218,inf,0.01627906976744186,0.9837209302325581,0.47674418604651164,0.5069767441860465
046L,04,6L,0,409,3,406,210,196,inf,0.007334963325183374,0.9926650366748166,0.5134474327628362,0.4792176039119804
046M,04,6M,0,463,7,456,250,206,inf,0.01511879049676026,0.9848812095032398,0.5399568034557235,0.4449244060475162
046N,04,6N,0,510,9,501,294,207,inf,0.01764705882352941,0.9823529411764705,0.5764705882352941,0.40588235294117647
046P,04,6P,0,441,1,440,243,197,inf,0.0022675736961451248,0.9977324263038548,0.5510204081632653,0.4467120181405896
046Q,04,6Q,0,363,10,353,198,155,inf,0.027548209366391185,0.9724517906336089,0.5454545454545454,0.42699724517906334
046R,04,6R,0,528,6,522,300,222,inf,0.011363636363636364,0.9886363636363636,0.5681818181818182,0.42045454545454547
046S,04,6S,0,469,8,461,254,207,inf,0.017057569296375266,0.9829424307036247,0.5415778251599147,0.44136460554371004
046T,04,6T,0,505,10,495,277,218,inf,0.019801980198019802,0.9801980198019802,0.5485148514851486,0.4316831683168317
046U,04,6U,0,455,5,450,237,213,inf,0.01098901098901099,0.989010989010989,0.5208791208791209,0.46813186813186813
046V,04,6V,0,471,3,468,282,186,inf,0.006369426751592357,0.9936305732484076,0.5987261146496815,0.39490445859872614
046W,04,6W,0,415,7,408,213,195,inf,0.016867469879518072,0.983132530120482,0.5132530120481927,0.46987951807228917
046X,04,6X,0,371,2,369,234,135,inf,0.005390835579514825,0.9946091644204852,0.6307277628032345,0.3638814016172507
046Y,04,6Y,0,280,1,279,170,109,inf,0.0035714285714285713,0.9964285714285714,0.6071428571428571,0.3892857142857143
047A,04,7A,0,500,10,490,285,205,inf,0.02,0.98,0.57,0.41
047B,04,7B,0,409,5,404,232,172,inf,0.012224938875305624,0.9877750611246944,0.5672371638141809,0.42053789731051344
047C,04,7C,0,386,4,382,248,134,inf,0.010362694300518135,0.9896373056994818,0.6424870466321243,0.3471502590673575
047D,04,7D,0,448,10,438,236,202,inf,0.022321428571428572,0.9776785714285714,0.5267857142857143,0.45089285714285715
047E,04,7E,0,479,0,479,269,210,inf,0.0,1.0,0.5615866388308977,0.4384133611691023
047F,04,7F,0,456,4,452,229,223,inf,0.008771929824561403,0.9912280701754386,0.5021929824561403,0.48903508771929827
047G,04,7G,0,353,8,345,234,111,inf,0.0226628895184136,0.9773371104815864,0.6628895184135978,0.31444759206798867
047H,04,7H,0,434,3,431,223,208,inf,0.0069124423963133645,0.9930875576036866,0.5138248847926268,0.4792626728110599
047I,04,7I,0,438,1,437,212,225,inf,0.00228310502283105,0.997716894977169,0.4840182648401826,0.5136986301369864
047J,04,7J,0,599,2,597,276,321,inf,0.00333889816360601,0.996661101836394,0.4607679465776294,0.5358931552587646
047K,04,7K,0,565,7,558,280,278,inf,0.012389380530973451,0.9876106194690265,0.49557522123893805,0.4920353982300885
047L,04,7L,0,530,4,526,261,265,inf,0.007547169811320755,0.9924528301886792,0.49245283018867925,0.5
047M,04,7M,0,490,6,484,193,291,inf,0.012244897959183673,0.9877551020408163,0.39387755102040817,0.5938775510204082
047N,04,7N,0,489,4,485,285,200,inf,0.0081799591002045,0.9918200408997955,0.5828220858895705,0.40899795501022496
047P,04,7P,0,461,3,458,203,255,inf,0.006507592190889371,0.9934924078091106,0.4403470715835141,0.5531453362255966
047Q,04,7Q,0,527,1,526,346,180,inf,0.0018975332068311196,0.9981024667931688,0.6565464895635673,0.3415559772296015
047R,04,7R,0,486,9,477,229,248,inf,0.018518518518518517,0.9814814814814815,0.4711934156378601,0.5102880658436214
047S,04,7S,0,746,0,746,297,449,inf,0.0,1.0,0.39812332439678283,0.6018766756032171
047T,04,7T,0,526,8,518,192,326,inf,0.015209125475285171,0.9847908745247148,0.3650190114068441,0.6197718631178707
047U,04,7U,0,457,3,454,215,239,inf,0.006564551422319475,0.9934354485776805,0.47045951859956237,0.5229759299781181
047V,04,7V,0,484,9,475,218,257,inf,0.01859504132231405,0.981404958677686,0.45041322314049587,0.53099173553719
047W,04,7W,0,672,4,668,287,381,inf,0.005952380952380952,0.9940476190476191,0.4270833333333333,0.5669642857142857
047X,04,7X,0,707,3,704,242,462,inf,0.004243281471004243,0.9957567185289957,0.3422913719943423,0.6534653465346535
047Y,04,7Y,0,377,1,376,208,168,inf,0.002652519893899204,0.9973474801061007,0.5517241379310345,0.44562334217506633
047Z,04,7Z,0,472,3,469,218,251,inf,0.006355932203389831,0.9936440677966102,0.461864406779661,0.5317796610169492
048A,04,8A,0,438,6,432,245,187,inf,0.0136986301369863,0.9863013698630136,0.5593607305936074,0.4269406392694064
048B,04,8B,0,590,17,573,316,257,inf,0.0288135593220339,0.9711864406779661,0.535593220338983,0.43559322033898307
048C,04,8C,0,435,21,414,243,171,inf,0.04827586206896552,0.9517241379310345,0.5586206896551724,0.3931034482758621
048D,04,8D,0,347,4,343,194,149,inf,0.011527377521613832,0.9884726224783862,0.5590778097982709,0.42939481268011526
048E,04,8E,0,324,4,320,197,123,inf,0.012345679012345678,0.9876543209876543,0.6080246913580247,0.37962962962962965
048F,04,8F,0,522,6,516,292,224,inf,0.011494252873563218,0.9885057471264368,0.5593869731800766,0.42911877394636017
048G,04,8G,0,454,4,450,296,154,inf,0.00881057268722467,0.9911894273127754,0.6519823788546255,0.3392070484581498
05101,05,101,785,291,20,271,167,104,0.37070063694267513,0.06872852233676977,0.9312714776632303,0.5738831615120275,0.35738831615120276
05102,05,102,1029,399,16,383,195,188,0.3877551020408163,0.040100250626566414,0.9598997493734336,0.48872180451127817,0.47117794486215536
05103,05,103,1048,460,15,445,196,249,0.4389312977099237,0.03260869565217391,0.967391304347826,0.4260869565217391,0.5413043478260869
05104,05,104,963,389,19,370,219,151,0.4039460020768432,0.04884318766066838,0.9511568123393316,0.5629820051413882,0.38817480719794345
05105,05,105,1030,442,18,424,166,258,0.429126213592233,0.04072398190045249,0.9592760180995475,0.3755656108597285,0.583710407239819
05106,05,106,1101,395,16,379,170,209,0.35876475930971846,0.04050632911392405,0.959493670886076,0.43037974683544306,0.529113924050633
05107,05,107,828,351,29,322,184,138,0.42391304347826086,0.08262108262108261,0.9173789173789174,0.5242165242165242,0.39316239316239315
05108,05,108,997,298,19,279,169,110,0.29889669007021064,0.06375838926174497,0.9362416107382551,0.5671140939597316,0.3691275167785235
05109,05,109,669,78,2,76,28,48,0.11659192825112108,0.02564102564102564,0.9743589743589743,0.358974358974359,0.6153846153846154
05110,05,110,865,330,13,317,176,141,0.3815028901734104,0.03939393939393939,0.9606060606060606,0.5333333333333333,0.42727272727272725
05111,05,111,1223,490,11,479,248,231,0.40065412919051513,0.022448979591836733,0.9775510204081632,0.5061224489795918,0.4714285714285714
05112,05,112,1042,444,11,433,232,201,0.42610364683301344,0.024774774774774775,0.9752252252252253,0.5225225225225225,0.4527027027027027
05113,05,113,992,404,14,390,182,208,0.40725806451612906,0.034653465346534656,0.9653465346534653,0.4504950495049505,0.5148514851485149
05114,05,114,889,364,13,351,181,170,0.4094488188976378,0.03571428571428571,0.9642857142857143,0.49725274725274726,0.46703296703296704
05115,05,115,1013,465,27,438,296,142,0.4590325765054294,0.05806451612903226,0.9419354838709677,0.6365591397849463,0.3053763440860215
05116,05,116,775,324,17,307,182,125,0.4180645161290323,0.05246913580246913,0.9475308641975309,0.5617283950617284,0.38580246913580246
05117,05,117,973,414,23,391,304,87,0.42548818088386436,0.05555555555555555,0.9444444444444444,0.7342995169082126,0.21014492753623187
05118,05,118,1195,382,12,370,238,132,0.3196652719665272,0.031413612565445025,0.9685863874345549,0.6230366492146597,0.34554973821989526
05119,05,119,1226,460,14,446,263,183,0.37520391517128876,0.030434782608695653,0.9695652173913043,0.5717391304347826,0.3978260869565217
05120,05,120,1243,492,29,463,280,183,0.39581657280772325,0.05894308943089431,0.9410569105691057,0.5691056910569106,0.3719512195121951
05121,05,121,1084,509,47,462,272,190,0.46955719557195574,0.09233791748526522,0.9076620825147348,0.5343811394891945,0.37328094302554027
05122,05,122,903,281,17,264,175,89,0.31118493909191586,0.060498220640569395,0.9395017793594306,0.6227758007117438,0.3167259786476868
05123,05,123,741,301,14,287,172,115,0.40620782726045884,0.046511627906976744,0.9534883720930233,0.5714285714285714,0.38205980066445183
05124,05,124,1321,547,15,532,355,177,0.4140802422407267,0.027422303473491772,0.9725776965265083,0.6489945155393053,0.3235831809872029
05125,05,125,1024,408,26,382,298,84,0.3984375,0.06372549019607843,0.9362745098039216,0.7303921568627451,0.20588235294117646
05126,05,126,1161,412,3,409,287,122,0.35486649440137813,0.007281553398058253,0.9927184466019418,0.6966019417475728,0.2961165048543689
05127,05,127,920,384,25,359,260,99,0.41739130434782606,0.06510416666666667,0.9348958333333334,0.6770833333333334,0.2578125
05128,05,128,879,209,15,194,131,63,0.23777019340159272,0.07177033492822966,0.9282296650717703,0.6267942583732058,0.3014354066985646
05129,05,129,996,439,21,418,297,121,0.4407630522088353,0.04783599088838269,0.9521640091116174,0.6765375854214123,0.275626423690205
05130,05,130,1060,456,34,422,264,158,0.43018867924528303,0.07456140350877193,0.9254385964912281,0.5789473684210527,0.34649122807017546
05131,05,131,418,196,10,186,127,59,0.4688995215311005,0.05102040816326531,0.9489795918367347,0.6479591836734694,0.3010204081632653
05132,05,132,1195,482,31,451,308,143,0.40334728033472805,0.06431535269709543,0.9356846473029046,0.6390041493775933,0.2966804979253112
05133,05,133,1203,394,18,376,228,148,0.32751454696591853,0.04568527918781726,0.9543147208121827,0.5786802030456852,0.3756345177664975
05134,05,134,1131,419,17,402,251,151,0.3704686118479222,0.0405727923627685,0.9594272076372315,0.5990453460620525,0.360381861575179
05201,05,201,1230,477,31,446,248,198,0.3878048780487805,0.0649895178197065,0.9350104821802935,0.519916142557652,0.41509433962264153
05202,05,202,1154,411,38,373,248,125,0.3561525129982669,0.09245742092457421,0.9075425790754258,0.6034063260340633,0.30413625304136255
05203,05,203,1180,487,24,463,314,149,0.41271186440677965,0.049281314168377825,0.9507186858316222,0.6447638603696099,0.3059548254620123
05204,05,204,909,338,7,331,231,100,0.3718371837183718,0.020710059171597635,0.9792899408284024,0.6834319526627219,0.2958579881656805
05205,05,205,1007,342,15,327,208,119,0.33962264150943394,0.043859649122807015,0.956140350877193,0.6081871345029239,0.347953216374269
05206,05,206,677,260,17,243,156,87,0.38404726735598227,0.06538461538461539,0.9346153846153846,0.6,0.3346153846153846
05207,05,207,1027,327,36,291,202,89,0.3184031158714703,0.11009174311926606,0.8899082568807339,0.617737003058104,0.27217125382262997
05208,05,208,1057,395,14,381,266,115,0.3736991485335856,0.035443037974683546,0.9645569620253165,0.6734177215189874,0.2911392405063291
05209,05,209,988,394,17,377,207,170,0.39878542510121456,0.04314720812182741,0.9568527918781726,0.5253807106598984,0.43147208121827413
05210,05,210,1096,426,23,403,275,128,0.3886861313868613,0.0539906103286385,0.9460093896713615,0.6455399061032864,0.3004694835680751
05211,05,211,807,366,11,355,230,125,0.45353159851301117,0.030054644808743168,0.9699453551912568,0.6284153005464481,0.34153005464480873
05212,05,212,862,378,31,347,216,131,0.4385150812064965,0.082010582010582,0.917989417989418,0.5714285714285714,0.34656084656084657
05213,05,213,996,473,21,452,196,256,0.4748995983935743,0.04439746300211417,0.9556025369978859,0.4143763213530655,0.5412262156448203
05214,05,214,1151,418,24,394,256,138,0.3631624674196351,0.05741626794258373,0.9425837320574163,0.6124401913875598,0.33014354066985646
05215,05,215,1018,357,13,344,226,118,0.3506876227897839,0.036414565826330535,0.9635854341736695,0.6330532212885154,0.33053221288515405
05216,05,216,948,354,12,342,213,129,0.37341772151898733,0.03389830508474576,0.9661016949152542,0.6016949152542372,0.3644067796610169
05217,05,217,739,301,15,286,176,110,0.40730717185385656,0.04983388704318937,0.9501661129568106,0.584717607973422,0.3654485049833887
05218,05,218,939,447,23,424,254,170,0.476038338658147,0.05145413870246085,0.9485458612975392,0.5682326621923938,0.38031319910514544
05219,05,219,1215,515,26,489,301,188,0.42386831275720166,0.05048543689320388,0.9495145631067962,0.5844660194174758,0.3650485436893204
05220,05,220,994,392,30,362,221,141,0.39436619718309857,0.07653061224489796,0.923469387755102,0.5637755102040817,0.3596938775510204
05221,05,221,824,369,12,357,231,126,0.44781553398058255,0.032520325203252036,0.967479674796748,0.6260162601626016,0.34146341463414637
05222,05,222,878,359,17,342,205,137,0.40888382687927105,0.04735376044568245,0.9526462395543176,0.5710306406685237,0.3816155988857939
05223,05,223,1064,428,21,407,269,138,0.40225563909774437,0.04906542056074766,0.9509345794392523,0.6285046728971962,0.32242990654205606
05224,05,224,897,369,7,362,241,121,0.411371237458194,0.018970189701897018,0.981029810298103,0.6531165311653117,0.32791327913279134
05225,05,225,926,410,22,388,271,117,0.4427645788336933,0.05365853658536585,0.9463414634146341,0.6609756097560976,0.28536585365853656
05226,05,226,1005,393,23,370,213,157,0.39104477611940297,0.058524173027989825,0.9414758269720102,0.5419847328244275,0.3994910941475827
05227,05,227,1259,415,18,397,298,99,0.329626687847498,0.043373493975903614,0.9566265060240964,0.7180722891566265,0.2385542168674699
05228,05,228,722,285,0,285,128,157,0.39473684210526316,0.0,1.0,0.44912280701754387,0.5508771929824562
05229,05,229,981,314,17,297,200,97,0.3200815494393476,0.054140127388535034,0.945859872611465,0.6369426751592356,0.3089171974522293
05230,05,230,652,289,7,282,196,86,0.4432515337423313,0.02422145328719723,0.9757785467128027,0.6782006920415224,0.2975778546712803
05301,05,301,1183,497,39,458,267,191,0.42011834319526625,0.07847082494969819,0.9215291750503019,0.5372233400402414,0.3843058350100604
05302,05,302,921,374,18,356,263,93,0.40608034744842564,0.0481283422459893,0.9518716577540107,0.7032085561497327,0.24866310160427807
05303,05,303,935,376,14,362,190,172,0.4021390374331551,0.03723404255319149,0.9627659574468085,0.5053191489361702,0.4574468085106383
05304,05,304,994,438,26,412,185,227,0.44064386317907445,0.0593607305936073,0.9406392694063926,0.4223744292237443,0.5182648401826484
05305,05,305,1188,506,18,488,343,145,0.42592592592592593,0.03557312252964427,0.9644268774703557,0.6778656126482213,0.2865612648221344
05306,05,306,813,269,14,255,150,105,0.33087330873308735,0.05204460966542751,0.9479553903345725,0.5576208178438662,0.3903345724907063
05307,05,307,1251,418,21,397,245,152,0.33413269384492406,0.050239234449760764,0.9497607655502392,0.5861244019138756,0.36363636363636365
05308,05,308,1182,511,34,477,303,174,0.4323181049069374,0.06653620352250489,0.9334637964774951,0.5929549902152642,0.3405088062622309
05309,05,309,1298,418,21,397,274,123,0.3220338983050847,0.050239234449760764,0.9497607655502392,0.6555023923444976,0.2942583732057416
05310,05,310,1162,428,19,409,260,149,0.3683304647160069,0.04439252336448598,0.955607476635514,0.6074766355140186,0.34813084112149534
05311,05,311,1162,490,10,480,323,157,0.42168674698795183,0.02040816326530612,0.9795918367346939,0.6591836734693878,0.32040816326530613
05312,05,312,915,378,28,350,192,158,0.4131147540983607,0.07407407407407407,0.9259259259259259,0.5079365079365079,0.41798941798941797
05313,05,313,1319,548,27,521,346,175,0.41546626231993933,0.04927007299270073,0.9507299270072993,0.6313868613138686,0.3193430656934307
05314,05,314,1162,504,17,487,291,196,0.43373493975903615,0.03373015873015873,0.9662698412698413,0.5773809523809523,0.3888888888888889
05315,05,315,1126,491,12,479,248,231,0.436056838365897,0.024439918533604887,0.9755600814663951,0.505091649694501,0.47046843177189407
05316,05,316,1307,522,31,491,306,185,0.39938791124713086,0.05938697318007663,0.9406130268199234,0.5862068965517241,0.3544061302681992
05317,05,317,1071,416,21,395,265,130,0.388422035480859,0.05048076923076923,0.9495192307692307,0.6370192307692307,0.3125
05318,05,318,1186,445,20,425,263,162,0.3752107925801012,0.0449438202247191,0.9550561797752809,0.5910112359550562,0.36404494382022473
05319,05,319,646,248,9,239,179,60,0.38390092879256965,0.036290322580645164,0.9637096774193549,0.7217741935483871,0.24193548387096775
05320,05,320,916,368,19,349,235,114,0.4017467248908297,0.051630434782608696,0.9483695652173914,0.6385869565217391,0.30978260869565216
05321,05,321,1139,424,19,405,293,112,0.3722563652326602,0.04481132075471698,0.9551886792452831,0.6910377358490566,0.2641509433962264
05322,05,322,1111,421,17,404,240,164,0.3789378937893789,0.040380047505938245,0.9596199524940617,0.5700712589073634,0.38954869358669836
05323,05,323,757,231,2,229,154,75,0.3051519154557464,0.008658008658008658,0.9913419913419913,0.6666666666666666,0.3246753246753247
05324,05,324,1118,431,26,405,268,137,0.3855098389982111,0.060324825986078884,0.9396751740139211,0.6218097447795824,0.31786542923433875
05325,05,325,1233,537,15,522,327,195,0.43552311435523117,0.027932960893854747,0.9720670391061452,0.6089385474860335,0.36312849162011174
05326,05,326,1068,362,17,345,215,130,0.3389513108614232,0.04696132596685083,0.9530386740331491,0.5939226519337016,0.35911602209944754
05327,05,327,1068,461,18,443,280,163,0.43164794007490637,0.039045553145336226,0.9609544468546638,0.6073752711496746,0.35357917570498915
05328,05,328,1202,495,21,474,278,196,0.4118136439267887,0.04242424242424243,0.9575757575757575,0.5616161616161616,0.39595959595959596
05329,05,329,943,354,9,345,239,106,0.3753976670201485,0.025423728813559324,0.9745762711864406,0.6751412429378532,0.2994350282485876
05330,05,330,420,166,8,158,95,63,0.3952380952380952,0.04819277108433735,0.9518072289156626,0.572289156626506,0.3795180722891566
05331,05,331,496,206,6,200,98,102,0.4153225806451613,0.02912621359223301,0.970873786407767,0.47572815533980584,0.49514563106796117
05332,05,332,0,0,0,0,0,0,0.0,0.0,0.0,0.0,0.0
05401,05,401,1352,490,5,485,222,263,0.3624260355029586,0.01020408163265306,0.9897959183673469,0.4530612244897959,0.536734693877551
05402,05,402,698,263,7,256,122,134,0.37679083094555876,0.026615969581749048,0.973384030418251,0.46387832699619774,0.5095057034220533
05403,05,403,944,387,22,365,157,208,0.4099576271186441,0.056847545219638244,0.9431524547803618,0.40568475452196384,0.537467700258398
05404,05,404,1047,472,14,458,206,252,0.45081184336198665,0.029661016949152543,0.9703389830508474,0.4364406779661017,0.5338983050847458
05405,05,405,1072,450,30,420,191,229,0.4197761194029851,0.06666666666666667,0.9333333333333333,0.42444444444444446,0.5088888888888888
05406,05,406,1032,378,22,356,201,155,0.36627906976744184,0.0582010582010582,0.9417989417989417,0.5317460317460317,0.41005291005291006
05407,05,407,998,410,10,400,147,253,0.41082164328657317,0.024390243902439025,0.975609756097561,0.35853658536585364,0.6170731707317073
05408,05,408,836,299,20,279,202,77,0.3576555023923445,0.06688963210702341,0.9331103678929766,0.6755852842809364,0.25752508361204013
05409,05,409,1093,500,14,486,235,251,0.45745654162854527,0.028,0.972,0.47,0.502
05410,05,410,1328,483,19,464,280,184,0.36370481927710846,0.039337474120082816,0.9606625258799172,0.5797101449275363,0.38095238095238093
05411,05,411,1044,448,20,428,284,144,0.42911877394636017,0.044642857142857144,0.9553571428571429,0.6339285714285714,0.32142857142857145
05412,05,412,1325,534,63,471,300,171,0.4030188679245283,0.11797752808988764,0.8820224719101124,0.5617977528089888,0.3202247191011236
05413,05,413,1383,503,29,474,254,220,0.36370209689081706,0.05765407554671968,0.9423459244532804,0.5049701789264414,0.43737574552683894
05414,05,414,773,323,21,302,212,90,0.4178525226390686,0.06501547987616099,0.934984520123839,0.6563467492260062,0.2786377708978328
05415,05,415,1273,471,28,443,283,160,0.3699921445404556,0.059447983014861996,0.940552016985138,0.6008492569002123,0.33970276008492567
05416,05,416,1210,406,10,396,165,231,0.33553719008264465,0.024630541871921183,0.9753694581280788,0.4064039408866995,0.5689655172413793
05417,05,417,926,413,9,404,179,225,0.44600431965442766,0.021791767554479417,0.9782082324455206,0.43341404358353514,0.5447941888619855
05418,05,418,724,231,6,225,133,92,0.319060773480663,0.025974025974025976,0.974025974025974,0.5757575757575758,0.39826839826839827
05419,05,419,1083,476,11,465,205,260,0.43951985226223456,0.023109243697478993,0.976890756302521,0.43067226890756305,0.5462184873949579
05420,05,420,1071,414,15,399,160,239,0.3865546218487395,0.036231884057971016,0.9637681159420289,0.3864734299516908,0.5772946859903382
05421,05,421,1224,517,43,474,336,138,0.4223856209150327,0.08317214700193423,0.9168278529980658,0.6499032882011605,0.26692456479690524
05422,05,422,1005,363,26,337,227,110,0.3611940298507463,0.07162534435261708,0.928374655647383,0.6253443526170799,0.30303030303030304
05423,05,423,839,312,22,290,156,134,0.37187127532777114,0.07051282051282051,0.9294871794871795,0.5,0.42948717948717946
05424,05,424,1218,478,20,458,245,213,0.3924466338259442,0.04184100418410042,0.9581589958158996,0.5125523012552301,0.4456066945606695
05425,05,425,966,382,13,369,168,201,0.39544513457556935,0.034031413612565446,0.9659685863874345,0.4397905759162304,0.5261780104712042
05426,05,426,1139,567,30,537,288,249,0.4978050921861282,0.05291005291005291,0.9470899470899471,0.5079365079365079,0.43915343915343913
05427,05,427,772,318,24,294,193,101,0.4119170984455959,0.07547169811320754,0.9245283018867925,0.6069182389937107,0.31761006289308175
05428,05,428,1092,518,21,497,252,245,0.47435897435897434,0.04054054054054054,0.9594594594594594,0.4864864864864865,0.47297297297297297
05429,05,429,943,411,18,393,183,210,0.43584305408271473,0.043795620437956206,0.9562043795620438,0.44525547445255476,0.5109489051094891
05430,05,430,1012,468,23,445,224,221,0.4624505928853755,0.049145299145299144,0.9508547008547008,0.47863247863247865,0.4722222222222222
05501,05,501,1013,387,14,373,226,147,0.3820335636722606,0.03617571059431524,0.9638242894056848,0.5839793281653747,0.3798449612403101
05502,05,502,1193,525,29,496,281,215,0.44006705783738476,0.05523809523809524,0.9447619047619048,0.5352380952380953,0.4095238095238095
05503,05,503,814,368,22,346,105,241,0.4520884520884521,0.059782608695652176,0.9402173913043478,0.28532608695652173,0.654891304347826
05504,05,504,919,357,9,348,223,125,0.38846572361262244,0.025210084033613446,0.9747899159663865,0.6246498599439776,0.35014005602240894
05505,05,505,1129,373,9,364,151,213,0.3303808680248007,0.024128686327077747,0.9758713136729222,0.40482573726541554,0.5710455764075067
05506,05,506,1057,494,17,477,201,276,0.467360454115421,0.03441295546558704,0.9655870445344129,0.4068825910931174,0.5587044534412956
05507,05,507,984,469,13,456,164,292,0.4766260162601626,0.02771855010660981,0.9722814498933902,0.34968017057569295,0.6226012793176973
05508,05,508,954,405,10,395,165,230,0.42452830188679247,0.024691358024691357,0.9753086419753086,0.4074074074074074,0.5679012345679012
05509,05,509,703,255,5,250,83,167,0.3627311522048364,0.0196078431372549,0.9803921568627451,0.3254901960784314,0.6549019607843137
05510,05,510,961,409,8,401,143,258,0.4255983350676379,0.019559902200488997,0.980440097799511,0.34963325183374083,0.6308068459657702
05511,05,511,905,370,13,357,121,236,0.4088397790055249,0.03513513513513514,0.9648648648648649,0.327027027027027,0.6378378378378379
05512,05,512,884,325,5,320,102,218,0.36764705882352944,0.015384615384615385,0.9846153846153847,0.31384615384615383,0.6707692307692308
05513,05,513,954,474,13,461,163,298,0.4968553459119497,0.027426160337552744,0.9725738396624473,0.3438818565400844,0.6286919831223629
05514,05,514,1010,326,20,306,206,100,0.3227722772277228,0.06134969325153374,0.9386503067484663,0.6319018404907976,0.3067484662576687
05515,05,515,1093,412,11,401,190,211,0.37694419030192133,0.02669902912621359,0.9733009708737864,0.46116504854368934,0.5121359223300971
05516,05,516,1200,489,20,469,208,261,0.4075,0.0408997955010225,0.9591002044989775,0.42535787321063395,0.5337423312883436
05517,05,517,1019,436,38,398,233,165,0.4278704612365064,0.0871559633027523,0.9128440366972477,0.5344036697247706,0.37844036697247707
05518,05,518,931,360,13,347,90,257,0.3866809881847476,0.03611111111111111,0.9638888888888889,0.25,0.7138888888888889
05519,05,519,987,385,34,351,174,177,0.3900709219858156,0.08831168831168831,0.9116883116883117,0.45194805194805193,0.4597402597402597
05520,05,520,1139,433,19,414,235,179,0.3801580333625988,0.04387990762124711,0.9561200923787528,0.5427251732101617,0.4133949191685912
05521,05,521,1131,405,18,387,245,142,0.35809018567639256,0.044444444444444446,0.9555555555555556,0.6049382716049383,0.3506172839506173
05522,05,522,957,402,12,390,176,214,0.4200626959247649,0.029850746268656716,0.9701492537313433,0.43781094527363185,0.5323383084577115
05523,05,523,1004,402,10,392,135,257,0.40039840637450197,0.024875621890547265,0.9751243781094527,0.3358208955223881,0.6393034825870647
05524,05,524,990,418,13,405,159,246,0.4222222222222222,0.03110047846889952,0.9688995215311005,0.3803827751196172,0.5885167464114832
05525,05,525,770,353,15,338,117,221,0.4584415584415584,0.042492917847025496,0.9575070821529745,0.3314447592067989,0.6260623229461756
05526,05,526,1148,498,36,462,190,272,0.4337979094076655,0.07228915662650602,0.927710843373494,0.3815261044176707,0.5461847389558233
05527,05,527,1419,429,29,400,307,93,0.3023255813953488,0.0675990675990676,0.9324009324009324,0.7156177156177156,0.21678321678321677
05528,05,528,905,415,12,403,152,251,0.4585635359116022,0.02891566265060241,0.9710843373493976,0.36626506024096384,0.6048192771084338
05529,05,529,925,363,7,356,111,245,0.3924324324324324,0.01928374655647383,0.9807162534435262,0.30578512396694213,0.6749311294765841
05530,05,530,971,406,33,373,255,118,0.4181256436663234,0.0812807881773399,0.9187192118226601,0.6280788177339901,0.29064039408866993
05531,05,531,785,364,6,358,205,153,0.4636942675159236,0.016483516483516484,0.9835164835164835,0.5631868131868132,0.42032967032967034
05532,05,532,1004,531,15,516,169,347,0.5288844621513944,0.02824858757062147,0.9717514124293786,0.3182674199623352,0.6534839924670434
051A,05,1A,0,625,24,601,340,261,inf,0.0384,0.9616,0.544,0.4176
051B,05,1B,0,584,8,576,317,259,inf,0.0136986301369863,0.9863013698630136,0.5428082191780822,0.4434931506849315
051C,05,1C,0,642,16,626,349,277,inf,0.024922118380062305,0.9750778816199377,0.543613707165109,0.43146417445482865
051D,05,1D,0,245,4,241,128,113,inf,0.0163265306122449,0.9836734693877551,0.5224489795918368,0.46122448979591835
051E,05,1E,0,614,18,596,286,310,inf,0.029315960912052116,0.9706840390879479,0.46579804560260585,0.504885993485342
051F,05,1F,0,239,7,232,127,105,inf,0.029288702928870293,0.9707112970711297,0.5313807531380753,0.4393305439330544
051G,05,1G,0,762,20,742,437,305,inf,0.026246719160104987,0.973753280839895,0.573490813648294,0.400262467191601
051H,05,1H,0,342,6,336,213,123,inf,0.017543859649122806,0.9824561403508771,0.6228070175438597,0.35964912280701755
051J,05,1J,0,607,12,595,300,295,inf,0.019769357495881382,0.9802306425041186,0.4942339373970346,0.48599670510708404
051K,05,1K,0,375,7,368,191,177,inf,0.018666666666666668,0.9813333333333333,0.5093333333333333,0.472
051L,05,1L,0,742,17,725,363,362,inf,0.022911051212938006,0.977088948787062,0.48921832884097033,0.48787061994609165
051M,05,1M,0,657,12,645,280,365,inf,0.0182648401826484,0.9817351598173516,0.426179604261796,0.5555555555555556
051N,05,1N,0,646,16,630,274,356,inf,0.02476780185758514,0.9752321981424149,0.4241486068111455,0.5510835913312694
051P,05,1P,0,603,11,592,400,192,inf,0.01824212271973466,0.9817578772802653,0.6633499170812603,0.31840796019900497
051Q,05,1Q,0,565,16,549,351,198,inf,0.02831858407079646,0.9716814159292035,0.6212389380530974,0.3504424778761062
051R,05,1R,0,481,9,472,279,193,inf,0.018711018711018712,0.9812889812889813,0.58004158004158,0.40124740124740127
051S,05,1S,0,526,8,518,323,195,inf,0.015209125475285171,0.9847908745247148,0.6140684410646388,0.37072243346007605
052A,05,2A,0,454,14,440,240,200,inf,0.030837004405286344,0.9691629955947136,0.5286343612334802,0.44052863436123346
052B,05,2B,0,352,3,349,215,134,inf,0.008522727272727272,0.9914772727272727,0.6107954545454546,0.3806818181818182
052C,05,2C,0,507,15,492,317,175,inf,0.029585798816568046,0.9704142011834319,0.6252465483234714,0.34516765285996054
052D,05,2D,0,807,18,789,501,288,inf,0.022304832713754646,0.9776951672862454,0.620817843866171,0.35687732342007433
052E,05,2E,0,546,11,535,303,232,inf,0.020146520146520148,0.9798534798534798,0.554945054945055,0.4249084249084249
052F,05,2F,0,699,21,678,426,252,inf,0.030042918454935622,0.9699570815450643,0.6094420600858369,0.3605150214592275
052G,05,2G,0,279,8,271,180,91,inf,0.02867383512544803,0.9713261648745519,0.6451612903225806,0.32616487455197135
052H,05,2H,0,233,15,218,146,72,inf,0.06437768240343347,0.9356223175965666,0.6266094420600858,0.3090128755364807
052J,05,2J,0,464,5,459,293,166,inf,0.010775862068965518,0.9892241379310345,0.6314655172413793,0.3577586206896552
052K,05,2K,0,210,6,204,119,85,inf,0.02857142857142857,0.9714285714285714,0.5666666666666667,0.40476190476190477
052L,05,2L,0,653,10,643,328,315,inf,0.015313935681470138,0.9846860643185299,0.5022970903522205,0.48238897396630936
052M,05,2M,0,683,14,669,393,276,inf,0.020497803806734993,0.9795021961932651,0.575402635431918,0.404099560761347
052N,05,2N,0,321,6,315,166,149,inf,0.018691588785046728,0.9813084112149533,0.5171339563862928,0.46417445482866043
052P,05,2P,0,168,2,166,95,71,inf,0.011904761904761904,0.9880952380952381,0.5654761904761905,0.4226190476190476
052Q,05,2Q,0,422,14,408,207,201,inf,0.03317535545023697,0.966824644549763,0.490521327014218,0.476303317535545
052R,05,2R,0,454,7,447,263,184,inf,0.015418502202643172,0.9845814977973568,0.579295154185022,0.4052863436123348
053A,05,3A,0,742,21,721,453,268,inf,0.02830188679245283,0.9716981132075472,0.610512129380054,0.3611859838274933
053B,05,3B,0,709,15,694,415,279,inf,0.021156558533145273,0.9788434414668548,0.5853314527503526,0.3935119887165021
053C,05,3C,0,653,9,644,409,235,inf,0.013782542113323124,0.9862174578866769,0.6263399693721287,0.35987748851454826
053D,05,3D,0,609,16,593,330,263,inf,0.026272577996715927,0.9737274220032841,0.541871921182266,0.4318555008210181
053E,05,3E,0,575,0,575,342,233,inf,0.0,1.0,0.5947826086956521,0.4052173913043478
053F,05,3F,0,544,10,534,300,234,inf,0.01838235294117647,0.9816176470588235,0.5514705882352942,0.43014705882352944
053G,05,3G,0,339,9,330,187,143,inf,0.02654867256637168,0.9734513274336283,0.551622418879056,0.4218289085545723
053H,05,3H,0,582,10,572,371,201,inf,0.01718213058419244,0.9828178694158075,0.6374570446735395,0.34536082474226804
053J,05,3J,0,594,15,579,346,233,inf,0.025252525252525252,0.9747474747474747,0.5824915824915825,0.39225589225589225
053K,05,3K,0,535,13,522,286,236,inf,0.024299065420560748,0.9757009345794393,0.5345794392523364,0.4411214953271028
053L,05,3L,0,249,4,245,153,92,inf,0.01606425702811245,0.9839357429718876,0.6144578313253012,0.36947791164658633
053M,05,3M,0,194,2,192,112,80,inf,0.010309278350515464,0.9896907216494846,0.5773195876288659,0.41237113402061853
053N,05,3N,0,316,5,311,190,121,inf,0.015822784810126583,0.9841772151898734,0.6012658227848101,0.3829113924050633
053P,05,3P,0,206,9,197,115,82,inf,0.043689320388349516,0.9563106796116505,0.558252427184466,0.39805825242718446
053Q,05,3Q,0,450,5,445,270,175,inf,0.011111111111111112,0.9888888888888889,0.6,0.3888888888888889
053R,05,3R,0,671,10,661,373,288,inf,0.014903129657228018,0.9850968703427719,0.555886736214605,0.42921013412816694
053S,05,3S,0,337,2,335,203,132,inf,0.005934718100890208,0.9940652818991098,0.6023738872403561,0.3916913946587537
053T,05,3T,0,120,0,120,51,69,inf,0.0,1.0,0.425,0.575
053U,05,3U,0,117,1,116,76,40,inf,0.008547008547008548,0.9914529914529915,0.6495726495726496,0.3418803418803419
053V,05,3V,0,237,1,236,143,93,inf,0.004219409282700422,0.9957805907172996,0.6033755274261603,0.3924050632911392
054A,05,4A,0,404,3,401,216,185,inf,0.007425742574257425,0.9925742574257426,0.5346534653465347,0.45792079207920794
054B,05,4B,0,678,9,669,317,352,inf,0.01327433628318584,0.9867256637168141,0.46755162241887904,0.5191740412979351
054C,05,4C,0,859,24,835,353,482,inf,0.027939464493597205,0.9720605355064028,0.4109429569266589,0.5611175785797439
054D,05,4D,0,647,10,637,294,343,inf,0.015455950540958269,0.9845440494590417,0.45440494590417313,0.5301391035548686
054E,05,4E,0,417,9,408,218,190,inf,0.02158273381294964,0.9784172661870504,0.5227817745803357,0.4556354916067146
054F,05,4F,0,425,7,418,193,225,inf,0.01647058823529412,0.9835294117647059,0.4541176470588235,0.5294117647058824
054G,05,4G,0,509,5,504,324,180,inf,0.009823182711198428,0.9901768172888016,0.6365422396856582,0.35363457760314343
054H,05,4H,0,365,7,358,121,237,inf,0.019178082191780823,0.9808219178082191,0.3315068493150685,0.6493150684931507
054J,05,4J,0,474,16,458,287,171,inf,0.03375527426160337,0.9662447257383966,0.6054852320675106,0.36075949367088606
054K,05,4K,0,553,12,541,293,248,inf,0.0216998191681736,0.9783001808318263,0.5298372513562387,0.4484629294755877
054L,05,4L,0,638,11,627,360,267,inf,0.017241379310344827,0.9827586206896551,0.5642633228840125,0.41849529780564265
054M,05,4M,0,327,5,322,166,156,inf,0.01529051987767584,0.9847094801223242,0.5076452599388379,0.47706422018348627
054N,05,4N,0,321,4,317,176,141,inf,0.012461059190031152,0.9875389408099688,0.5482866043613707,0.4392523364485981
054P,05,4P,0,310,5,305,149,156,inf,0.016129032258064516,0.9838709677419355,0.4806451612903226,0.5032258064516129
054Q,05,4Q,0,321,5,316,127,189,inf,0.01557632398753894,0.9844236760124611,0.3956386292834891,0.5887850467289719
054R,05,4R,0,341,3,338,173,165,inf,0.008797653958944282,0.9912023460410557,0.5073313782991202,0.4838709677419355
054S,05,4S,0,733,13,720,362,358,inf,0.017735334242837655,0.9822646657571623,0.49386084583901774,0.48840381991814463
054T,05,4T,0,470,11,459,190,269,inf,0.023404255319148935,0.9765957446808511,0.40425531914893614,0.5723404255319149
054U,05,4U,0,509,15,494,196,298,inf,0.029469548133595286,0.9705304518664047,0.3850687622789784,0.5854616895874263
055A,05,5A,0,401,7,394,127,267,inf,0.017456359102244388,0.9825436408977556,0.3167082294264339,0.6658354114713217
055B,05,5B,0,578,13,565,312,253,inf,0.02249134948096886,0.9775086505190311,0.5397923875432526,0.43771626297577854
055C,05,5C,0,379,5,374,148,226,inf,0.013192612137203167,0.9868073878627969,0.39050131926121373,0.5963060686015831
055D,05,5D,0,629,12,617,371,246,inf,0.019077901430842606,0.9809220985691574,0.589825119236884,0.39109697933227344
055E,05,5E,0,560,7,553,339,214,inf,0.0125,0.9875,0.6053571428571428,0.3821428571428571
055F,05,5F,0,589,19,570,302,268,inf,0.03225806451612903,0.967741935483871,0.5127334465195246,0.45500848896434637
055G,05,5G,0,455,10,445,177,268,inf,0.02197802197802198,0.978021978021978,0.389010989010989,0.589010989010989
055H,05,5H,0,507,6,501,185,316,inf,0.011834319526627219,0.9881656804733728,0.36489151873767256,0.6232741617357002
055J,05,5J,0,718,11,707,245,462,inf,0.01532033426183844,0.9846796657381616,0.3412256267409471,0.6434540389972145
055K,05,5K,0,408,7,401,129,272,inf,0.01715686274509804,0.9828431372549019,0.3161764705882353,0.6666666666666666
055L,05,5L,0,664,13,651,216,435,inf,0.01957831325301205,0.9804216867469879,0.3253012048192771,0.6551204819277109
055M,05,5M,0,402,22,380,145,235,inf,0.05472636815920398,0.945273631840796,0.36069651741293535,0.5845771144278606
055N,05,5N,0,301,0,301,173,128,inf,0.0,1.0,0.574750830564784,0.42524916943521596
055P,05,5P,0,313,2,311,135,176,inf,0.006389776357827476,0.9936102236421726,0.43130990415335463,0.5623003194888179
055Q,05,5Q,0,384,5,379,151,228,inf,0.013020833333333334,0.9869791666666666,0.3932291666666667,0.59375
055R,05,5R,0,663,13,650,253,397,inf,0.0196078431372549,0.9803921568627451,0.3815987933634992,0.5987933634992458
055S,05,5S,0,436,6,430,129,301,inf,0.013761467889908258,0.9862385321100917,0.2958715596330275,0.6903669724770642
055T,05,5T,0,468,7,461,161,300,inf,0.014957264957264958,0.9850427350427351,0.344017094017094,0.6410256410256411
055U,05,5U,0,395,4,391,126,265,inf,0.010126582278481013,0.9898734177215189,0.3189873417721519,0.6708860759493671
055V,05,5V,0,409,5,404,121,283,inf,0.012224938875305624,0.9877750611246944,0.29584352078239606,0.6919315403422983
055W,05,5W,0,419,8,411,167,244,inf,0.01909307875894988,0.9809069212410502,0.39856801909307876,0.5823389021479713
055X,05,5X,0,357,25,332,114,218,inf,0.0700280112044818,0.9299719887955182,0.31932773109243695,0.6106442577030813
055Y,05,5Y,0,334,4,330,106,224,inf,0.011976047904191617,0.9880239520958084,0.31736526946107785,0.6706586826347305
055Z,05,5Z,0,445,5,440,116,324,inf,0.011235955056179775,0.9887640449438202,0.2606741573033708,0.7280898876404495
06101,06,101,1283,459,15,444,167,277,0.35775526110678096,0.032679738562091505,0.9673202614379085,0.3638344226579521,0.6034858387799564
06102,06,102,1303,465,15,450,233,217,0.35686876438986953,0.03225806451612903,0.967741935483871,0.5010752688172043,0.4666666666666667
06103,06,103,1256,511,13,498,315,183,0.4068471337579618,0.025440313111545987,0.974559686888454,0.6164383561643836,0.35812133072407043
06104,06,104,1288,496,17,479,259,220,0.38509316770186336,0.034274193548387094,0.9657258064516129,0.5221774193548387,0.4435483870967742
06105,06,105,1185,452,16,436,242,194,0.38143459915611816,0.035398230088495575,0.9646017699115044,0.5353982300884956,0.42920353982300885
06106,06,106,1150,427,20,407,245,162,0.37130434782608696,0.0468384074941452,0.9531615925058547,0.5737704918032787,0.3793911007025761
06107,06,107,1205,493,26,467,258,209,0.4091286307053942,0.05273833671399594,0.947261663286004,0.5233265720081136,0.4239350912778905
06108,06,108,1267,449,16,433,206,227,0.35438042620363064,0.035634743875278395,0.9643652561247216,0.45879732739420936,0.5055679287305123
06109,06,109,1314,486,26,460,248,212,0.3698630136986301,0.053497942386831275,0.9465020576131687,0.5102880658436214,0.43621399176954734
06110,06,110,1167,450,14,436,251,185,0.3856041131105398,0.03111111111111111,0.9688888888888889,0.5577777777777778,0.4111111111111111
06111,06,111,1126,461,19,442,236,206,0.40941385435168737,0.04121475054229935,0.9587852494577006,0.5119305856832972,0.44685466377440347
06112,06,112,1245,494,15,479,278,201,0.3967871485943775,0.030364372469635626,0.9696356275303644,0.562753036437247,0.4068825910931174
06113,06,113,1156,402,8,394,233,161,0.3477508650519031,0.01990049751243781,0.9800995024875622,0.5796019900497512,0.40049751243781095
06114,06,114,1240,432,10,422,182,240,0.34838709677419355,0.023148148148148147,0.9768518518518519,0.4212962962962963,0.5555555555555556
06115,06,115,1208,463,8,455,251,204,0.3832781456953642,0.017278617710583154,0.9827213822894169,0.5421166306695464,0.4406047516198704
06116,06,116,1224,512,6,506,264,242,0.41830065359477125,0.01171875,0.98828125,0.515625,0.47265625
06117,06,117,1180,421,10,411,200,211,0.35677966101694913,0.023752969121140142,0.9762470308788599,0.4750593824228028,0.501187648456057
06118,06,118,1224,476,15,461,225,236,0.3888888888888889,0.031512605042016806,0.9684873949579832,0.4726890756302521,0.4957983193277311
06119,06,119,1224,465,15,450,243,207,0.3799019607843137,0.03225806451612903,0.967741935483871,0.5225806451612903,0.44516129032258067
06120,06,120,1141,473,14,459,280,179,0.4145486415425066,0.02959830866807611,0.9704016913319239,0.5919661733615222,0.3784355179704017
06121,06,121,1207,467,15,452,257,195,0.3869096934548467,0.032119914346895075,0.9678800856531049,0.550321199143469,0.41755888650963596
06122,06,122,1308,538,16,522,297,225,0.41131498470948014,0.02973977695167286,0.9702602230483272,0.5520446096654275,0.41821561338289964
06123,06,123,1185,446,7,439,228,211,0.3763713080168776,0.01569506726457399,0.984304932735426,0.5112107623318386,0.4730941704035874
06124,06,124,1257,496,12,484,298,186,0.39459029435163084,0.024193548387096774,0.9758064516129032,0.6008064516129032,0.375
06125,06,125,1260,480,12,468,272,196,0.38095238095238093,0.025,0.975,0.5666666666666667,0.4083333333333333
06126,06,126,1136,485,16,469,274,195,0.4269366197183099,0.032989690721649485,0.9670103092783505,0.5649484536082474,0.4020618556701031
06201,06,201,1225,515,12,503,289,214,0.4204081632653061,0.02330097087378641,0.9766990291262136,0.5611650485436893,0.4155339805825243
06202,06,202,1356,538,22,516,292,224,0.3967551622418879,0.040892193308550186,0.9591078066914498,0.5427509293680297,0.4163568773234201
06203,06,203,1211,464,20,444,254,190,0.3831544178364988,0.04310344827586207,0.9568965517241379,0.5474137931034483,0.40948275862068967
06204,06,204,1261,556,26,530,281,249,0.4409199048374306,0.046762589928057555,0.9532374100719424,0.5053956834532374,0.447841726618705
06205,06,205,1133,440,21,419,228,191,0.3883495145631068,0.04772727272727273,0.9522727272727273,0.5181818181818182,0.4340909090909091
06206,06,206,1262,554,17,537,238,299,0.43898573692551507,0.030685920577617327,0.9693140794223827,0.4296028880866426,0.5397111913357401
06207,06,207,1167,383,21,362,225,137,0.3281919451585261,0.05483028720626632,0.9451697127937336,0.587467362924282,0.3577023498694517
06208,06,208,1264,506,23,483,266,217,0.40031645569620256,0.045454545454545456,0.9545454545454546,0.525691699604743,0.4288537549407115
06209,06,209,1314,465,17,448,249,199,0.3538812785388128,0.03655913978494624,0.9634408602150538,0.535483870967742,0.42795698924731185
06210,06,210,1295,525,16,509,239,270,0.40540540540540543,0.030476190476190476,0.9695238095238096,0.4552380952380952,0.5142857142857142
06211,06,211,1353,522,13,509,248,261,0.3858093126385809,0.02490421455938697,0.975095785440613,0.47509578544061304,0.5
06212,06,212,1292,459,7,452,261,191,0.35526315789473684,0.015250544662309368,0.9847494553376906,0.5686274509803921,0.41612200435729846
06213,06,213,1329,434,2,432,277,155,0.326561324303988,0.004608294930875576,0.9953917050691244,0.6382488479262672,0.35714285714285715
06214,06,214,1149,483,9,474,274,200,0.42036553524804177,0.018633540372670808,0.9813664596273292,0.567287784679089,0.4140786749482402
06215,06,215,1287,481,12,469,255,214,0.37373737373737376,0.02494802494802495,0.975051975051975,0.5301455301455301,0.44490644490644493
06216,06,216,1245,476,16,460,248,212,0.3823293172690763,0.03361344537815126,0.9663865546218487,0.5210084033613446,0.44537815126050423
06217,06,217,1307,535,14,521,274,247,0.4093343534812548,0.026168224299065422,0.9738317757009346,0.5121495327102804,0.4616822429906542
06218,06,218,1200,382,9,373,226,147,0.31833333333333336,0.02356020942408377,0.9764397905759162,0.5916230366492147,0.38481675392670156
06219,06,219,1182,458,16,442,272,170,0.38747884940778343,0.034934497816593885,0.9650655021834061,0.5938864628820961,0.37117903930131
06220,06,220,1239,483,19,464,282,182,0.3898305084745763,0.039337474120082816,0.9606625258799172,0.5838509316770186,0.37681159420289856
06221,06,221,1313,541,16,525,249,276,0.412033511043412,0.029574861367837338,0.9704251386321626,0.4602587800369686,0.5101663585951941
06222,06,222,1102,426,18,408,259,149,0.38656987295825773,0.04225352112676056,0.9577464788732394,0.607981220657277,0.34976525821596244
06223,06,223,1101,435,13,422,240,182,0.39509536784741145,0.029885057471264367,0.9701149425287356,0.5517241379310345,0.41839080459770117
06224,06,224,1264,523,21,502,289,213,0.4137658227848101,0.040152963671128104,0.9598470363288719,0.5525812619502868,0.4072657743785851
06225,06,225,1181,419,16,403,222,181,0.35478408128704486,0.03818615751789976,0.9618138424821002,0.5298329355608592,0.431980906921241
06301,06,301,1344,474,16,458,208,250,0.35267857142857145,0.03375527426160337,0.9662447257383966,0.4388185654008439,0.5274261603375527
06302,06,302,1291,481,7,474,225,249,0.37257939581719596,0.014553014553014554,0.9854469854469855,0.4677754677754678,0.5176715176715176
06303,06,303,1131,529,12,517,272,245,0.4677276746242264,0.022684310018903593,0.9773156899810964,0.5141776937618148,0.46313799621928164
06304,06,304,1289,474,23,451,144,307,0.36772692009309543,0.04852320675105485,0.9514767932489452,0.3037974683544304,0.6476793248945147
06305,06,305,1166,502,16,486,238,248,0.4305317324185249,0.03187250996015936,0.9681274900398407,0.47410358565737054,0.4940239043824701
06306,06,306,1319,459,19,440,185,255,0.3479909021986353,0.04139433551198257,0.9586056644880174,0.40305010893246185,0.5555555555555556
06307,06,307,1196,444,21,423,166,257,0.3712374581939799,0.0472972972972973,0.9527027027027027,0.3738738738738739,0.5788288288288288
06308,06,308,1185,474,14,460,150,310,0.4,0.029535864978902954,0.9704641350210971,0.31645569620253167,0.6540084388185654
06309,06,309,1322,441,14,427,158,269,0.33358547655068077,0.031746031746031744,0.9682539682539683,0.35827664399092973,0.6099773242630385
06310,06,310,1277,507,9,498,211,287,0.3970242756460454,0.01775147928994083,0.9822485207100592,0.4161735700197239,0.5660749506903353
06311,06,311,1098,394,13,381,147,234,0.3588342440801457,0.03299492385786802,0.9670050761421319,0.3730964467005076,0.5939086294416244
06312,06,312,1165,435,18,417,122,295,0.37339055793991416,0.041379310344827586,0.9586206896551724,0.28045977011494255,0.6781609195402298
06313,06,313,1195,470,10,460,203,257,0.39330543933054396,0.02127659574468085,0.9787234042553191,0.4319148936170213,0.5468085106382978
06314,06,314,1267,450,3,447,175,272,0.35516969218626676,0.006666666666666667,0.9933333333333333,0.3888888888888889,0.6044444444444445
06315,06,315,1211,439,15,424,148,276,0.3625103220478943,0.03416856492027335,0.9658314350797267,0.33712984054669703,0.6287015945330297
06316,06,316,1277,459,20,439,246,193,0.3594361785434612,0.04357298474945534,0.9564270152505446,0.5359477124183006,0.420479302832244
06317,06,317,1274,462,30,432,225,207,0.3626373626373626,0.06493506493506493,0.935064935064935,0.487012987012987,0.44805194805194803
06318,06,318,1295,498,23,475,255,220,0.38455598455598455,0.04618473895582329,0.9538152610441767,0.5120481927710844,0.44176706827309237
06319,06,319,1139,455,11,444,205,239,0.3994732221246708,0.024175824175824177,0.9758241758241758,0.45054945054945056,0.5252747252747253
06320,06,320,1242,514,15,499,207,292,0.4138486312399356,0.029182879377431907,0.9708171206225681,0.4027237354085603,0.5680933852140078
06321,06,321,1270,466,27,439,213,226,0.3669291338582677,0.05793991416309013,0.9420600858369099,0.4570815450643777,0.48497854077253216
06322,06,322,1299,477,15,462,232,230,0.3672055427251732,0.031446540880503145,0.9685534591194969,0.4863731656184486,0.48218029350104824
06323,06,323,1221,452,9,443,155,288,0.3701883701883702,0.01991150442477876,0.9800884955752213,0.34292035398230086,0.6371681415929203
06324,06,324,1181,511,6,505,167,338,0.43268416596104997,0.011741682974559686,0.9882583170254403,0.3268101761252446,0.6614481409001957
06325,06,325,1298,481,18,463,185,278,0.37057010785824346,0.037422037422037424,0.9625779625779626,0.38461538461538464,0.577962577962578
06326,06,326,1240,481,16,465,212,253,0.3879032258064516,0.033264033264033266,0.9667359667359667,0.4407484407484408,0.525987525987526
06327,06,327,1189,472,17,455,207,248,0.3969722455845248,0.036016949152542374,0.9639830508474576,0.4385593220338983,0.5254237288135594
06401,06,401,1199,529,15,514,219,295,0.44120100083402836,0.02835538752362949,0.9716446124763705,0.41398865784499056,0.55765595463138
06402,06,402,1315,555,22,533,240,293,0.4220532319391635,0.03963963963963964,0.9603603603603603,0.43243243243243246,0.527927927927928
06403,06,403,1322,461,13,448,226,222,0.348714069591528,0.028199566160520606,0.9718004338394793,0.49023861171366595,0.48156182212581344
06404,06,404,1163,460,26,434,164,270,0.39552880481513325,0.05652173913043478,0.9434782608695652,0.3565217391304348,0.5869565217391305
06405,06,405,1279,561,20,541,181,360,0.43862392494136043,0.035650623885918005,0.964349376114082,0.3226381461675579,0.6417112299465241
06406,06,406,1268,430,13,417,225,192,0.3391167192429022,0.030232558139534883,0.9697674418604652,0.5232558139534884,0.44651162790697674
06407,06,407,1359,477,10,467,246,221,0.3509933774834437,0.020964360587002098,0.9790356394129979,0.5157232704402516,0.46331236897274636
06408,06,408,1336,412,16,396,125,271,0.3083832335329341,0.038834951456310676,0.9611650485436893,0.30339805825242716,0.6577669902912622
06409,06,409,1199,449,21,428,197,231,0.37447873227689743,0.0467706013363029,0.9532293986636972,0.43875278396436523,0.5144766146993318
06410,06,410,1275,506,32,474,250,224,0.3968627450980392,0.06324110671936758,0.9367588932806324,0.49407114624505927,0.4426877470355731
06411,06,411,1589,684,33,651,282,369,0.4304594084329767,0.04824561403508772,0.9517543859649122,0.41228070175438597,0.5394736842105263
06412,06,412,1256,562,25,537,263,274,0.44745222929936307,0.04448398576512456,0.9555160142348754,0.4679715302491103,0.4875444839857651
06413,06,413,1283,451,33,418,231,187,0.35151987529228373,0.07317073170731707,0.926829268292683,0.5121951219512195,0.4146341463414634
06414,06,414,1202,505,18,487,381,106,0.42013311148086524,0.03564356435643564,0.9643564356435643,0.7544554455445545,0.2099009900990099
06415,06,415,1067,399,20,379,240,139,0.3739456419868791,0.05012531328320802,0.949874686716792,0.6015037593984962,0.3483709273182957
06416,06,416,1300,459,17,442,181,261,0.35307692307692307,0.037037037037037035,0.9629629629629629,0.39433551198257083,0.5686274509803921
06417,06,417,1278,454,27,427,173,254,0.35524256651017216,0.05947136563876652,0.9405286343612335,0.381057268722467,0.5594713656387665
06418,06,418,1212,501,18,483,197,286,0.41336633663366334,0.03592814371257485,0.9640718562874252,0.3932135728542914,0.5708582834331337
06419,06,419,1186,440,27,413,199,214,0.37099494097807756,0.06136363636363636,0.9386363636363636,0.45227272727272727,0.4863636363636364
06420,06,420,1169,487,10,477,298,179,0.41659538066723695,0.02053388090349076,0.9794661190965093,0.6119096509240246,0.3675564681724846
06421,06,421,1280,470,13,457,216,241,0.3671875,0.027659574468085105,0.9723404255319149,0.4595744680851064,0.5127659574468085
06422,06,422,1237,499,10,489,229,260,0.4033953112368634,0.02004008016032064,0.9799599198396793,0.4589178356713427,0.5210420841683366
06423,06,423,1277,474,13,461,162,299,0.3711824588880188,0.027426160337552744,0.9725738396624473,0.34177215189873417,0.630801687763713
06501,06,501,1181,443,13,430,234,196,0.37510584250635054,0.029345372460496615,0.9706546275395034,0.5282167042889391,0.44243792325056436
06502,06,502,1316,458,13,445,237,208,0.34802431610942247,0.028384279475982533,0.9716157205240175,0.517467248908297,0.45414847161572053
06503,06,503,1250,449,24,425,195,230,0.3592,0.053452115812917596,0.9465478841870824,0.43429844097995546,0.512249443207127
06504,06,504,1105,467,27,440,182,258,0.42262443438914027,0.057815845824411134,0.9421841541755889,0.3897216274089936,0.5524625267665952
06505,06,505,1251,499,19,480,209,271,0.39888089528377296,0.03807615230460922,0.9619238476953907,0.4188376753507014,0.5430861723446894
06506,06,506,1218,421,16,405,239,166,0.34564860426929395,0.03800475059382423,0.9619952494061758,0.5676959619952494,0.39429928741092635
06507,06,507,1190,487,26,461,257,204,0.4092436974789916,0.053388090349075976,0.946611909650924,0.5277207392197125,0.4188911704312115
06508,06,508,1314,463,15,448,249,199,0.3523592085235921,0.032397408207343416,0.9676025917926566,0.5377969762419006,0.4298056155507559
06509,06,509,1322,506,20,486,213,273,0.3827534039334342,0.039525691699604744,0.9604743083003953,0.4209486166007905,0.5395256916996047
06510,06,510,1278,560,18,542,256,286,0.4381846635367762,0.03214285714285714,0.9678571428571429,0.45714285714285713,0.5107142857142857
06511,06,511,1136,381,26,355,157,198,0.335387323943662,0.06824146981627296,0.931758530183727,0.4120734908136483,0.5196850393700787
06512,06,512,1217,469,18,451,261,190,0.3853738701725555,0.03837953091684435,0.9616204690831557,0.5565031982942431,0.4051172707889126
06513,06,513,1161,472,29,443,262,181,0.40654608096468564,0.0614406779661017,0.9385593220338984,0.5550847457627118,0.3834745762711864
06514,06,514,1260,511,11,500,173,327,0.40555555555555556,0.021526418786692758,0.9784735812133072,0.3385518590998043,0.639921722113503
06515,06,515,1248,526,15,511,255,256,0.421474358974359,0.028517110266159697,0.9714828897338403,0.4847908745247148,0.4866920152091255
06516,06,516,1087,394,16,378,230,148,0.3624655013799448,0.04060913705583756,0.9593908629441624,0.583756345177665,0.3756345177664975
06517,06,517,1240,493,22,471,267,204,0.3975806451612903,0.04462474645030426,0.9553752535496958,0.5415821501014199,0.41379310344827586
06518,06,518,1044,428,22,406,227,179,0.4099616858237548,0.0514018691588785,0.9485981308411215,0.530373831775701,0.4182242990654206
06519,06,519,1021,363,19,344,170,174,0.3555337904015671,0.05234159779614325,0.9476584022038568,0.46831955922865015,0.4793388429752066
06520,06,520,1103,431,10,421,171,250,0.39075249320036265,0.02320185614849188,0.9767981438515081,0.39675174013921116,0.580046403712297
06521,06,521,1105,434,18,416,171,245,0.3927601809954751,0.041474654377880185,0.9585253456221198,0.39400921658986177,0.5645161290322581
06522,06,522,1286,477,24,453,254,199,0.37091757387247276,0.050314465408805034,0.949685534591195,0.5324947589098532,0.4171907756813417
06523,06,523,1322,551,17,534,365,169,0.4167927382753404,0.030852994555353903,0.969147005444646,0.662431941923775,0.30671506352087113
06524,06,524,1000,384,21,363,230,133,0.384,0.0546875,0.9453125,0.5989583333333334,0.3463541666666667
06525,06,525,981,366,20,346,220,126,0.3730886850152905,0.0546448087431694,0.9453551912568307,0.6010928961748634,0.3442622950819672
06601,06,601,1211,392,13,379,164,215,0.3236994219653179,0.03316326530612245,0.9668367346938775,0.41836734693877553,0.548469387755102
06602,06,602,1204,535,16,519,259,260,0.44435215946843853,0.029906542056074768,0.9700934579439252,0.48411214953271026,0.48598130841121495
06603,06,603,1189,459,12,447,164,283,0.3860386879730866,0.026143790849673203,0.9738562091503268,0.3572984749455338,0.616557734204793
06604,06,604,1171,545,14,531,239,292,0.4654141759180188,0.025688073394495414,0.9743119266055046,0.43853211009174314,0.5357798165137615
06605,06,605,1302,634,9,625,314,311,0.4869431643625192,0.014195583596214511,0.9858044164037855,0.4952681388012618,0.49053627760252366
06606,06,606,1206,475,13,462,100,362,0.3938640132669983,0.02736842105263158,0.9726315789473684,0.21052631578947367,0.7621052631578947
06607,06,607,1212,459,17,442,124,318,0.3787128712871287,0.037037037037037035,0.9629629629629629,0.2701525054466231,0.6928104575163399
06608,06,608,1398,501,14,487,196,291,0.3583690987124464,0.027944111776447105,0.9720558882235529,0.3912175648702595,0.5808383233532934
06609,06,609,1151,434,8,426,161,265,0.37706342311033886,0.018433179723502304,0.9815668202764977,0.3709677419354839,0.6105990783410138
06610,06,610,1145,477,7,470,148,322,0.4165938864628821,0.014675052410901468,0.9853249475890985,0.31027253668763105,0.6750524109014675
06611,06,611,1261,489,11,478,237,241,0.3877874702616971,0.022494887525562373,0.9775051124744376,0.48466257668711654,0.49284253578732107
06612,06,612,1136,473,18,455,205,250,0.4163732394366197,0.03805496828752643,0.9619450317124736,0.4334038054968288,0.5285412262156448
06613,06,613,1145,434,15,419,149,270,0.37903930131004365,0.03456221198156682,0.9654377880184332,0.3433179723502304,0.6221198156682027
06614,06,614,1205,519,4,515,163,352,0.4307053941908714,0.007707129094412331,0.9922928709055877,0.3140655105973025,0.6782273603082851
06615,06,615,1284,461,14,447,250,197,0.3590342679127726,0.03036876355748373,0.9696312364425163,0.5422993492407809,0.42733188720173537
06616,06,616,1286,604,14,590,255,335,0.46967340590979784,0.023178807947019868,0.9768211920529801,0.42218543046357615,0.554635761589404
06617,06,617,1257,391,17,374,156,218,0.31105807478122516,0.043478260869565216,0.9565217391304348,0.3989769820971867,0.5575447570332481
06618,06,618,1344,535,10,525,272,253,0.39806547619047616,0.018691588785046728,0.9813084112149533,0.508411214953271,0.47289719626168225
06619,06,619,1295,577,22,555,283,272,0.44555984555984557,0.038128249566724434,0.9618717504332756,0.4904679376083189,0.4714038128249567
06620,06,620,1321,510,16,494,240,254,0.38607115821347465,0.03137254901960784,0.9686274509803922,0.47058823529411764,0.4980392156862745
06621,06,621,1311,504,15,489,234,255,0.38443935926773454,0.02976190476190476,0.9702380952380952,0.4642857142857143,0.5059523809523809
06622,06,622,1327,522,18,504,293,211,0.3933685003767898,0.034482758620689655,0.9655172413793104,0.5613026819923371,0.4042145593869732
06623,06,623,1362,511,17,494,253,241,0.3751835535976505,0.033268101761252444,0.9667318982387475,0.49510763209393344,0.47162426614481406
06624,06,624,1263,463,22,441,214,227,0.3665874901029295,0.047516198704103674,0.9524838012958964,0.46220302375809935,0.490280777537797
06625,06,625,1288,478,5,473,136,337,0.37111801242236025,0.010460251046025104,0.9895397489539749,0.28451882845188287,0.7050209205020921
06701,06,701,1159,447,12,435,142,293,0.3856773080241588,0.026845637583892617,0.9731543624161074,0.31767337807606266,0.6554809843400448
06702,06,702,1230,471,13,458,147,311,0.3829268292682927,0.027600849256900213,0.9723991507430998,0.31210191082802546,0.6602972399150743
06703,06,703,1130,446,12,434,151,283,0.39469026548672564,0.026905829596412557,0.9730941704035875,0.33856502242152464,0.6345291479820628
06704,06,704,1258,367,7,360,170,190,0.2917329093799682,0.01907356948228883,0.9809264305177112,0.46321525885558584,0.5177111716621253
06705,06,705,1104,386,16,370,168,202,0.3496376811594203,0.04145077720207254,0.9585492227979274,0.43523316062176165,0.5233160621761658
06706,06,706,1387,549,12,537,157,380,0.39581831290555153,0.02185792349726776,0.9781420765027322,0.2859744990892532,0.692167577413479
06707,06,707,1373,460,15,445,158,287,0.3350327749453751,0.03260869565217391,0.967391304347826,0.34347826086956523,0.6239130434782608
06708,06,708,1144,465,5,460,217,243,0.40646853146853146,0.010752688172043012,0.989247311827957,0.4666666666666667,0.5225806451612903
06709,06,709,1088,426,18,408,123,285,0.3915441176470588,0.04225352112676056,0.9577464788732394,0.2887323943661972,0.6690140845070423
06710,06,710,1185,483,19,464,185,279,0.40759493670886077,0.039337474120082816,0.9606625258799172,0.3830227743271222,0.577639751552795
06711,06,711,1173,326,14,312,103,209,0.27791986359761295,0.04294478527607362,0.9570552147239264,0.3159509202453988,0.6411042944785276
06712,06,712,1100,446,28,418,204,214,0.40545454545454546,0.06278026905829596,0.9372197309417041,0.45739910313901344,0.4798206278026906
06713,06,713,1217,462,1,461,154,307,0.37962202136400985,0.0021645021645021645,0.9978354978354979,0.3333333333333333,0.6645021645021645
06714,06,714,1198,508,17,491,246,245,0.4240400667779633,0.03346456692913386,0.9665354330708661,0.484251968503937,0.4822834645669291
06715,06,715,1060,391,12,379,149,230,0.36886792452830186,0.030690537084398978,0.969309462915601,0.38107416879795397,0.5882352941176471
06716,06,716,1160,474,9,465,142,323,0.4086206896551724,0.0189873417721519,0.9810126582278481,0.29957805907172996,0.6814345991561181
06717,06,717,1115,477,7,470,226,244,0.42780269058295967,0.014675052410901468,0.9853249475890985,0.47379454926624737,0.5115303983228512
06718,06,718,1253,486,14,472,169,303,0.38786911412609737,0.02880658436213992,0.9711934156378601,0.3477366255144033,0.6234567901234568
06719,06,719,1209,489,19,470,211,259,0.4044665012406948,0.03885480572597137,0.9611451942740287,0.43149284253578735,0.5296523517382413
06720,06,720,1219,530,16,514,186,328,0.43478260869565216,0.03018867924528302,0.969811320754717,0.35094339622641507,0.6188679245283019
06721,06,721,1188,486,21,465,169,296,0.4090909090909091,0.043209876543209874,0.9567901234567902,0.3477366255144033,0.6090534979423868
06722,06,722,1345,451,18,433,141,292,0.3353159851301115,0.03991130820399113,0.9600886917960089,0.31263858093126384,0.647450110864745
06723,06,723,1196,440,10,430,131,299,0.36789297658862874,0.022727272727272728,0.9772727272727273,0.29772727272727273,0.6795454545454546
06724,06,724,1144,505,24,481,249,232,0.44143356643356646,0.047524752475247525,0.9524752475247524,0.49306930693069306,0.4594059405940594
06725,06,725,1077,427,18,409,197,212,0.39647168059424326,0.04215456674473068,0.9578454332552693,0.4613583138173302,0.4964871194379391
061A,06,1A,0,667,6,661,303,358,inf,0.008995502248875561,0.9910044977511244,0.4542728635682159,0.5367316341829086
061AA,06,1AA,0,519,7,512,311,201,inf,0.01348747591522158,0.9865125240847784,0.5992292870905588,0.3872832369942196
061AB,06,1AB,0,414,2,412,265,147,inf,0.004830917874396135,0.9951690821256038,0.6400966183574879,0.35507246376811596
061B,06,1B,0,610,6,604,279,325,inf,0.009836065573770493,0.9901639344262295,0.45737704918032784,0.5327868852459017
061C,06,1C,0,469,4,465,273,192,inf,0.008528784648187633,0.9914712153518124,0.582089552238806,0.4093816631130064
061D,06,1D,0,586,10,576,323,253,inf,0.017064846416382253,0.9829351535836177,0.5511945392491467,0.431740614334471
061E,06,1E,0,443,8,435,230,205,inf,0.01805869074492099,0.981941309255079,0.5191873589164786,0.46275395033860045
061F,06,1F,0,407,4,403,213,190,inf,0.009828009828009828,0.9901719901719902,0.5233415233415234,0.4668304668304668
061G,06,1G,0,457,8,449,216,233,inf,0.0175054704595186,0.9824945295404814,0.4726477024070022,0.5098468271334792
061H,06,1H,0,629,4,625,277,348,inf,0.006359300476947536,0.9936406995230525,0.44038155802861684,0.5532591414944356
061J,06,1J,0,539,11,528,264,264,inf,0.02040816326530612,0.9795918367346939,0.4897959183673469,0.4897959183673469
061K,06,1K,0,490,13,477,266,211,inf,0.026530612244897958,0.9734693877551021,0.5428571428571428,0.4306122448979592
061L,06,1L,0,439,9,430,212,218,inf,0.02050113895216401,0.979498861047836,0.48291571753986334,0.49658314350797267
061M,06,1M,0,428,7,421,230,191,inf,0.016355140186915886,0.9836448598130841,0.5373831775700935,0.4462616822429907
061N,06,1N,0,407,15,392,229,163,inf,0.036855036855036855,0.9631449631449631,0.5626535626535627,0.4004914004914005
061P,06,1P,0,555,9,546,268,278,inf,0.016216216216216217,0.9837837837837838,0.4828828828828829,0.5009009009009009
061Q,06,1Q,0,439,8,431,243,188,inf,0.018223234624145785,0.9817767653758542,0.5535307517084282,0.428246013667426
061R,06,1R,0,527,6,521,291,230,inf,0.011385199240986717,0.9886148007590133,0.5521821631878557,0.4364326375711575
061S,06,1S,0,527,9,518,224,294,inf,0.017077798861480076,0.9829222011385199,0.4250474383301708,0.5578747628083491
061T,06,1T,0,548,7,541,242,299,inf,0.012773722627737226,0.9872262773722628,0.4416058394160584,0.5456204379562044
061U,06,1U,0,501,10,491,262,229,inf,0.01996007984031936,0.9800399201596807,0.5229540918163673,0.45708582834331335
061V,06,1V,0,476,7,469,270,199,inf,0.014705882352941176,0.9852941176470589,0.5672268907563025,0.4180672268907563
061W,06,1W,0,485,8,477,243,234,inf,0.016494845360824743,0.9835051546391752,0.5010309278350515,0.4824742268041237
061X,06,1X,0,530,9,521,270,251,inf,0.016981132075471698,0.9830188679245283,0.5094339622641509,0.47358490566037736
061Y,06,1Y,0,505,4,501,248,253,inf,0.007920792079207921,0.9920792079207921,0.4910891089108911,0.500990099009901
061Z,06,1Z,0,505,4,501,276,225,inf,0.007920792079207921,0.9920792079207921,0.5465346534653466,0.44554455445544555
062A,06,2A,0,465,11,454,255,199,inf,0.023655913978494623,0.9763440860215054,0.5483870967741935,0.42795698924731185
062AA,06,2AA,0,516,16,500,243,257,inf,0.031007751937984496,0.9689922480620154,0.47093023255813954,0.49806201550387597
062B,06,2B,0,520,12,508,250,258,inf,0.023076923076923078,0.9769230769230769,0.4807692307692308,0.49615384615384617
062C,06,2C,0,440,4,436,239,197,inf,0.00909090909090909,0.990909090909091,0.5431818181818182,0.44772727272727275
062D,06,2D,0,424,4,420,198,222,inf,0.009433962264150943,0.9905660377358491,0.4669811320754717,0.5235849056603774
062E,06,2E,0,420,8,412,228,184,inf,0.01904761904761905,0.9809523809523809,0.5428571428571428,0.4380952380952381
062F,06,2F,0,481,3,478,216,262,inf,0.006237006237006237,0.9937629937629938,0.4490644490644491,0.5446985446985447
062G,06,2G,0,471,6,465,264,201,inf,0.012738853503184714,0.9872611464968153,0.5605095541401274,0.4267515923566879
062H,06,2H,0,461,9,452,249,203,inf,0.019522776572668113,0.9804772234273319,0.5401301518438177,0.4403470715835141
062J,06,2J,0,547,6,541,280,261,inf,0.010968921389396709,0.9890310786106032,0.5118829981718465,0.47714808043875684
062K,06,2K,0,538,11,527,252,275,inf,0.020446096654275093,0.9795539033457249,0.4684014869888476,0.5111524163568774
062L,06,2L,0,544,7,537,280,257,inf,0.012867647058823529,0.9871323529411765,0.5147058823529411,0.4724264705882353
062M,06,2M,0,572,8,564,325,239,inf,0.013986013986013986,0.986013986013986,0.5681818181818182,0.4178321678321678
062N,06,2N,0,510,31,479,280,199,inf,0.060784313725490195,0.9392156862745098,0.5490196078431373,0.39019607843137255
062P,06,2P,0,494,8,486,296,190,inf,0.016194331983805668,0.9838056680161943,0.5991902834008097,0.38461538461538464
062Q,06,2Q,0,509,0,509,267,242,inf,0.0,1.0,0.5245579567779961,0.47544204322200395
062R,06,2R,0,484,11,473,261,212,inf,0.022727272727272728,0.9772727272727273,0.5392561983471075,0.4380165289256198
062S,06,2S,0,516,6,510,286,224,inf,0.011627906976744186,0.9883720930232558,0.5542635658914729,0.43410852713178294
062T,06,2T,0,429,0,429,243,186,inf,0.0,1.0,0.5664335664335665,0.43356643356643354
062U,06,2U,0,481,2,479,270,209,inf,0.004158004158004158,0.9958419958419958,0.5613305613305614,0.43451143451143454
062V,06,2V,0,491,7,484,284,200,inf,0.014256619144602852,0.9857433808553971,0.5784114052953157,0.4073319755600815
062W,06,2W,0,481,14,467,223,244,inf,0.029106029106029108,0.9708939708939709,0.46361746361746364,0.5072765072765073
062X,06,2X,0,382,9,373,218,155,inf,0.02356020942408377,0.9764397905759162,0.5706806282722513,0.40575916230366493
062Y,06,2Y,0,411,7,404,236,168,inf,0.0170316301703163,0.9829683698296837,0.5742092457420924,0.40875912408759124
062Z,06,2Z,0,445,7,438,246,192,inf,0.015730337078651686,0.9842696629213483,0.5528089887640449,0.4314606741573034
063A,06,3A,0,652,12,640,282,358,inf,0.018404907975460124,0.9815950920245399,0.4325153374233129,0.549079754601227
063AA,06,3AA,0,573,8,565,253,312,inf,0.013961605584642234,0.9860383944153578,0.44153577661431065,0.5445026178010471
063AB,06,3AB,0,559,6,553,256,297,inf,0.01073345259391771,0.9892665474060823,0.45796064400715564,0.5313059033989267
063AC,06,3AC,0,537,7,530,208,322,inf,0.01303538175046555,0.9869646182495344,0.38733705772811916,0.5996275605214153
063B,06,3B,0,602,9,593,254,339,inf,0.014950166112956811,0.9850498338870431,0.4219269102990033,0.5631229235880398
063C,06,3C,0,391,4,387,212,175,inf,0.010230179028132993,0.989769820971867,0.5421994884910486,0.4475703324808184
063D,06,3D,0,624,5,619,205,414,inf,0.008012820512820512,0.9919871794871795,0.328525641025641,0.6634615384615384
063E,06,3E,0,408,7,401,194,207,inf,0.01715686274509804,0.9828431372549019,0.47549019607843135,0.5073529411764706
063F,06,3F,0,538,11,527,230,297,inf,0.020446096654275093,0.9795539033457249,0.4275092936802974,0.5520446096654275
063G,06,3G,0,568,9,559,212,347,inf,0.01584507042253521,0.9841549295774648,0.3732394366197183,0.6109154929577465
063H,06,3H,0,526,4,522,173,349,inf,0.0076045627376425855,0.9923954372623575,0.3288973384030418,0.6634980988593155
063J,06,3J,0,600,7,593,186,407,inf,0.011666666666666667,0.9883333333333333,0.31,0.6783333333333333
063K,06,3K,0,584,9,575,208,367,inf,0.015410958904109588,0.9845890410958904,0.3561643835616438,0.6284246575342466
063L,06,3L,0,505,10,495,193,302,inf,0.019801980198019802,0.9801980198019802,0.3821782178217822,0.598019801980198
063M,06,3M,0,568,6,562,201,361,inf,0.01056338028169014,0.9894366197183099,0.3538732394366197,0.6355633802816901
063N,06,3N,0,512,11,501,172,329,inf,0.021484375,0.978515625,0.3359375,0.642578125
063P,06,3P,0,514,11,503,171,332,inf,0.021400778210116732,0.9785992217898832,0.3326848249027237,0.6459143968871596
063Q,06,3Q,0,553,8,545,164,381,inf,0.014466546112115732,0.9855334538878843,0.2965641952983725,0.6889692585895117
063R,06,3R,0,473,19,454,265,189,inf,0.040169133192389,0.959830866807611,0.5602536997885835,0.39957716701902746
063S,06,3S,0,460,6,454,234,220,inf,0.013043478260869565,0.9869565217391304,0.508695652173913,0.4782608695652174
063T,06,3T,0,475,9,466,243,223,inf,0.018947368421052633,0.9810526315789474,0.511578947368421,0.4694736842105263
063U,06,3U,0,472,7,465,199,266,inf,0.014830508474576272,0.9851694915254238,0.4216101694915254,0.5635593220338984
063V,06,3V,0,563,2,561,196,365,inf,0.003552397868561279,0.9964476021314387,0.3481349911190053,0.6483126110124334
063W,06,3W,0,438,7,431,194,237,inf,0.01598173515981735,0.9840182648401826,0.4429223744292237,0.541095890410959
063X,06,3X,0,558,7,551,205,346,inf,0.012544802867383513,0.9874551971326165,0.3673835125448029,0.6200716845878136
063Y,06,3Y,0,562,2,560,172,388,inf,0.0035587188612099642,0.99644128113879,0.30604982206405695,0.6903914590747331
063Z,06,3Z,0,466,5,461,171,290,inf,0.01072961373390558,0.9892703862660944,0.3669527896995708,0.6223175965665236
064A,06,4A,0,467,3,464,191,273,inf,0.006423982869379015,0.9935760171306209,0.4089935760171306,0.5845824411134903
064B,06,4B,0,473,11,462,198,264,inf,0.023255813953488372,0.9767441860465116,0.4186046511627907,0.5581395348837209
064C,06,4C,0,546,7,539,250,289,inf,0.01282051282051282,0.9871794871794872,0.45787545787545786,0.5293040293040293
064D,06,4D,0,488,11,477,181,296,inf,0.022540983606557378,0.9774590163934426,0.3709016393442623,0.6065573770491803
064E,06,4E,0,508,9,499,162,337,inf,0.017716535433070866,0.9822834645669292,0.3188976377952756,0.6633858267716536
064F,06,4F,0,520,0,520,235,285,inf,0.0,1.0,0.4519230769230769,0.5480769230769231
064G,06,4G,0,493,3,490,245,245,inf,0.006085192697768763,0.9939148073022313,0.4969574036511156,0.4969574036511156
064H,06,4H,0,630,7,623,235,388,inf,0.011111111111111112,0.9888888888888889,0.373015873015873,0.6158730158730159
064J,06,4J,0,521,6,515,239,276,inf,0.011516314779270634,0.9884836852207294,0.45873320537428025,0.5297504798464492
064K,06,4K,0,348,5,343,173,170,inf,0.014367816091954023,0.985632183908046,0.49712643678160917,0.4885057471264368
064L,06,4L,0,532,4,528,287,241,inf,0.007518796992481203,0.9924812030075187,0.5394736842105263,0.45300751879699247
064M,06,4M,0,385,6,379,177,202,inf,0.015584415584415584,0.9844155844155844,0.4597402597402597,0.5246753246753246
064N,06,4N,0,426,1,425,190,235,inf,0.002347417840375587,0.9976525821596244,0.4460093896713615,0.5516431924882629
064P,06,4P,0,207,4,203,137,66,inf,0.01932367149758454,0.9806763285024155,0.6618357487922706,0.3188405797101449
064Q,06,4Q,0,314,4,310,172,138,inf,0.012738853503184714,0.9872611464968153,0.5477707006369427,0.4394904458598726
064R,06,4R,0,615,13,602,210,392,inf,0.02113821138211382,0.9788617886178862,0.34146341463414637,0.6373983739837399
064S,06,4S,0,555,7,548,238,310,inf,0.012612612612612612,0.9873873873873874,0.42882882882882883,0.5585585585585585
064T,06,4T,0,517,10,507,190,317,inf,0.019342359767891684,0.9806576402321083,0.36750483558994196,0.6131528046421664
064U,06,4U,0,421,6,415,196,219,inf,0.014251781472684086,0.9857482185273159,0.4655581947743468,0.5201900237529691
064V,06,4V,0,389,7,382,214,168,inf,0.017994858611825194,0.9820051413881749,0.5501285347043702,0.4318766066838046
064W,06,4W,0,515,6,509,218,291,inf,0.011650485436893204,0.9883495145631068,0.42330097087378643,0.5650485436893203
064X,06,4X,0,515,13,502,228,274,inf,0.02524271844660194,0.974757281553398,0.44271844660194176,0.5320388349514563
064Y,06,4Y,0,619,4,615,226,389,inf,0.006462035541195477,0.9935379644588045,0.3651050080775444,0.6284329563812601
065A,06,5A,0,447,6,441,232,209,inf,0.013422818791946308,0.9865771812080537,0.5190156599552572,0.46756152125279643
065AA,06,5AA,0,217,2,215,133,82,inf,0.009216589861751152,0.9907834101382489,0.6129032258064516,0.3778801843317972
065B,06,5B,0,427,12,415,199,216,inf,0.02810304449648712,0.9718969555035128,0.46604215456674475,0.5058548009367682
065C,06,5C,0,475,10,465,240,225,inf,0.021052631578947368,0.9789473684210527,0.5052631578947369,0.47368421052631576
065D,06,5D,0,461,5,456,176,280,inf,0.010845986984815618,0.9891540130151844,0.38177874186550975,0.6073752711496746
065E,06,5E,0,547,9,538,223,315,inf,0.016453382084095063,0.9835466179159049,0.4076782449725777,0.5758683729433273
065F,06,5F,0,447,6,441,232,209,inf,0.013422818791946308,0.9865771812080537,0.5190156599552572,0.46756152125279643
065G,06,5G,0,346,4,342,188,154,inf,0.011560693641618497,0.9884393063583815,0.5433526011560693,0.44508670520231214
065H,06,5H,0,444,5,439,220,219,inf,0.01126126126126126,0.9887387387387387,0.4954954954954955,0.49324324324324326
065J,06,5J,0,544,15,529,224,305,inf,0.027573529411764705,0.9724264705882353,0.4117647058823529,0.5606617647058824
065K,06,5K,0,420,5,415,209,206,inf,0.011904761904761904,0.9880952380952381,0.4976190476190476,0.49047619047619045
065L,06,5L,0,470,9,461,219,242,inf,0.019148936170212766,0.9808510638297873,0.46595744680851064,0.5148936170212766
065M,06,5M,0,359,8,351,204,147,inf,0.022284122562674095,0.9777158774373259,0.5682451253481894,0.40947075208913647
065N,06,5N,0,328,4,324,154,170,inf,0.012195121951219513,0.9878048780487805,0.4695121951219512,0.5182926829268293
065P,06,5P,0,532,8,524,194,330,inf,0.015037593984962405,0.9849624060150376,0.36466165413533835,0.6203007518796992
065Q,06,5Q,0,429,6,423,208,215,inf,0.013986013986013986,0.986013986013986,0.48484848484848486,0.5011655011655012
065R,06,5R,0,348,5,343,201,142,inf,0.014367816091954023,0.985632183908046,0.5775862068965517,0.40804597701149425
065S,06,5S,0,333,6,327,166,161,inf,0.018018018018018018,0.9819819819819819,0.4984984984984985,0.48348348348348347
065T,06,5T,0,307,6,301,147,154,inf,0.019543973941368076,0.9804560260586319,0.4788273615635179,0.501628664495114
065U,06,5U,0,372,6,366,169,197,inf,0.016129032258064516,0.9838709677419355,0.4543010752688172,0.5295698924731183
065V,06,5V,0,491,7,484,189,295,inf,0.014256619144602852,0.9857433808553971,0.384928716904277,0.6008146639511202
065W,06,5W,0,498,3,495,188,307,inf,0.006024096385542169,0.9939759036144579,0.37751004016064255,0.6164658634538153
065X,06,5X,0,430,6,424,223,201,inf,0.013953488372093023,0.986046511627907,0.5186046511627908,0.46744186046511627
065Y,06,5Y,0,353,2,351,225,126,inf,0.0056657223796034,0.9943342776203966,0.6373937677053825,0.35694050991501414
065Z,06,5Z,0,286,3,283,166,117,inf,0.01048951048951049,0.9895104895104895,0.5804195804195804,0.4090909090909091
066A,06,6A,0,673,6,667,296,371,inf,0.008915304606240713,0.9910846953937593,0.4398216939078752,0.5512630014858841
066AA,06,6AA,0,609,3,606,119,487,inf,0.0049261083743842365,0.9950738916256158,0.19540229885057472,0.7996715927750411
066B,06,6B,0,473,6,467,214,253,inf,0.012684989429175475,0.9873150105708245,0.452431289640592,0.5348837209302325
066C,06,6C,0,592,3,589,205,384,inf,0.005067567567567568,0.9949324324324325,0.34628378378378377,0.6486486486486487
066D,06,6D,0,459,7,452,196,256,inf,0.015250544662309368,0.9847494553376906,0.42701525054466233,0.5577342047930284
066E,06,6E,0,442,7,435,224,211,inf,0.01583710407239819,0.9841628959276018,0.5067873303167421,0.47737556561085975
066F,06,6F,0,493,6,487,117,370,inf,0.012170385395537525,0.9878296146044625,0.23732251521298176,0.7505070993914807
066G,06,6G,0,539,2,537,127,410,inf,0.0037105751391465678,0.9962894248608535,0.23562152133580705,0.7606679035250464
066H,06,6H,0,637,9,628,205,423,inf,0.0141287284144427,0.9858712715855573,0.3218210361067504,0.6640502354788069
066J,06,6J,0,532,10,522,182,340,inf,0.018796992481203006,0.981203007518797,0.34210526315789475,0.6390977443609023
066K,06,6K,0,534,6,528,132,396,inf,0.011235955056179775,0.9887640449438202,0.24719101123595505,0.7415730337078652
066L,06,6L,0,521,13,508,232,276,inf,0.02495201535508637,0.9750479846449136,0.44529750479846447,0.5297504798464492
066M,06,6M,0,470,6,464,214,250,inf,0.01276595744680851,0.9872340425531915,0.4553191489361702,0.5319148936170213
066N,06,6N,0,577,10,567,180,387,inf,0.01733102253032929,0.9826689774696707,0.3119584055459272,0.6707105719237435
066P,06,6P,0,516,6,510,173,337,inf,0.011627906976744186,0.9883720930232558,0.33527131782945735,0.6531007751937985
066Q,06,6Q,0,508,9,499,264,235,inf,0.017716535433070866,0.9822834645669292,0.5196850393700787,0.4625984251968504
066R,06,6R,0,450,6,444,233,211,inf,0.013333333333333334,0.9866666666666667,0.5177777777777778,0.4688888888888889
066S,06,6S,0,541,13,528,210,318,inf,0.024029574861367836,0.9759704251386322,0.38817005545286504,0.5878003696857671
066T,06,6T,0,557,7,550,275,275,inf,0.012567324955116697,0.9874326750448833,0.49371633752244165,0.49371633752244165
066U,06,6U,0,487,5,482,198,284,inf,0.01026694045174538,0.9897330595482546,0.406570841889117,0.5831622176591376
066V,06,6V,0,544,9,535,233,302,inf,0.016544117647058824,0.9834558823529411,0.42830882352941174,0.5551470588235294
066W,06,6W,0,504,6,498,252,246,inf,0.011904761904761904,0.9880952380952381,0.5,0.4880952380952381
066X,06,6X,0,558,10,548,299,249,inf,0.017921146953405017,0.982078853046595,0.53584229390681,0.44623655913978494
066Y,06,6Y,0,601,12,589,306,283,inf,0.019966722129783693,0.9800332778702163,0.5091514143094842,0.47088186356073214
066Z,06,6Z,0,553,12,541,254,287,inf,0.0216998191681736,0.9783001808318263,0.4593128390596745,0.5189873417721519
067A,06,7A,0,584,9,575,187,388,inf,0.015410958904109588,0.9845890410958904,0.3202054794520548,0.6643835616438356
067AA,06,7AA,0,409,10,399,185,214,inf,0.02444987775061125,0.9755501222493888,0.45232273838630804,0.5232273838630807
067B,06,7B,0,519,3,516,149,367,inf,0.005780346820809248,0.9942196531791907,0.28709055876685935,0.7071290944123314
067C,06,7C,0,444,6,438,171,267,inf,0.013513513513513514,0.9864864864864865,0.38513513513513514,0.6013513513513513
067D,06,7D,0,519,5,514,165,349,inf,0.009633911368015413,0.9903660886319846,0.3179190751445087,0.6724470134874759
067E,06,7E,0,531,7,524,227,297,inf,0.013182674199623353,0.9868173258003766,0.4274952919020716,0.559322033898305
067F,06,7F,0,661,14,647,203,444,inf,0.02118003025718608,0.9788199697428139,0.3071104387291982,0.6717095310136157
067G,06,7G,0,696,10,686,213,473,inf,0.014367816091954023,0.985632183908046,0.30603448275862066,0.6795977011494253
067H,06,7H,0,448,7,441,171,270,inf,0.015625,0.984375,0.38169642857142855,0.6026785714285714
067J,06,7J,0,516,1,515,182,333,inf,0.001937984496124031,0.998062015503876,0.35271317829457366,0.6453488372093024
067K,06,7K,0,501,5,496,190,306,inf,0.00998003992015968,0.9900199600798403,0.37924151696606784,0.6107784431137725
067L,06,7L,0,618,10,608,238,370,inf,0.016181229773462782,0.9838187702265372,0.3851132686084142,0.598705501618123
067M,06,7M,0,495,11,484,230,254,inf,0.022222222222222223,0.9777777777777777,0.46464646464646464,0.5131313131313131
067N,06,7N,0,594,5,589,190,399,inf,0.008417508417508417,0.9915824915824916,0.31986531986531985,0.6717171717171717
067P,06,7P,0,464,5,459,226,233,inf,0.010775862068965518,0.9892241379310345,0.4870689655172414,0.5021551724137931
067Q,06,7Q,0,483,3,480,177,303,inf,0.006211180124223602,0.9937888198757764,0.36645962732919257,0.6273291925465838
067R,06,7R,0,546,8,538,166,372,inf,0.014652014652014652,0.9853479853479854,0.304029304029304,0.6813186813186813
067S,06,7S,0,459,9,450,205,245,inf,0.0196078431372549,0.9803921568627451,0.4466230936819172,0.5337690631808278
067T,06,7T,0,570,9,561,206,355,inf,0.015789473684210527,0.9842105263157894,0.36140350877192984,0.6228070175438597
067U,06,7U,0,567,11,556,257,299,inf,0.019400352733686066,0.9805996472663139,0.4532627865961199,0.527336860670194
067V,06,7V,0,501,9,492,196,296,inf,0.017964071856287425,0.9820359281437125,0.3912175648702595,0.590818363273453
067W,06,7W,0,488,7,481,132,349,inf,0.014344262295081968,0.985655737704918,0.27049180327868855,0.7151639344262295
067X,06,7X,0,696,5,691,194,497,inf,0.007183908045977011,0.992816091954023,0.27873563218390807,0.7140804597701149
067Y,06,7Y,0,607,12,595,178,417,inf,0.019769357495881382,0.9802306425041186,0.2932454695222405,0.6869851729818781
067Z,06,7Z,0,456,12,444,244,200,inf,0.02631578947368421,0.9736842105263158,0.5350877192982456,0.43859649122807015
07101,07,101,1145,344,11,333,183,150,0.30043668122270745,0.03197674418604651,0.9680232558139535,0.5319767441860465,0.436046511627907
07102,07,102,1216,439,14,425,235,190,0.36101973684210525,0.03189066059225513,0.9681093394077449,0.5353075170842825,0.4328018223234624
07103,07,103,1104,434,18,416,213,203,0.39311594202898553,0.041474654377880185,0.9585253456221198,0.49078341013824883,0.46774193548387094
07104,07,104,1326,508,11,497,320,177,0.38310708898944196,0.021653543307086614,0.9783464566929134,0.6299212598425197,0.3484251968503937
07105,07,105,1190,441,9,432,299,133,0.37058823529411766,0.02040816326530612,0.9795918367346939,0.6780045351473923,0.30158730158730157
07106,07,106,1116,442,13,429,318,111,0.3960573476702509,0.029411764705882353,0.9705882352941176,0.7194570135746606,0.251131221719457
07107,07,107,1268,496,8,488,351,137,0.3911671924290221,0.016129032258064516,0.9838709677419355,0.7076612903225806,0.2762096774193548
07108,07,108,1226,509,13,496,372,124,0.41517128874388254,0.025540275049115914,0.9744597249508841,0.730844793713163,0.24361493123772102
07109,07,109,1002,392,16,376,245,131,0.3912175648702595,0.04081632653061224,0.9591836734693877,0.625,0.33418367346938777
07110,07,110,1237,517,9,508,338,170,0.417946645109135,0.017408123791102514,0.9825918762088974,0.6537717601547389,0.3288201160541586
07111,07,111,1225,470,9,461,291,170,0.3836734693877551,0.019148936170212766,0.9808510638297873,0.6191489361702127,0.3617021276595745
07112,07,112,1152,460,8,452,335,117,0.3993055555555556,0.017391304347826087,0.9826086956521739,0.7282608695652174,0.2543478260869565
07113,07,113,1237,513,15,498,296,202,0.4147130153597413,0.029239766081871343,0.9707602339181286,0.5769980506822612,0.3937621832358674
07114,07,114,1333,525,16,509,327,182,0.3938484621155289,0.030476190476190476,0.9695238095238096,0.6228571428571429,0.3466666666666667
07115,07,115,1124,395,10,385,256,129,0.351423487544484,0.02531645569620253,0.9746835443037974,0.6481012658227848,0.3265822784810127
07116,07,116,1104,410,10,400,252,148,0.3713768115942029,0.024390243902439025,0.975609756097561,0.6146341463414634,0.36097560975609755
07117,07,117,1160,424,10,414,221,193,0.36551724137931035,0.02358490566037736,0.9764150943396226,0.5212264150943396,0.455188679245283
07118,07,118,639,231,7,224,134,90,0.3615023474178404,0.030303030303030304,0.9696969696969697,0.5800865800865801,0.38961038961038963
07119,07,119,1153,378,26,352,231,121,0.32784041630529054,0.06878306878306878,0.9312169312169312,0.6111111111111112,0.3201058201058201
07120,07,120,1150,459,10,449,296,153,0.3991304347826087,0.02178649237472767,0.9782135076252724,0.644880174291939,0.3333333333333333
07121,07,121,1215,456,13,443,277,166,0.37530864197530867,0.02850877192982456,0.9714912280701754,0.6074561403508771,0.36403508771929827
07122,07,122,1324,477,22,455,237,218,0.36027190332326287,0.04612159329140461,0.9538784067085954,0.4968553459119497,0.4570230607966457
07123,07,123,1113,426,11,415,299,116,0.38274932614555257,0.025821596244131457,0.9741784037558685,0.7018779342723005,0.27230046948356806
07124,07,124,1166,468,18,450,319,131,0.4013722126929674,0.038461538461538464,0.9615384615384616,0.6816239316239316,0.2799145299145299
07125,07,125,1120,449,29,420,309,111,0.40089285714285716,0.0645879732739421,0.9354120267260579,0.688195991091314,0.24721603563474387
07126,07,126,1158,433,21,412,317,95,0.37392055267702934,0.04849884526558892,0.9515011547344111,0.7321016166281755,0.21939953810623555
07127,07,127,1154,439,24,415,325,90,0.3804159445407279,0.05466970387243736,0.9453302961275627,0.7403189066059226,0.20501138952164008
07128,07,128,1188,488,7,481,351,130,0.4107744107744108,0.014344262295081968,0.985655737704918,0.7192622950819673,0.26639344262295084
07129,07,129,1228,445,9,436,302,134,0.36237785016286644,0.020224719101123594,0.9797752808988764,0.6786516853932584,0.30112359550561796
07201,07,201,1226,465,8,457,273,184,0.3792822185970636,0.017204301075268817,0.9827956989247312,0.5870967741935483,0.3956989247311828
07202,07,202,1107,357,4,353,236,117,0.3224932249322493,0.011204481792717087,0.988795518207283,0.6610644257703081,0.3277310924369748
07203,07,203,1128,415,7,408,225,183,0.3679078014184397,0.016867469879518072,0.983132530120482,0.5421686746987951,0.44096385542168676
07204,07,204,1158,517,13,504,333,171,0.4464594127806563,0.025145067698259187,0.9748549323017408,0.6441005802707931,0.3307543520309478
07205,07,205,1363,578,14,564,396,168,0.42406456346294935,0.02422145328719723,0.9757785467128027,0.6851211072664359,0.2906574394463668
07206,07,206,1045,426,8,418,265,153,0.4076555023923445,0.018779342723004695,0.9812206572769953,0.6220657276995305,0.3591549295774648
07207,07,207,1254,454,14,440,265,175,0.3620414673046252,0.030837004405286344,0.9691629955947136,0.5837004405286343,0.3854625550660793
07208,07,208,1120,334,12,322,215,107,0.2982142857142857,0.03592814371257485,0.9640718562874252,0.6437125748502994,0.3203592814371258
07209,07,209,1009,372,5,367,236,131,0.3686818632309217,0.013440860215053764,0.9865591397849462,0.6344086021505376,0.3521505376344086
07210,07,210,1083,451,12,439,302,137,0.4164358264081256,0.026607538802660754,0.9733924611973392,0.6696230598669624,0.30376940133037694
07211,07,211,1129,463,14,449,316,133,0.41009743135518156,0.03023758099352052,0.9697624190064795,0.6825053995680346,0.28725701943844495
07212,07,212,1199,422,6,416,326,90,0.3519599666388657,0.014218009478672985,0.985781990521327,0.7725118483412322,0.2132701421800948
07213,07,213,1124,397,24,373,260,113,0.35320284697508897,0.060453400503778336,0.9395465994962217,0.654911838790932,0.28463476070528965
07214,07,214,1123,450,14,436,309,127,0.40071237756010686,0.03111111111111111,0.9688888888888889,0.6866666666666666,0.2822222222222222
07215,07,215,1113,459,17,442,336,106,0.4123989218328841,0.037037037037037035,0.9629629629629629,0.7320261437908496,0.23093681917211328
07216,07,216,1215,422,13,409,278,131,0.34732510288065843,0.030805687203791468,0.9691943127962085,0.6587677725118484,0.3104265402843602
07217,07,217,1227,471,10,461,328,133,0.38386308068459657,0.021231422505307854,0.9787685774946921,0.6963906581740976,0.2823779193205945
07218,07,218,1149,409,10,399,275,124,0.35596170583115755,0.02444987775061125,0.9755501222493888,0.6723716381418093,0.30317848410757947
07219,07,219,1006,399,14,385,295,90,0.3966202783300199,0.03508771929824561,0.9649122807017544,0.7393483709273183,0.22556390977443608
07220,07,220,1179,464,13,451,328,123,0.3935538592027142,0.028017241379310345,0.9719827586206896,0.7068965517241379,0.2650862068965517
07221,07,221,1044,420,14,406,288,118,0.40229885057471265,0.03333333333333333,0.9666666666666667,0.6857142857142857,0.28095238095238095
07222,07,222,1226,443,9,434,252,182,0.36133768352365414,0.020316027088036117,0.9796839729119639,0.5688487584650113,0.4108352144469526
07223,07,223,1079,401,15,386,275,111,0.3716404077849861,0.03740648379052369,0.9625935162094763,0.685785536159601,0.27680798004987534
07224,07,224,1560,584,12,572,425,147,0.37435897435897436,0.02054794520547945,0.9794520547945206,0.7277397260273972,0.2517123287671233
07225,07,225,1290,575,18,557,415,142,0.44573643410852715,0.03130434782608696,0.9686956521739131,0.7217391304347827,0.24695652173913044
07226,07,226,1111,428,13,415,279,136,0.3852385238523852,0.030373831775700934,0.969626168224299,0.6518691588785047,0.3177570093457944
07227,07,227,1102,389,7,382,287,95,0.352994555353902,0.017994858611825194,0.9820051413881749,0.7377892030848329,0.2442159383033419
07228,07,228,1173,457,8,449,339,110,0.3895993179880648,0.0175054704595186,0.9824945295404814,0.7417943107221007,0.24070021881838075
07301,07,301,1087,458,14,444,270,174,0.42134314627414904,0.03056768558951965,0.9694323144104804,0.5895196506550219,0.3799126637554585
07302,07,302,1177,476,11,465,265,200,0.40441801189464743,0.023109243697478993,0.976890756302521,0.5567226890756303,0.42016806722689076
07303,07,303,1178,521,14,507,300,207,0.44227504244482174,0.026871401151631478,0.9731285988483686,0.5758157389635317,0.39731285988483683
07304,07,304,1196,471,21,450,244,206,0.39381270903010035,0.044585987261146494,0.9554140127388535,0.5180467091295117,0.43736730360934184
07305,07,305,1089,414,11,403,213,190,0.38016528925619836,0.026570048309178744,0.9734299516908212,0.5144927536231884,0.45893719806763283
07306,07,306,1112,425,12,413,213,200,0.38219424460431656,0.02823529411764706,0.971764705882353,0.5011764705882353,0.47058823529411764
07307,07,307,1125,432,7,425,250,175,0.384,0.016203703703703703,0.9837962962962963,0.5787037037037037,0.4050925925925926
07308,07,308,1041,408,14,394,222,172,0.3919308357348703,0.03431372549019608,0.9656862745098039,0.5441176470588235,0.4215686274509804
07309,07,309,1117,490,18,472,268,204,0.4386750223813787,0.036734693877551024,0.963265306122449,0.5469387755102041,0.4163265306122449
07310,07,310,1129,465,12,453,237,216,0.41186891054030117,0.025806451612903226,0.9741935483870968,0.5096774193548387,0.4645161290322581
07311,07,311,1249,502,15,487,265,222,0.40192153722978385,0.029880478087649404,0.9701195219123506,0.5278884462151394,0.44223107569721115
07312,07,312,1124,437,7,430,253,177,0.3887900355871886,0.016018306636155607,0.9839816933638444,0.5789473684210527,0.40503432494279173
07313,07,313,1000,363,12,351,197,154,0.363,0.03305785123966942,0.9669421487603306,0.5426997245179064,0.42424242424242425
07314,07,314,1197,470,15,455,275,180,0.39264828738512947,0.031914893617021274,0.9680851063829787,0.5851063829787234,0.3829787234042553
07315,07,315,1115,416,8,408,211,197,0.37309417040358744,0.019230769230769232,0.9807692307692307,0.5072115384615384,0.4735576923076923
07316,07,316,1139,436,13,423,239,184,0.38279192273924495,0.02981651376146789,0.9701834862385321,0.5481651376146789,0.42201834862385323
07317,07,317,1185,465,14,451,277,174,0.3924050632911392,0.030107526881720432,0.9698924731182795,0.5956989247311828,0.3741935483870968
07318,07,318,1185,511,13,498,301,197,0.4312236286919831,0.025440313111545987,0.974559686888454,0.589041095890411,0.38551859099804303
07319,07,319,1190,438,11,427,229,198,0.3680672268907563,0.02511415525114155,0.9748858447488584,0.5228310502283106,0.4520547945205479
07320,07,320,1098,406,17,389,199,190,0.3697632058287796,0.04187192118226601,0.958128078817734,0.49014778325123154,0.46798029556650245
07321,07,321,1233,466,22,444,277,167,0.37793998377939986,0.04721030042918455,0.9527896995708155,0.5944206008583691,0.3583690987124464
07322,07,322,1089,491,17,474,327,147,0.4508723599632691,0.034623217922606926,0.9653767820773931,0.6659877800407332,0.29938900203665986
07323,07,323,1219,530,5,525,329,196,0.43478260869565216,0.009433962264150943,0.9905660377358491,0.620754716981132,0.36981132075471695
07324,07,324,1149,486,19,467,318,149,0.42297650130548303,0.03909465020576132,0.9609053497942387,0.654320987654321,0.3065843621399177
07325,07,325,1056,435,17,418,273,145,0.4119318181818182,0.03908045977011494,0.960919540229885,0.6275862068965518,0.3333333333333333
07326,07,326,1246,477,17,460,338,122,0.3828250401284109,0.03563941299790356,0.9643605870020965,0.7085953878406709,0.2557651991614256
07327,07,327,1194,502,26,476,294,182,0.4204355108877722,0.05179282868525897,0.9482071713147411,0.5856573705179283,0.36254980079681276
07328,07,328,1212,429,17,412,240,172,0.35396039603960394,0.039627039627039624,0.9603729603729604,0.5594405594405595,0.40093240093240096
07329,07,329,1267,375,11,364,164,200,0.2959747434885556,0.029333333333333333,0.9706666666666667,0.43733333333333335,0.5333333333333333
07401,07,401,1209,529,12,517,329,188,0.43755169561621177,0.022684310018903593,0.9773156899810964,0.6219281663516069,0.3553875236294896
07402,07,402,1105,416,17,399,238,161,0.3764705882352941,0.040865384615384616,0.9591346153846154,0.5721153846153846,0.3870192307692308
07403,07,403,1201,436,14,422,254,168,0.3630308076602831,0.03211009174311927,0.9678899082568807,0.5825688073394495,0.3853211009174312
07404,07,404,1223,478,13,465,303,162,0.39084219133278825,0.027196652719665274,0.9728033472803347,0.6338912133891214,0.3389121338912134
07405,07,405,1137,496,6,490,310,180,0.436235708003518,0.012096774193548387,0.9879032258064516,0.625,0.3629032258064516
07406,07,406,1174,486,16,470,271,199,0.41396933560477,0.03292181069958848,0.9670781893004116,0.5576131687242798,0.4094650205761317
07407,07,407,1134,416,10,406,241,165,0.36684303350970016,0.02403846153846154,0.9759615384615384,0.5793269230769231,0.39663461538461536
07408,07,408,1139,459,19,440,304,136,0.40298507462686567,0.04139433551198257,0.9586056644880174,0.6623093681917211,0.2962962962962963
07409,07,409,1219,397,19,378,223,155,0.32567678424938473,0.04785894206549118,0.9521410579345088,0.5617128463476071,0.3904282115869018
07410,07,410,1048,340,8,332,215,117,0.3244274809160305,0.023529411764705882,0.9764705882352941,0.6323529411764706,0.34411764705882353
07411,07,411,1124,373,12,361,218,143,0.3318505338078292,0.032171581769437,0.967828418230563,0.5844504021447721,0.38337801608579086
07412,07,412,1054,446,17,429,240,189,0.42314990512333966,0.03811659192825112,0.9618834080717489,0.5381165919282511,0.42376681614349776
07413,07,413,1228,448,24,424,256,168,0.36482084690553745,0.05357142857142857,0.9464285714285714,0.5714285714285714,0.375
07414,07,414,1066,369,14,355,197,158,0.34615384615384615,0.037940379403794036,0.962059620596206,0.5338753387533876,0.4281842818428184
07415,07,415,1126,345,15,330,175,155,0.3063943161634103,0.043478260869565216,0.9565217391304348,0.5072463768115942,0.4492753623188406
07416,07,416,1237,500,14,486,329,157,0.4042037186742118,0.028,0.972,0.658,0.314
07417,07,417,1109,432,8,424,241,183,0.38954012623985573,0.018518518518518517,0.9814814814814815,0.5578703703703703,0.4236111111111111
07418,07,418,1129,415,17,398,249,149,0.3675819309123118,0.04096385542168675,0.9590361445783132,0.6,0.35903614457831323
07419,07,419,1101,424,13,411,276,135,0.3851044504995459,0.030660377358490566,0.9693396226415094,0.6509433962264151,0.31839622641509435
07420,07,420,1124,453,9,444,280,164,0.4030249110320285,0.019867549668874173,0.9801324503311258,0.6181015452538632,0.3620309050772627
07421,07,421,1115,447,8,439,293,146,0.4008968609865471,0.017897091722595078,0.9821029082774049,0.6554809843400448,0.32662192393736017
07422,07,422,1243,522,15,507,341,166,0.41995172968624295,0.028735632183908046,0.9712643678160919,0.6532567049808429,0.31800766283524906
07423,07,423,1250,482,16,466,313,153,0.3856,0.03319502074688797,0.966804979253112,0.6493775933609959,0.31742738589211617
07424,07,424,1251,458,22,436,339,97,0.36610711430855314,0.048034934497816595,0.9519650655021834,0.740174672489083,0.21179039301310043
07425,07,425,1182,396,15,381,226,155,0.3350253807106599,0.03787878787878788,0.9621212121212122,0.5707070707070707,0.39141414141414144
07426,07,426,1204,451,13,438,273,165,0.3745847176079734,0.028824833702882482,0.9711751662971175,0.6053215077605322,0.36585365853658536
07427,07,427,1211,445,11,434,258,176,0.3674649050371594,0.024719101123595506,0.9752808988764045,0.5797752808988764,0.3955056179775281
07428,07,428,1157,432,15,417,260,157,0.37337942955920483,0.034722222222222224,0.9652777777777778,0.6018518518518519,0.36342592592592593
07501,07,501,1199,443,22,421,248,173,0.3694745621351126,0.04966139954853273,0.9503386004514672,0.5598194130925508,0.3905191873589165
07502,07,502,1268,471,15,456,257,199,0.3714511041009464,0.03184713375796178,0.9681528662420382,0.5456475583864119,0.42250530785562634
07503,07,503,1148,469,21,448,250,198,0.40853658536585363,0.04477611940298507,0.9552238805970149,0.5330490405117271,0.42217484008528783
07504,07,504,1203,483,21,462,259,203,0.4014962593516209,0.043478260869565216,0.9565217391304348,0.5362318840579711,0.42028985507246375
07505,07,505,1225,474,17,457,283,174,0.38693877551020406,0.035864978902953586,0.9641350210970464,0.5970464135021097,0.3670886075949367
07506,07,506,1131,421,22,399,225,174,0.372236958443855,0.052256532066508314,0.9477434679334917,0.5344418052256532,0.41330166270783847
07507,07,507,1214,473,22,451,235,216,0.3896210873146623,0.046511627906976744,0.9534883720930233,0.49682875264270615,0.45665961945031713
07508,07,508,1255,504,16,488,263,225,0.401593625498008,0.031746031746031744,0.9682539682539683,0.5218253968253969,0.44642857142857145
07509,07,509,1191,462,26,436,244,192,0.3879093198992443,0.05627705627705628,0.9437229437229437,0.5281385281385281,0.4155844155844156
07510,07,510,1147,388,20,368,210,158,0.33827375762859635,0.05154639175257732,0.9484536082474226,0.5412371134020618,0.4072164948453608
07511,07,511,1244,464,23,441,252,189,0.3729903536977492,0.04956896551724138,0.9504310344827587,0.5431034482758621,0.4073275862068966
07512,07,512,1099,451,17,434,249,185,0.4103730664240218,0.037694013303769404,0.9623059866962306,0.5521064301552107,0.41019955654101997
07513,07,513,1123,403,22,381,219,162,0.358860195903829,0.05459057071960298,0.9454094292803971,0.543424317617866,0.40198511166253104
07514,07,514,1192,333,13,320,192,128,0.27936241610738255,0.03903903903903904,0.960960960960961,0.5765765765765766,0.3843843843843844
07515,07,515,1264,422,12,410,250,160,0.3338607594936709,0.02843601895734597,0.9715639810426541,0.5924170616113744,0.3791469194312796
07516,07,516,1162,469,24,445,252,193,0.4036144578313253,0.0511727078891258,0.9488272921108742,0.5373134328358209,0.4115138592750533
07517,07,517,1248,486,24,462,254,208,0.3894230769230769,0.04938271604938271,0.9506172839506173,0.522633744855967,0.4279835390946502
07518,07,518,1093,402,25,377,196,181,0.3677950594693504,0.06218905472636816,0.9378109452736318,0.48756218905472637,0.4502487562189055
07519,07,519,1096,401,14,387,279,108,0.3658759124087591,0.034912718204488775,0.9650872817955112,0.6957605985037406,0.26932668329177056
07520,07,520,1039,397,15,382,277,105,0.38209817131857554,0.037783375314861464,0.9622166246851386,0.6977329974811083,0.26448362720403024
07521,07,521,1232,501,24,477,262,215,0.40665584415584416,0.04790419161676647,0.9520958083832335,0.5229540918163673,0.4291417165668663
07522,07,522,1273,467,10,457,242,215,0.36684996072270226,0.021413276231263382,0.9785867237687366,0.5182012847965739,0.4603854389721627
07523,07,523,1289,539,26,513,295,218,0.4181536074476338,0.04823747680890538,0.9517625231910947,0.5473098330241187,0.4044526901669759
07524,07,524,1073,433,13,420,240,180,0.40354147250698974,0.03002309468822171,0.9699769053117783,0.5542725173210161,0.41570438799076215
07525,07,525,1139,400,13,387,154,233,0.35118525021949076,0.0325,0.9675,0.385,0.5825
07526,07,526,1103,416,8,408,150,258,0.3771532184950136,0.019230769230769232,0.9807692307692307,0.3605769230769231,0.6201923076923077
07527,07,527,1187,344,20,324,152,172,0.2898062342038753,0.05813953488372093,0.9418604651162791,0.4418604651162791,0.5
07528,07,528,1006,381,15,366,143,223,0.378727634194831,0.03937007874015748,0.9606299212598425,0.3753280839895013,0.5853018372703412
07601,07,601,1184,401,34,367,188,179,0.33868243243243246,0.08478802992518704,0.9152119700748129,0.4688279301745636,0.4463840399002494
07602,07,602,1120,378,8,370,195,175,0.3375,0.021164021164021163,0.9788359788359788,0.5158730158730159,0.46296296296296297
07603,07,603,1281,547,16,531,317,214,0.4270101483216237,0.029250457038391225,0.9707495429616088,0.5795246800731262,0.3912248628884826
07604,07,604,994,425,17,408,282,126,0.4275653923541248,0.04,0.96,0.6635294117647059,0.2964705882352941
07605,07,605,1267,445,19,426,270,156,0.35122336227308604,0.04269662921348315,0.9573033707865168,0.6067415730337079,0.350561797752809
07606,07,606,1253,458,10,448,232,216,0.3655227454110136,0.021834061135371178,0.9781659388646288,0.5065502183406113,0.47161572052401746
07607,07,607,1125,381,25,356,195,161,0.33866666666666667,0.06561679790026247,0.9343832020997376,0.5118110236220472,0.4225721784776903
07608,07,608,1200,419,15,404,239,165,0.3491666666666667,0.03579952267303103,0.964200477326969,0.5704057279236276,0.3937947494033413
07609,07,609,1213,465,30,435,254,181,0.38334707337180546,0.06451612903225806,0.9354838709677419,0.546236559139785,0.38924731182795697
07610,07,610,1182,496,34,462,264,198,0.4196277495769882,0.06854838709677419,0.9314516129032258,0.532258064516129,0.39919354838709675
07611,07,611,1080,299,15,284,162,122,0.27685185185185185,0.05016722408026756,0.9498327759197325,0.5418060200668896,0.4080267558528428
07612,07,612,1248,490,17,473,216,257,0.3926282051282051,0.03469387755102041,0.9653061224489796,0.44081632653061226,0.5244897959183673
07613,07,613,1134,498,48,450,177,273,0.43915343915343913,0.0963855421686747,0.9036144578313253,0.35542168674698793,0.5481927710843374
07614,07,614,1184,400,38,362,236,126,0.33783783783783783,0.095,0.905,0.59,0.315
07615,07,615,1200,496,22,474,156,318,0.41333333333333333,0.04435483870967742,0.9556451612903226,0.31451612903225806,0.6411290322580645
07616,07,616,1202,392,18,374,146,228,0.3261231281198003,0.04591836734693878,0.9540816326530612,0.37244897959183676,0.5816326530612245
07617,07,617,1244,447,19,428,167,261,0.35932475884244375,0.042505592841163314,0.9574944071588367,0.37360178970917224,0.5838926174496645
07618,07,618,1148,449,35,414,249,165,0.3911149825783972,0.0779510022271715,0.9220489977728286,0.5545657015590201,0.3674832962138085
07619,07,619,1197,424,7,417,224,193,0.35421888053467,0.01650943396226415,0.9834905660377359,0.5283018867924528,0.455188679245283
07620,07,620,1182,472,29,443,200,243,0.3993231810490694,0.0614406779661017,0.9385593220338984,0.423728813559322,0.5148305084745762
07621,07,621,1104,448,6,442,128,314,0.4057971014492754,0.013392857142857142,0.9866071428571429,0.2857142857142857,0.7008928571428571
07622,07,622,1003,357,13,344,176,168,0.3559322033898305,0.036414565826330535,0.9635854341736695,0.49299719887955185,0.47058823529411764
07623,07,623,1197,482,16,466,228,238,0.40267335004177107,0.03319502074688797,0.966804979253112,0.4730290456431535,0.49377593360995853
07624,07,624,1094,392,17,375,165,210,0.3583180987202925,0.04336734693877551,0.9566326530612245,0.42091836734693877,0.5357142857142857
07625,07,625,1105,406,26,380,138,242,0.36742081447963804,0.06403940886699508,0.9359605911330049,0.3399014778325123,0.5960591133004927
07626,07,626,1169,391,11,380,151,229,0.33447390932420873,0.028132992327365727,0.9718670076726342,0.38618925831202044,0.5856777493606138
07627,07,627,597,253,14,239,78,161,0.423785594639866,0.05533596837944664,0.9446640316205533,0.308300395256917,0.6363636363636364
07628,07,628,1129,460,17,443,134,309,0.40744021257750224,0.03695652173913044,0.9630434782608696,0.29130434782608694,0.6717391304347826
07701,07,701,1178,443,19,424,126,298,0.3760611205432937,0.04288939051918736,0.9571106094808126,0.28442437923250563,0.672686230248307
07702,07,702,1080,456,24,432,166,266,0.4222222222222222,0.05263157894736842,0.9473684210526315,0.36403508771929827,0.5833333333333334
07703,07,703,1143,460,14,446,178,268,0.40244969378827644,0.030434782608695653,0.9695652173913043,0.3869565217391304,0.5826086956521739
07704,07,704,1184,491,19,472,189,283,0.41469594594594594,0.038696537678207736,0.9613034623217923,0.384928716904277,0.5763747454175153
07705,07,705,1307,559,30,529,235,294,0.42769701606732974,0.05366726296958855,0.9463327370304114,0.4203935599284436,0.5259391771019678
07706,07,706,1248,516,33,483,269,214,0.41346153846153844,0.06395348837209303,0.936046511627907,0.5213178294573644,0.41472868217054265
07707,07,707,1273,466,23,443,263,180,0.36606441476826396,0.04935622317596566,0.9506437768240343,0.5643776824034334,0.38626609442060084
07708,07,708,1179,395,29,366,190,176,0.33502968617472434,0.07341772151898734,0.9265822784810127,0.4810126582278481,0.44556962025316454
07709,07,709,1234,476,16,460,237,223,0.3857374392220421,0.03361344537815126,0.9663865546218487,0.49789915966386555,0.4684873949579832
07710,07,710,1155,518,22,496,180,316,0.4484848484848485,0.04247104247104247,0.9575289575289575,0.3474903474903475,0.61003861003861
07711,07,711,1145,443,17,426,218,208,0.3868995633187773,0.03837471783295711,0.9616252821670429,0.49209932279909707,0.46952595936794583
07712,07,712,1120,512,12,500,142,358,0.45714285714285713,0.0234375,0.9765625,0.27734375,0.69921875
07713,07,713,1290,546,22,524,166,358,0.4232558139534884,0.040293040293040296,0.9597069597069597,0.304029304029304,0.6556776556776557
07714,07,714,1176,486,32,454,247,207,0.413265306122449,0.06584362139917696,0.934156378600823,0.5082304526748971,0.42592592592592593
07715,07,715,1184,511,10,501,170,331,0.43158783783783783,0.019569471624266144,0.9804305283757339,0.33268101761252444,0.6477495107632094
07716,07,716,1181,507,11,496,187,309,0.42929720575783237,0.021696252465483234,0.9783037475345168,0.368836291913215,0.6094674556213018
07717,07,717,1170,452,13,439,207,232,0.38632478632478634,0.028761061946902654,0.9712389380530974,0.4579646017699115,0.5132743362831859
07718,07,718,1105,453,24,429,216,213,0.4099547511312217,0.052980132450331126,0.9470198675496688,0.4768211920529801,0.47019867549668876
07719,07,719,1207,415,12,403,166,237,0.34382767191383595,0.02891566265060241,0.9710843373493976,0.4,0.5710843373493976
07720,07,720,1173,477,11,466,209,257,0.40664961636828645,0.023060796645702306,0.9769392033542977,0.4381551362683438,0.5387840670859538
07721,07,721,1123,427,32,395,157,238,0.38023152270703475,0.07494145199063232,0.9250585480093677,0.36768149882903983,0.5573770491803278
07722,07,722,1140,431,8,423,245,178,0.3780701754385965,0.018561484918793503,0.9814385150812065,0.568445475638051,0.41299303944315546
07723,07,723,1223,461,9,452,222,230,0.3769419460343418,0.019522776572668113,0.9804772234273319,0.48156182212581344,0.49891540130151846
07724,07,724,1139,394,14,380,241,139,0.34591747146619845,0.03553299492385787,0.9644670050761421,0.6116751269035533,0.35279187817258884
07725,07,725,1073,359,25,334,209,125,0.33457595526561046,0.06963788300835655,0.9303621169916435,0.5821727019498607,0.34818941504178275
07726,07,726,1155,423,17,406,164,242,0.36623376623376624,0.04018912529550828,0.9598108747044918,0.3877068557919622,0.5721040189125296
07727,07,727,977,361,11,350,133,217,0.3694984646878199,0.030470914127423823,0.9695290858725761,0.3684210526315789,0.6011080332409973
07728,07,728,951,342,12,330,108,222,0.35962145110410093,0.03508771929824561,0.9649122807017544,0.3157894736842105,0.6491228070175439
071A,07,1A,0,642,12,630,339,291,inf,0.018691588785046728,0.9813084112149533,0.5280373831775701,0.4532710280373832
071B,07,1B,0,582,11,571,276,295,inf,0.018900343642611683,0.9810996563573883,0.4742268041237113,0.506872852233677
071C,07,1C,0,625,7,618,348,270,inf,0.0112,0.9888,0.5568,0.432
071D,07,1D,0,612,12,600,387,213,inf,0.0196078431372549,0.9803921568627451,0.6323529411764706,0.3480392156862745
071E,07,1E,0,596,1,595,372,223,inf,0.0016778523489932886,0.9983221476510067,0.6241610738255033,0.37416107382550334
071F,07,1F,0,631,6,625,451,174,inf,0.009508716323296355,0.9904912836767037,0.7147385103011094,0.2757527733755943
071G,07,1G,0,682,7,675,426,249,inf,0.010263929618768328,0.9897360703812317,0.624633431085044,0.3651026392961877
071H,07,1H,0,631,8,623,392,231,inf,0.012678288431061807,0.9873217115689382,0.6212361331220285,0.36608557844690964
071I,07,1I,0,627,4,623,364,259,inf,0.006379585326953748,0.9936204146730463,0.580542264752791,0.4130781499202552
071K,07,1K,0,634,6,628,409,219,inf,0.00946372239747634,0.9905362776025236,0.6451104100946372,0.34542586750788645
071L,07,1L,0,643,3,640,379,261,inf,0.004665629860031105,0.995334370139969,0.5894245723172629,0.4059097978227061
071M,07,1M,0,615,12,603,349,254,inf,0.01951219512195122,0.9804878048780488,0.567479674796748,0.41300813008130083
071N,07,1N,0,677,7,670,368,302,inf,0.0103397341211226,0.9896602658788775,0.5435745937961596,0.4460856720827179
071P,07,1P,0,659,9,650,375,275,inf,0.013657056145675266,0.9863429438543247,0.5690440060698028,0.417298937784522
071R,07,1R,0,647,8,639,356,283,inf,0.012364760432766615,0.9876352395672334,0.5502318392581144,0.437403400309119
071S,07,1S,0,595,7,588,335,253,inf,0.011764705882352941,0.9882352941176471,0.5630252100840336,0.42521008403361343
071T,07,1T,0,635,7,628,400,228,inf,0.011023622047244094,0.988976377952756,0.6299212598425197,0.3590551181102362
071U,07,1U,0,650,10,640,433,207,inf,0.015384615384615385,0.9846153846153847,0.6661538461538462,0.31846153846153846
071V,07,1V,0,666,4,662,479,183,inf,0.006006006006006006,0.993993993993994,0.7192192192192193,0.2747747747747748
071W,07,1W,0,618,8,610,449,161,inf,0.012944983818770227,0.9870550161812298,0.7265372168284789,0.2605177993527508
072A,07,2A,0,697,13,684,365,319,inf,0.018651362984218076,0.9813486370157819,0.5236728837876614,0.45767575322812054
072B,07,2B,0,676,10,666,413,253,inf,0.014792899408284023,0.985207100591716,0.6109467455621301,0.3742603550295858
072C,07,2C,0,936,10,926,589,337,inf,0.010683760683760684,0.9893162393162394,0.6292735042735043,0.36004273504273504
072D,07,2D,0,642,4,638,377,261,inf,0.006230529595015576,0.9937694704049844,0.5872274143302181,0.40654205607476634
072E,07,2E,0,621,8,613,368,245,inf,0.01288244766505636,0.9871175523349437,0.5925925925925926,0.394524959742351
072F,07,2F,0,705,7,698,452,246,inf,0.009929078014184398,0.9900709219858156,0.6411347517730497,0.34893617021276596
072G,07,2G,0,663,8,655,380,275,inf,0.012066365007541479,0.9879336349924586,0.5731523378582202,0.41478129713423834
072H,07,2H,0,641,20,621,442,179,inf,0.031201248049921998,0.968798751950078,0.6895475819032761,0.2792511700468019
072I,07,2I,0,843,12,831,546,285,inf,0.014234875444839857,0.9857651245551602,0.6476868327402135,0.33807829181494664
072K,07,2K,0,655,8,647,447,200,inf,0.012213740458015267,0.9877862595419847,0.6824427480916031,0.3053435114503817
072L,07,2L,0,469,3,466,332,134,inf,0.006396588486140725,0.9936034115138592,0.7078891257995735,0.2857142857142857
072M,07,2M,0,648,4,644,474,170,inf,0.006172839506172839,0.9938271604938271,0.7314814814814815,0.2623456790123457
072N,07,2N,0,670,12,658,484,174,inf,0.01791044776119403,0.982089552238806,0.7223880597014926,0.25970149253731345
072P,07,2P,0,655,6,649,489,160,inf,0.00916030534351145,0.9908396946564886,0.7465648854961832,0.24427480916030533
072R,07,2R,0,648,8,640,398,242,inf,0.012345679012345678,0.9876543209876543,0.6141975308641975,0.3734567901234568
072S,07,2S,0,654,10,644,431,213,inf,0.01529051987767584,0.9847094801223242,0.6590214067278287,0.3256880733944954
072T,07,2T,0,689,4,685,501,184,inf,0.005805515239477504,0.9941944847605225,0.7271407837445574,0.26705370101596515
072U,07,2U,0,590,6,584,410,174,inf,0.010169491525423728,0.9898305084745763,0.6949152542372882,0.29491525423728815
072V,07,2V,0,639,5,634,467,167,inf,0.00782472613458529,0.9921752738654147,0.730829420970266,0.26134585289514867
073A,07,3A,0,668,6,662,374,288,inf,0.008982035928143712,0.9910179640718563,0.5598802395209581,0.4311377245508982
073B,07,3B,0,609,12,597,330,267,inf,0.019704433497536946,0.9802955665024631,0.541871921182266,0.43842364532019706
073C,07,3C,0,632,9,623,339,284,inf,0.014240506329113924,0.9857594936708861,0.5363924050632911,0.44936708860759494
073D,07,3D,0,663,8,655,324,331,inf,0.012066365007541479,0.9879336349924586,0.48868778280542985,0.49924585218702866
073E,07,3E,0,607,7,600,361,239,inf,0.011532125205930808,0.9884678747940692,0.5947281713344317,0.39373970345963755
073F,07,3F,0,640,12,628,348,280,inf,0.01875,0.98125,0.54375,0.4375
073G,07,3G,0,582,9,573,338,235,inf,0.015463917525773196,0.9845360824742269,0.5807560137457045,0.40378006872852235
073H,07,3H,0,587,15,572,286,286,inf,0.02555366269165247,0.9744463373083475,0.48722316865417375,0.48722316865417375
073I,07,3I,0,689,8,681,361,320,inf,0.011611030478955007,0.988388969521045,0.5239477503628447,0.4644412191582003
073K,07,3K,0,603,5,598,329,269,inf,0.008291873963515755,0.9917081260364843,0.5456053067993366,0.4461028192371476
073L,07,3L,0,622,11,611,336,275,inf,0.017684887459807074,0.9823151125401929,0.5401929260450161,0.44212218649517687
073M,07,3M,0,744,3,741,409,332,inf,0.004032258064516129,0.9959677419354839,0.5497311827956989,0.44623655913978494
073N,07,3N,0,640,8,632,357,275,inf,0.0125,0.9875,0.5578125,0.4296875
073P,07,3P,0,630,10,620,377,243,inf,0.015873015873015872,0.9841269841269841,0.5984126984126984,0.38571428571428573
073R,07,3R,0,579,4,575,361,214,inf,0.0069084628670120895,0.9930915371329879,0.6234887737478411,0.3696027633851468
073S,07,3S,0,629,9,620,333,287,inf,0.014308426073131956,0.985691573926868,0.5294117647058824,0.4562798092209857
073T,07,3T,0,607,10,597,369,228,inf,0.016474464579901153,0.9835255354200988,0.6079077429983526,0.3756177924217463
073U,07,3U,0,671,14,657,402,255,inf,0.020864381520119227,0.9791356184798807,0.5991058122205664,0.38002980625931443
073V,07,3V,0,616,7,609,393,216,inf,0.011363636363636364,0.9886363636363636,0.637987012987013,0.35064935064935066
073W,07,3W,0,642,6,636,395,241,inf,0.009345794392523364,0.9906542056074766,0.6152647975077882,0.37538940809968846
073X,07,3X,0,619,12,607,302,305,inf,0.01938610662358643,0.9806138933764136,0.4878836833602585,0.4927302100161551
073Y,07,3Y,0,626,6,620,268,352,inf,0.009584664536741214,0.9904153354632588,0.4281150159744409,0.5623003194888179
074A,07,4A,0,608,9,599,334,265,inf,0.014802631578947368,0.9851973684210527,0.5493421052631579,0.43585526315789475
074B,07,4B,0,638,16,622,354,268,inf,0.025078369905956112,0.9749216300940439,0.554858934169279,0.4200626959247649
074C,07,4C,0,642,4,638,377,261,inf,0.006230529595015576,0.9937694704049844,0.5872274143302181,0.40654205607476634
074D,07,4D,0,626,12,614,324,290,inf,0.019169329073482427,0.9808306709265175,0.5175718849840255,0.46325878594249204
074E,07,4E,0,624,12,612,354,258,inf,0.019230769230769232,0.9807692307692307,0.5673076923076923,0.41346153846153844
074F,07,4F,0,733,15,718,426,292,inf,0.020463847203274217,0.9795361527967258,0.5811732605729877,0.39836289222373805
074G,07,4G,0,644,10,634,361,273,inf,0.015527950310559006,0.984472049689441,0.5605590062111802,0.42391304347826086
074H,07,4H,0,647,8,639,372,267,inf,0.012364760432766615,0.9876352395672334,0.5749613601236476,0.4126738794435858
074I,07,4I,0,889,23,866,428,438,inf,0.025871766029246346,0.9741282339707537,0.4814398200224972,0.49268841394825647
074K,07,4K,0,400,6,394,267,127,inf,0.015,0.985,0.6675,0.3175
074L,07,4L,0,482,9,473,295,178,inf,0.01867219917012448,0.9813278008298755,0.6120331950207469,0.36929460580912865
074M,07,4M,0,577,9,568,290,278,inf,0.01559792027729636,0.9844020797227037,0.5025996533795494,0.48180242634315423
074N,07,4N,0,635,10,625,350,275,inf,0.015748031496062992,0.984251968503937,0.5511811023622047,0.4330708661417323
074P,07,4P,0,652,9,643,406,237,inf,0.013803680981595092,0.9861963190184049,0.6226993865030674,0.36349693251533743
074R,07,4R,0,616,10,606,387,219,inf,0.016233766233766232,0.9837662337662337,0.6282467532467533,0.3555194805194805
074S,07,4S,0,689,11,678,456,222,inf,0.015965166908563134,0.9840348330914369,0.6618287373004355,0.32220609579100146
074T,07,4T,0,655,14,641,393,248,inf,0.021374045801526718,0.9786259541984733,0.6,0.3786259541984733
074U,07,4U,0,607,12,595,350,245,inf,0.019769357495881382,0.9802306425041186,0.5766062602965404,0.40362438220757824
074V,07,4V,0,572,10,562,335,227,inf,0.017482517482517484,0.9825174825174825,0.5856643356643356,0.3968531468531469
075A,07,5A,0,639,5,634,300,334,inf,0.00782472613458529,0.9921752738654147,0.4694835680751174,0.5226917057902973
075B,07,5B,0,524,7,517,266,251,inf,0.013358778625954198,0.9866412213740458,0.5076335877862596,0.47900763358778625
075C,07,5C,0,624,15,609,326,283,inf,0.02403846153846154,0.9759615384615384,0.5224358974358975,0.453525641025641
075D,07,5D,0,654,12,642,379,263,inf,0.01834862385321101,0.981651376146789,0.5795107033639144,0.40214067278287463
075E,07,5E,0,586,9,577,314,263,inf,0.015358361774744027,0.984641638225256,0.5358361774744027,0.44880546075085326
075F,07,5F,0,606,14,592,286,306,inf,0.0231023102310231,0.976897689768977,0.47194719471947194,0.504950495049505
075G,07,5G,0,623,8,615,328,287,inf,0.012841091492776886,0.9871589085072231,0.5264847512038523,0.4606741573033708
075H,07,5H,0,589,11,578,277,301,inf,0.01867572156196944,0.9813242784380306,0.4702886247877759,0.5110356536502547
075I,07,5I,0,595,15,580,288,292,inf,0.025210084033613446,0.9747899159663865,0.48403361344537815,0.4907563025210084
075K,07,5K,0,688,11,677,342,335,inf,0.015988372093023256,0.9840116279069767,0.49709302325581395,0.48691860465116277
075L,07,5L,0,607,9,598,277,321,inf,0.014827018121911038,0.985172981878089,0.45634266886326197,0.528830313014827
075M,07,5M,0,623,11,612,431,181,inf,0.01765650080256822,0.9823434991974318,0.6918138041733547,0.29052969502407705
075N,07,5N,0,613,8,605,294,311,inf,0.013050570962479609,0.9869494290375204,0.4796084828711256,0.5073409461663948
075P,07,5P,0,589,10,579,291,288,inf,0.01697792869269949,0.9830220713073005,0.4940577249575552,0.48896434634974534
075R,07,5R,0,633,15,618,289,329,inf,0.023696682464454975,0.976303317535545,0.4565560821484992,0.5197472353870458
075S,07,5S,0,620,8,612,243,369,inf,0.012903225806451613,0.9870967741935484,0.3919354838709677,0.5951612903225807
075T,07,5T,0,682,17,665,255,410,inf,0.024926686217008796,0.9750733137829912,0.37390029325513197,0.6011730205278593
076A,07,6A,0,590,15,575,217,358,inf,0.025423728813559324,0.9745762711864406,0.3677966101694915,0.6067796610169491
076B,07,6B,0,644,20,624,266,358,inf,0.031055900621118012,0.968944099378882,0.41304347826086957,0.5559006211180124
076C,07,6C,0,547,12,535,311,224,inf,0.021937842778793418,0.9780621572212066,0.5685557586837294,0.40950639853747717
076D,07,6D,0,570,8,562,256,306,inf,0.014035087719298246,0.9859649122807017,0.44912280701754387,0.5368421052631579
076E,07,6E,0,584,4,580,242,338,inf,0.00684931506849315,0.9931506849315068,0.4143835616438356,0.5787671232876712
076F,07,6F,0,629,16,613,320,293,inf,0.025437201907790145,0.9745627980922098,0.5087440381558028,0.465818759936407
076G,07,6G,0,616,11,605,310,295,inf,0.017857142857142856,0.9821428571428571,0.5032467532467533,0.4788961038961039
076H,07,6H,0,564,9,555,287,268,inf,0.015957446808510637,0.9840425531914894,0.5088652482269503,0.475177304964539
076I,07,6I,0,760,9,751,323,428,inf,0.011842105263157895,0.9881578947368421,0.425,0.5631578947368421
076K,07,6K,0,523,10,513,164,349,inf,0.019120458891013385,0.9808795411089866,0.3135755258126195,0.6673040152963671
076L,07,6L,0,611,10,601,236,365,inf,0.016366612111292964,0.983633387888707,0.3862520458265139,0.5973813420621932
076M,07,6M,0,562,2,560,208,352,inf,0.0035587188612099642,0.99644128113879,0.3701067615658363,0.6263345195729537
076N,07,6N,0,629,14,615,314,301,inf,0.022257551669316374,0.9777424483306836,0.49920508744038156,0.4785373608903021
076P,07,6P,0,616,20,596,223,373,inf,0.032467532467532464,0.9675324675324676,0.362012987012987,0.6055194805194806
076R,07,6R,0,649,10,639,189,450,inf,0.015408320493066256,0.9845916795069337,0.29121725731895226,0.6933744221879815
076S,07,6S,0,609,5,604,254,350,inf,0.008210180623973728,0.9917898193760263,0.41707717569786534,0.5747126436781609
076T,07,6T,0,600,10,590,219,371,inf,0.016666666666666666,0.9833333333333333,0.365,0.6183333333333333
076U,07,6U,0,604,9,595,237,358,inf,0.014900662251655629,0.9850993377483444,0.3923841059602649,0.5927152317880795
077A,07,7A,0,590,5,585,178,407,inf,0.00847457627118644,0.9915254237288136,0.3016949152542373,0.6898305084745763
077B,07,7B,0,527,8,519,209,310,inf,0.015180265654648957,0.9848197343453511,0.396584440227704,0.5882352941176471
077C,07,7C,0,558,4,554,227,327,inf,0.007168458781362007,0.992831541218638,0.4068100358422939,0.5860215053763441
077D,07,7D,0,644,7,637,198,439,inf,0.010869565217391304,0.9891304347826086,0.30745341614906835,0.6816770186335404
077E,07,7E,0,613,12,601,349,252,inf,0.01957585644371941,0.9804241435562806,0.5693311582381729,0.4110929853181077
077F,07,7F,0,609,9,600,250,350,inf,0.014778325123152709,0.9852216748768473,0.41050903119868637,0.5747126436781609
077G,07,7G,0,617,12,605,196,409,inf,0.019448946515397084,0.9805510534846029,0.31766612641815234,0.6628849270664505
077H,07,7H,0,589,12,577,231,346,inf,0.02037351443123939,0.9796264855687606,0.3921901528013582,0.5874363327674024
077I,07,7I,0,857,9,848,261,587,inf,0.010501750291715286,0.9894982497082847,0.3045507584597433,0.6849474912485414
077K,07,7K,0,612,18,594,195,399,inf,0.029411764705882353,0.9705882352941176,0.31862745098039214,0.6519607843137255
077L,07,7L,0,298,3,295,143,152,inf,0.010067114093959731,0.9899328859060402,0.4798657718120805,0.5100671140939598
077M,07,7M,0,559,10,549,171,378,inf,0.017889087656529516,0.9821109123434705,0.30590339892665475,0.6762075134168157
077N,07,7N,0,572,4,568,195,373,inf,0.006993006993006993,0.993006993006993,0.3409090909090909,0.6520979020979021
077P,07,7P,0,630,9,621,286,335,inf,0.014285714285714285,0.9857142857142858,0.45396825396825397,0.5317460317460317
077R,07,7R,0,644,12,632,273,359,inf,0.018633540372670808,0.9813664596273292,0.42391304347826086,0.5574534161490683
077S,07,7S,0,618,7,611,244,367,inf,0.011326860841423949,0.988673139158576,0.3948220064724919,0.5938511326860841
077T,07,7T,0,638,10,628,258,370,inf,0.01567398119122257,0.9843260188087775,0.4043887147335423,0.5799373040752351
077U,07,7U,0,660,10,650,290,360,inf,0.015151515151515152,0.9848484848484849,0.4393939393939394,0.5454545454545454
077V,07,7V,0,610,8,602,172,430,inf,0.013114754098360656,0.9868852459016394,0.2819672131147541,0.7049180327868853
08101,08,101,1033,362,8,354,285,69,0.3504356243949661,0.022099447513812154,0.9779005524861878,0.787292817679558,0.19060773480662985
08102,08,102,1079,405,9,396,331,65,0.3753475440222428,0.022222222222222223,0.9777777777777777,0.817283950617284,0.16049382716049382
08103,08,103,1040,369,9,360,302,58,0.3548076923076923,0.024390243902439025,0.975609756097561,0.8184281842818428,0.15718157181571815
08104,08,104,1029,369,8,361,317,44,0.358600583090379,0.02168021680216802,0.978319783197832,0.8590785907859079,0.11924119241192412
08105,08,105,1045,394,11,383,330,53,0.3770334928229665,0.027918781725888325,0.9720812182741116,0.8375634517766497,0.13451776649746192
08106,08,106,1036,430,7,423,338,85,0.41505791505791506,0.01627906976744186,0.9837209302325581,0.786046511627907,0.19767441860465115
08107,08,107,1060,436,7,429,368,61,0.41132075471698115,0.016055045871559634,0.9839449541284404,0.8440366972477065,0.13990825688073394
08108,08,108,982,355,8,347,291,56,0.3615071283095723,0.022535211267605635,0.9774647887323944,0.819718309859155,0.15774647887323945
08109,08,109,1036,396,5,391,337,54,0.38223938223938225,0.012626262626262626,0.9873737373737373,0.851010101010101,0.13636363636363635
08110,08,110,1014,425,14,411,330,81,0.41913214990138065,0.03294117647058824,0.9670588235294117,0.7764705882352941,0.19058823529411764
08111,08,111,979,388,11,377,313,64,0.39632277834525026,0.028350515463917526,0.9716494845360825,0.8067010309278351,0.16494845360824742
08112,08,112,1148,383,15,368,301,67,0.3336236933797909,0.0391644908616188,0.9608355091383812,0.7859007832898173,0.17493472584856398
08113,08,113,1061,434,9,425,351,74,0.40904806786050896,0.020737327188940093,0.9792626728110599,0.8087557603686636,0.17050691244239632
08114,08,114,994,340,4,336,289,47,0.3420523138832998,0.011764705882352941,0.9882352941176471,0.85,0.13823529411764707
08115,08,115,990,417,9,408,347,61,0.4212121212121212,0.02158273381294964,0.9784172661870504,0.8321342925659473,0.14628297362110312
08116,08,116,1140,384,11,373,322,51,0.3368421052631579,0.028645833333333332,0.9713541666666666,0.8385416666666666,0.1328125
08117,08,117,1072,422,13,409,340,69,0.39365671641791045,0.030805687203791468,0.9691943127962085,0.8056872037914692,0.16350710900473933
08118,08,118,988,372,8,364,287,77,0.3765182186234818,0.021505376344086023,0.978494623655914,0.771505376344086,0.20698924731182797
08119,08,119,1089,410,9,401,333,68,0.37649219467401285,0.02195121951219512,0.9780487804878049,0.8121951219512196,0.16585365853658537
08120,08,120,1057,434,5,429,357,72,0.4105960264900662,0.01152073732718894,0.988479262672811,0.8225806451612904,0.16589861751152074
08121,08,121,1126,384,4,380,302,78,0.3410301953818828,0.010416666666666666,0.9895833333333334,0.7864583333333334,0.203125
08122,08,122,901,370,12,358,287,71,0.41065482796892344,0.032432432432432434,0.9675675675675676,0.7756756756756756,0.1918918918918919
08123,08,123,1074,388,6,382,242,140,0.3612662942271881,0.015463917525773196,0.9845360824742269,0.6237113402061856,0.36082474226804123
08124,08,124,937,412,7,405,350,55,0.439701173959445,0.01699029126213592,0.9830097087378641,0.8495145631067961,0.13349514563106796
08125,08,125,1072,379,10,369,266,103,0.353544776119403,0.026385224274406333,0.9736147757255936,0.7018469656992085,0.2717678100263852
08126,08,126,929,372,8,364,296,68,0.40043057050592035,0.021505376344086023,0.978494623655914,0.7956989247311828,0.1827956989247312
08127,08,127,1134,397,9,388,298,90,0.35008818342151676,0.022670025188916875,0.9773299748110831,0.7506297229219143,0.22670025188916876
08128,08,128,932,345,5,340,288,52,0.3701716738197425,0.014492753623188406,0.9855072463768116,0.8347826086956521,0.15072463768115943
08129,08,129,996,391,13,378,314,64,0.392570281124498,0.03324808184143223,0.9667519181585678,0.80306905370844,0.1636828644501279
08130,08,130,1006,392,15,377,314,63,0.38966202783300197,0.03826530612244898,0.9617346938775511,0.8010204081632653,0.16071428571428573
08131,08,131,799,251,4,247,196,51,0.3141426783479349,0.01593625498007968,0.9840637450199203,0.7808764940239044,0.20318725099601595
08201,08,201,1155,426,12,414,317,97,0.36883116883116884,0.028169014084507043,0.971830985915493,0.744131455399061,0.22769953051643194
08202,08,202,1070,443,14,429,358,71,0.41401869158878507,0.03160270880361174,0.9683972911963883,0.8081264108352144,0.16027088036117382
08203,08,203,904,368,10,358,298,60,0.40707964601769914,0.02717391304347826,0.9728260869565217,0.8097826086956522,0.16304347826086957
08204,08,204,1015,411,9,402,347,55,0.40492610837438425,0.021897810218978103,0.9781021897810219,0.8442822384428224,0.13381995133819952
08205,08,205,1029,372,11,361,313,48,0.36151603498542273,0.02956989247311828,0.9704301075268817,0.8413978494623656,0.12903225806451613
08206,08,206,1040,374,13,361,301,60,0.3596153846153846,0.034759358288770054,0.9652406417112299,0.8048128342245989,0.16042780748663102
08207,08,207,1005,355,4,351,307,44,0.35323383084577115,0.011267605633802818,0.9887323943661972,0.8647887323943662,0.12394366197183099
08208,08,208,995,332,7,325,273,52,0.3336683417085427,0.02108433734939759,0.9789156626506024,0.822289156626506,0.1566265060240964
08209,08,209,951,319,7,312,263,49,0.33543638275499477,0.0219435736677116,0.9780564263322884,0.8244514106583072,0.1536050156739812
08210,08,210,1003,346,8,338,262,76,0.34496510468594216,0.023121387283236993,0.976878612716763,0.7572254335260116,0.21965317919075145
08211,08,211,1052,385,14,371,295,76,0.3659695817490494,0.03636363636363636,0.9636363636363636,0.7662337662337663,0.1974025974025974
08212,08,212,1083,412,7,405,351,54,0.3804247460757156,0.01699029126213592,0.9830097087378641,0.8519417475728155,0.13106796116504854
08213,08,213,1097,413,9,404,349,55,0.3764813126709207,0.021791767554479417,0.9782082324455206,0.8450363196125908,0.13317191283292978
08214,08,214,1028,413,4,409,340,69,0.40175097276264593,0.009685230024213076,0.9903147699757869,0.8232445520581114,0.16707021791767554
08215,08,215,990,430,11,419,342,77,0.43434343434343436,0.02558139534883721,0.9744186046511628,0.7953488372093023,0.17906976744186046
08216,08,216,1048,440,8,432,359,73,0.4198473282442748,0.01818181818181818,0.9818181818181818,0.8159090909090909,0.16590909090909092
08217,08,217,1079,449,13,436,382,54,0.4161260426320667,0.028953229398663696,0.9710467706013363,0.8507795100222717,0.12026726057906459
08218,08,218,1048,440,12,428,360,68,0.4198473282442748,0.02727272727272727,0.9727272727272728,0.8181818181818182,0.15454545454545454
08219,08,219,1032,413,11,402,317,85,0.4001937984496124,0.026634382566585957,0.9733656174334141,0.7675544794188862,0.20581113801452786
08220,08,220,1096,404,9,395,330,65,0.3686131386861314,0.022277227722772276,0.9777227722772277,0.8168316831683168,0.1608910891089109
08221,08,221,1063,397,4,393,314,79,0.37347130761994357,0.010075566750629723,0.9899244332493703,0.7909319899244333,0.19899244332493704
08222,08,222,1033,354,13,341,290,51,0.3426911907066796,0.03672316384180791,0.963276836158192,0.8192090395480226,0.1440677966101695
08223,08,223,1057,348,27,321,262,59,0.32923368022705773,0.07758620689655173,0.9224137931034483,0.7528735632183908,0.16954022988505746
08224,08,224,1143,472,18,454,371,83,0.41294838145231844,0.038135593220338986,0.961864406779661,0.7860169491525424,0.17584745762711865
08225,08,225,1030,406,16,390,316,74,0.3941747572815534,0.03940886699507389,0.9605911330049262,0.7783251231527094,0.18226600985221675
08226,08,226,986,395,10,385,331,54,0.40060851926977686,0.02531645569620253,0.9746835443037974,0.8379746835443038,0.13670886075949368
08227,08,227,1009,419,6,413,333,80,0.41526263627353815,0.014319809069212411,0.9856801909307876,0.7947494033412887,0.1909307875894988
08228,08,228,897,325,4,321,266,55,0.36231884057971014,0.012307692307692308,0.9876923076923076,0.8184615384615385,0.16923076923076924
08229,08,229,1084,362,6,356,311,45,0.3339483394833948,0.016574585635359115,0.9834254143646409,0.8591160220994475,0.12430939226519337
08230,08,230,948,370,9,361,310,51,0.39029535864978904,0.024324324324324326,0.9756756756756757,0.8378378378378378,0.13783783783783785
08231,08,231,889,375,3,372,313,59,0.421822272215973,0.008,0.992,0.8346666666666667,0.15733333333333333
08301,08,301,914,379,11,368,306,62,0.41466083150984684,0.029023746701846966,0.9709762532981531,0.8073878627968337,0.16358839050131926
08302,08,302,965,337,16,321,269,52,0.34922279792746114,0.04747774480712166,0.9525222551928784,0.798219584569733,0.1543026706231454
08303,08,303,1020,380,7,373,315,58,0.37254901960784315,0.018421052631578946,0.9815789473684211,0.8289473684210527,0.15263157894736842
08304,08,304,993,386,7,379,301,78,0.38872104733131924,0.018134715025906734,0.9818652849740933,0.7797927461139896,0.20207253886010362
08305,08,305,1032,426,10,416,360,56,0.4127906976744186,0.023474178403755867,0.9765258215962441,0.8450704225352113,0.13145539906103287
08306,08,306,918,397,5,392,312,80,0.4324618736383442,0.012594458438287154,0.9874055415617129,0.7858942065491183,0.20151133501259447
08307,08,307,962,347,7,340,291,49,0.3607068607068607,0.020172910662824207,0.9798270893371758,0.8386167146974063,0.14121037463976946
08308,08,308,1030,445,12,433,362,71,0.4320388349514563,0.02696629213483146,0.9730337078651685,0.8134831460674158,0.15955056179775282
08309,08,309,1171,422,29,393,316,77,0.36037574722459437,0.06872037914691943,0.9312796208530806,0.7488151658767772,0.18246445497630331
08310,08,310,964,356,11,345,293,52,0.36929460580912865,0.03089887640449438,0.9691011235955056,0.8230337078651685,0.14606741573033707
08311,08,311,962,415,13,402,198,204,0.4313929313929314,0.03132530120481928,0.9686746987951808,0.4771084337349398,0.491566265060241
08312,08,312,1252,428,20,408,301,107,0.34185303514376997,0.04672897196261682,0.9532710280373832,0.7032710280373832,0.25
08313,08,313,1221,408,18,390,315,75,0.33415233415233414,0.04411764705882353,0.9558823529411765,0.7720588235294118,0.18382352941176472
08314,08,314,1217,393,29,364,295,69,0.3229252259654889,0.0737913486005089,0.926208651399491,0.7506361323155216,0.17557251908396945
08315,08,315,1295,362,17,345,273,72,0.27953667953667954,0.04696132596685083,0.9530386740331491,0.7541436464088398,0.19889502762430938
08316,08,316,1013,371,31,340,204,136,0.36623889437314905,0.08355795148247978,0.9164420485175202,0.5498652291105122,0.3665768194070081
08317,08,317,938,379,27,352,156,196,0.40405117270788915,0.0712401055408971,0.9287598944591029,0.41160949868073876,0.5171503957783641
08318,08,318,992,400,7,393,257,136,0.4032258064516129,0.0175,0.9825,0.6425,0.34
08319,08,319,1035,369,32,337,179,158,0.3565217391304348,0.08672086720867209,0.9132791327913279,0.48509485094850946,0.4281842818428184
08320,08,320,1199,455,22,433,326,107,0.3794829024186822,0.04835164835164835,0.9516483516483516,0.7164835164835165,0.23516483516483516
08321,08,321,1318,372,22,350,227,123,0.2822458270106222,0.05913978494623656,0.9408602150537635,0.6102150537634409,0.33064516129032256
08322,08,322,1317,433,11,422,277,145,0.3287775246772969,0.025404157043879907,0.9745958429561201,0.6397228637413395,0.3348729792147806
08323,08,323,957,307,9,298,199,99,0.3207941483803553,0.029315960912052116,0.9706840390879479,0.6482084690553745,0.32247557003257327
08324,08,324,1208,389,24,365,278,87,0.3220198675496689,0.061696658097686374,0.9383033419023136,0.7146529562982005,0.2236503856041131
08325,08,325,939,409,23,386,271,115,0.4355697550585729,0.05623471882640587,0.9437652811735942,0.6625916870415648,0.28117359413202936
08326,08,326,1048,422,31,391,302,89,0.4026717557251908,0.07345971563981042,0.9265402843601895,0.7156398104265402,0.2109004739336493
08327,08,327,1431,444,23,421,297,124,0.31027253668763105,0.0518018018018018,0.9481981981981982,0.668918918918919,0.27927927927927926
08328,08,328,974,350,13,337,263,74,0.3593429158110883,0.037142857142857144,0.9628571428571429,0.7514285714285714,0.21142857142857144
08329,08,329,785,206,6,200,153,47,0.2624203821656051,0.02912621359223301,0.970873786407767,0.7427184466019418,0.22815533980582525
08330,08,330,1021,361,13,348,263,85,0.3535749265426053,0.036011080332409975,0.96398891966759,0.7285318559556787,0.23545706371191136
08331,08,331,980,345,6,339,257,82,0.3520408163265306,0.017391304347826087,0.9826086956521739,0.744927536231884,0.23768115942028986
08401,08,401,1090,378,22,356,189,167,0.3467889908256881,0.0582010582010582,0.9417989417989417,0.5,0.4417989417989418
08402,08,402,1081,411,18,393,222,171,0.38020351526364476,0.043795620437956206,0.9562043795620438,0.5401459854014599,0.41605839416058393
08403,08,403,1174,450,12,438,310,128,0.3833049403747871,0.02666666666666667,0.9733333333333334,0.6888888888888889,0.28444444444444444
08404,08,404,1101,363,27,336,159,177,0.329700272479564,0.0743801652892562,0.9256198347107438,0.4380165289256198,0.48760330578512395
08405,08,405,1157,399,19,380,199,181,0.34485738980121,0.047619047619047616,0.9523809523809523,0.49874686716791977,0.45363408521303256
08406,08,406,1191,465,14,451,237,214,0.3904282115869018,0.030107526881720432,0.9698924731182795,0.5096774193548387,0.46021505376344085
08407,08,407,1172,352,14,338,159,179,0.3003412969283277,0.03977272727272727,0.9602272727272727,0.45170454545454547,0.5085227272727273
08408,08,408,881,339,19,320,173,147,0.3847900113507378,0.05604719764011799,0.943952802359882,0.5103244837758112,0.4336283185840708
08409,08,409,974,428,15,413,174,239,0.4394250513347023,0.035046728971962614,0.9649532710280374,0.40654205607476634,0.5584112149532711
08410,08,410,1002,406,12,394,152,242,0.405189620758483,0.029556650246305417,0.9704433497536946,0.37438423645320196,0.5960591133004927
08411,08,411,1008,368,19,349,135,214,0.36507936507936506,0.051630434782608696,0.9483695652173914,0.36684782608695654,0.5815217391304348
08412,08,412,1071,372,14,358,170,188,0.3473389355742297,0.03763440860215054,0.9623655913978495,0.45698924731182794,0.5053763440860215
08413,08,413,1089,384,11,373,212,161,0.3526170798898072,0.028645833333333332,0.9713541666666666,0.5520833333333334,0.4192708333333333
08414,08,414,985,333,21,312,158,154,0.3380710659898477,0.06306306306306306,0.9369369369369369,0.4744744744744745,0.4624624624624625
08415,08,415,1287,485,27,458,312,146,0.37684537684537683,0.05567010309278351,0.9443298969072165,0.643298969072165,0.30103092783505153
08416,08,416,1127,444,24,420,236,184,0.3939662821650399,0.05405405405405406,0.9459459459459459,0.5315315315315315,0.4144144144144144
08417,08,417,1058,411,23,388,247,141,0.388468809073724,0.05596107055961071,0.9440389294403893,0.6009732360097324,0.34306569343065696
08418,08,418,1070,373,18,355,192,163,0.3485981308411215,0.04825737265415549,0.9517426273458445,0.514745308310992,0.43699731903485256
08419,08,419,1219,434,27,407,246,161,0.3560295324036095,0.06221198156682028,0.9377880184331797,0.5668202764976958,0.3709677419354839
08420,08,420,1071,403,31,372,225,147,0.37628384687208216,0.07692307692307693,0.9230769230769231,0.5583126550868487,0.36476426799007444
08421,08,421,1058,354,14,340,251,89,0.33459357277882795,0.03954802259887006,0.96045197740113,0.7090395480225988,0.2514124293785311
08422,08,422,1094,373,38,335,224,111,0.34095063985374774,0.10187667560321716,0.8981233243967829,0.6005361930294906,0.2975871313672922
08423,08,423,950,414,31,383,249,134,0.4357894736842105,0.0748792270531401,0.9251207729468599,0.6014492753623188,0.32367149758454106
08424,08,424,969,350,16,334,223,111,0.36119711042311664,0.045714285714285714,0.9542857142857143,0.6371428571428571,0.3171428571428571
08425,08,425,1095,344,16,328,226,102,0.3141552511415525,0.046511627906976744,0.9534883720930233,0.6569767441860465,0.29651162790697677
08426,08,426,864,316,29,287,166,121,0.36574074074074076,0.09177215189873418,0.9082278481012658,0.5253164556962026,0.3829113924050633
08427,08,427,1005,356,14,342,159,183,0.354228855721393,0.03932584269662921,0.9606741573033708,0.44662921348314605,0.5140449438202247
08428,08,428,1061,376,18,358,164,194,0.354382657869934,0.047872340425531915,0.9521276595744681,0.43617021276595747,0.5159574468085106
08429,08,429,891,348,43,305,211,94,0.39057239057239057,0.1235632183908046,0.8764367816091954,0.6063218390804598,0.27011494252873564
08430,08,430,907,339,22,317,186,131,0.3737596471885336,0.06489675516224189,0.9351032448377581,0.5486725663716814,0.3864306784660767
08431,08,431,1207,426,22,404,279,125,0.35294117647058826,0.051643192488262914,0.9483568075117371,0.6549295774647887,0.2934272300469484
08501,08,501,1113,338,11,327,196,131,0.3036837376460018,0.03254437869822485,0.9674556213017751,0.5798816568047337,0.3875739644970414
08502,08,502,1028,406,14,392,238,154,0.3949416342412451,0.034482758620689655,0.9655172413793104,0.5862068965517241,0.3793103448275862
08503,08,503,847,350,6,344,173,171,0.4132231404958678,0.017142857142857144,0.9828571428571429,0.4942857142857143,0.48857142857142855
08504,08,504,928,396,20,376,203,173,0.4267241379310345,0.050505050505050504,0.9494949494949495,0.5126262626262627,0.43686868686868685
08505,08,505,992,385,22,363,199,164,0.38810483870967744,0.05714285714285714,0.9428571428571428,0.5168831168831168,0.42597402597402595
08506,08,506,948,399,10,389,240,149,0.4208860759493671,0.02506265664160401,0.974937343358396,0.6015037593984962,0.37343358395989973
08507,08,507,1027,409,15,394,238,156,0.39824732229795523,0.03667481662591687,0.9633251833740831,0.5819070904645477,0.38141809290953543
08508,08,508,1269,434,11,423,276,147,0.34200157604412923,0.02534562211981567,0.9746543778801844,0.6359447004608295,0.3387096774193548
08509,08,509,1186,464,18,446,163,283,0.3912310286677909,0.03879310344827586,0.9612068965517241,0.35129310344827586,0.6099137931034483
08510,08,510,1008,326,11,315,140,175,0.32341269841269843,0.03374233128834356,0.9662576687116564,0.4294478527607362,0.5368098159509203
08511,08,511,974,308,10,298,186,112,0.3162217659137577,0.032467532467532464,0.9675324675324676,0.6038961038961039,0.36363636363636365
08512,08,512,1038,442,21,421,196,225,0.4258188824662813,0.04751131221719457,0.9524886877828054,0.4434389140271493,0.5090497737556561
08513,08,513,1037,423,18,405,175,230,0.40790742526518803,0.0425531914893617,0.9574468085106383,0.41371158392434987,0.5437352245862884
08514,08,514,899,332,17,315,153,162,0.3692992213570634,0.05120481927710843,0.9487951807228916,0.4608433734939759,0.4879518072289157
08515,08,515,942,383,13,370,169,201,0.40658174097664546,0.033942558746736295,0.9660574412532638,0.4412532637075718,0.5248041775456919
08516,08,516,1023,426,17,409,269,140,0.41642228739002934,0.03990610328638498,0.960093896713615,0.6314553990610329,0.3286384976525822
08517,08,517,857,333,24,309,151,158,0.3885647607934656,0.07207207207207207,0.9279279279279279,0.45345345345345345,0.4744744744744745
08518,08,518,903,349,14,335,142,193,0.3864894795127353,0.04011461318051576,0.9598853868194842,0.4068767908309456,0.5530085959885387
08519,08,519,1020,365,12,353,150,203,0.35784313725490197,0.03287671232876712,0.9671232876712329,0.410958904109589,0.5561643835616439
08520,08,520,941,401,15,386,146,240,0.4261424017003188,0.03740648379052369,0.9625935162094763,0.3640897755610973,0.5985037406483791
08521,08,521,925,334,12,322,129,193,0.36108108108108106,0.03592814371257485,0.9640718562874252,0.38622754491017963,0.5778443113772455
08522,08,522,902,385,8,377,191,186,0.4268292682926829,0.02077922077922078,0.9792207792207792,0.4961038961038961,0.4831168831168831
08523,08,523,972,412,19,393,164,229,0.42386831275720166,0.04611650485436893,0.9538834951456311,0.39805825242718446,0.5558252427184466
08524,08,524,916,369,20,349,199,150,0.4028384279475983,0.05420054200542006,0.94579945799458,0.5392953929539296,0.4065040650406504
08525,08,525,894,349,14,335,168,167,0.39038031319910516,0.04011461318051576,0.9598853868194842,0.4813753581661891,0.4785100286532951
08526,08,526,972,429,17,412,180,232,0.44135802469135804,0.039627039627039624,0.9603729603729604,0.4195804195804196,0.5407925407925408
08527,08,527,1022,360,21,339,185,154,0.3522504892367906,0.058333333333333334,0.9416666666666667,0.5138888888888888,0.42777777777777776
08528,08,528,935,348,23,325,154,171,0.37219251336898396,0.06609195402298851,0.9339080459770115,0.4425287356321839,0.49137931034482757
08529,08,529,981,382,14,368,221,147,0.3893985728848114,0.03664921465968586,0.9633507853403142,0.5785340314136126,0.38481675392670156
08530,08,530,831,322,6,316,160,156,0.38748495788206977,0.018633540372670808,0.9813664596273292,0.4968944099378882,0.484472049689441
08531,08,531,1073,350,39,311,185,126,0.32618825722274,0.11142857142857143,0.8885714285714286,0.5285714285714286,0.36
08532,08,532,942,361,17,344,186,158,0.3832271762208068,0.04709141274238227,0.9529085872576177,0.5152354570637119,0.4376731301939058
08533,08,533,857,366,23,343,165,178,0.42707117852975496,0.06284153005464481,0.9371584699453552,0.45081967213114754,0.48633879781420764
08534,08,534,1041,462,14,448,251,197,0.4438040345821326,0.030303030303030304,0.9696969696969697,0.5432900432900433,0.4264069264069264
08601,08,601,896,335,5,330,109,221,0.37388392857142855,0.014925373134328358,0.9850746268656716,0.3253731343283582,0.6597014925373135
08602,08,602,888,377,19,358,113,245,0.42454954954954954,0.050397877984084884,0.9496021220159151,0.29973474801061006,0.649867374005305
08603,08,603,928,354,20,334,156,178,0.38146551724137934,0.05649717514124294,0.943502824858757,0.4406779661016949,0.5028248587570622
08604,08,604,893,373,12,361,150,211,0.4176931690929451,0.032171581769437,0.967828418230563,0.40214477211796246,0.5656836461126006
08605,08,605,881,392,26,366,152,214,0.4449489216799092,0.0663265306122449,0.9336734693877551,0.3877551020408163,0.5459183673469388
08606,08,606,917,375,20,355,180,175,0.4089422028353326,0.05333333333333334,0.9466666666666667,0.48,0.4666666666666667
08607,08,607,895,355,15,340,158,182,0.39664804469273746,0.04225352112676056,0.9577464788732394,0.4450704225352113,0.5126760563380282
08608,08,608,912,434,19,415,172,243,0.4758771929824561,0.04377880184331797,0.956221198156682,0.39631336405529954,0.5599078341013825
08609,08,609,991,392,30,362,225,137,0.3955600403632694,0.07653061224489796,0.923469387755102,0.5739795918367347,0.3494897959183674
08610,08,610,897,425,19,406,172,234,0.4738015607580825,0.04470588235294118,0.9552941176470588,0.4047058823529412,0.5505882352941176
08611,08,611,841,335,12,323,193,130,0.3983353151010702,0.03582089552238806,0.9641791044776119,0.5761194029850746,0.3880597014925373
08612,08,612,912,390,34,356,148,208,0.4276315789473684,0.08717948717948718,0.9128205128205128,0.37948717948717947,0.5333333333333333
08613,08,613,900,343,31,312,167,145,0.3811111111111111,0.09037900874635568,0.9096209912536443,0.4868804664723032,0.4227405247813411
08614,08,614,876,351,8,343,142,201,0.4006849315068493,0.022792022792022793,0.9772079772079773,0.4045584045584046,0.5726495726495726
08615,08,615,886,392,22,370,207,163,0.44243792325056436,0.05612244897959184,0.9438775510204082,0.5280612244897959,0.41581632653061223
08616,08,616,808,344,9,335,227,108,0.42574257425742573,0.02616279069767442,0.9738372093023255,0.6598837209302325,0.313953488372093
08617,08,617,865,411,24,387,196,191,0.4751445086705202,0.058394160583941604,0.9416058394160584,0.4768856447688564,0.46472019464720193
08618,08,618,902,431,15,416,173,243,0.4778270509977827,0.03480278422273782,0.9651972157772621,0.4013921113689095,0.5638051044083526
08619,08,619,876,352,16,336,138,198,0.4018264840182648,0.045454545454545456,0.9545454545454546,0.39204545454545453,0.5625
08620,08,620,796,344,16,328,164,164,0.4321608040201005,0.046511627906976744,0.9534883720930233,0.47674418604651164,0.47674418604651164
08621,08,621,909,388,31,357,184,173,0.42684268426842686,0.07989690721649484,0.9201030927835051,0.4742268041237113,0.44587628865979384
08622,08,622,902,345,9,336,129,207,0.38248337028824836,0.02608695652173913,0.9739130434782609,0.3739130434782609,0.6
08623,08,623,956,416,23,393,240,153,0.4351464435146444,0.055288461538461536,0.9447115384615384,0.5769230769230769,0.36778846153846156
08624,08,624,858,364,21,343,164,179,0.42424242424242425,0.057692307692307696,0.9423076923076923,0.45054945054945056,0.49175824175824173
08625,08,625,1011,381,28,353,151,202,0.3768545994065282,0.07349081364829396,0.926509186351706,0.3963254593175853,0.5301837270341208
08626,08,626,897,359,14,345,123,222,0.40022296544035674,0.03899721448467967,0.9610027855153204,0.3426183844011142,0.6183844011142061
08627,08,627,873,311,17,294,100,194,0.35624284077892326,0.05466237942122187,0.9453376205787781,0.3215434083601286,0.6237942122186495
08628,08,628,838,399,15,384,129,255,0.47613365155131265,0.03759398496240601,0.9624060150375939,0.3233082706766917,0.6390977443609023
08629,08,629,829,390,15,375,131,244,0.4704463208685163,0.038461538461538464,0.9615384615384616,0.33589743589743587,0.6256410256410256
08630,08,630,827,362,12,350,132,218,0.437726723095526,0.03314917127071823,0.9668508287292817,0.36464088397790057,0.6022099447513812
08631,08,631,901,376,8,368,146,222,0.41731409544950054,0.02127659574468085,0.9787234042553191,0.3882978723404255,0.5904255319148937
08632,08,632,1094,439,14,425,149,276,0.4012797074954296,0.03189066059225513,0.9681093394077449,0.33940774487471526,0.6287015945330297
08633,08,633,1208,456,30,426,268,158,0.37748344370860926,0.06578947368421052,0.9342105263157895,0.5877192982456141,0.34649122807017546
08634,08,634,1015,371,22,349,246,103,0.36551724137931035,0.05929919137466307,0.9407008086253369,0.6630727762803235,0.2776280323450135
08635,08,635,1011,359,13,346,250,96,0.35509396636993074,0.036211699164345405,0.9637883008356546,0.6963788300835655,0.26740947075208915
08636,08,636,866,307,30,277,182,95,0.35450346420323325,0.09771986970684039,0.9022801302931596,0.5928338762214984,0.30944625407166126
081A,08,1A,0,413,2,411,350,61,inf,0.004842615012106538,0.9951573849878934,0.847457627118644,0.14769975786924938
081AA,08,1AA,0,445,3,442,359,83,inf,0.006741573033707865,0.9932584269662922,0.8067415730337079,0.18651685393258427
081AB,08,1AB,0,484,3,481,393,88,inf,0.006198347107438017,0.993801652892562,0.8119834710743802,0.18181818181818182
081AC,08,1AC,0,415,5,410,346,64,inf,0.012048192771084338,0.9879518072289156,0.8337349397590361,0.15421686746987953
081B,08,1B,0,390,5,385,326,59,inf,0.01282051282051282,0.9871794871794872,0.8358974358974359,0.15128205128205127
081C,08,1C,0,391,19,372,298,74,inf,0.04859335038363171,0.9514066496163683,0.7621483375959079,0.18925831202046037
081D,08,1D,0,402,0,402,343,59,inf,0.0,1.0,0.8532338308457711,0.14676616915422885
081E,08,1E,0,339,2,337,295,42,inf,0.0058997050147492625,0.9941002949852508,0.8702064896755162,0.12389380530973451
081F,08,1F,0,380,24,356,310,46,inf,0.06315789473684211,0.9368421052631579,0.8157894736842105,0.12105263157894737
081G,08,1G,0,344,3,341,276,65,inf,0.00872093023255814,0.9912790697674418,0.8023255813953488,0.18895348837209303
081H,08,1H,0,317,5,312,273,39,inf,0.015772870662460567,0.9842271293375394,0.861198738170347,0.12302839116719243
081I,08,1I,0,379,3,376,299,77,inf,0.0079155672823219,0.9920844327176781,0.7889182058047494,0.20316622691292877
081J,08,1J,0,356,3,353,315,38,inf,0.008426966292134831,0.9915730337078652,0.8848314606741573,0.10674157303370786
081K,08,1K,0,390,3,387,335,52,inf,0.007692307692307693,0.9923076923076923,0.8589743589743589,0.13333333333333333
081L,08,1L,0,292,0,292,244,48,inf,0.0,1.0,0.8356164383561644,0.1643835616438356
081M,08,1M,0,413,5,408,347,61,inf,0.012106537530266344,0.9878934624697336,0.8401937046004843,0.14769975786924938
081N,08,1N,0,409,4,405,333,72,inf,0.009779951100244499,0.9902200488997555,0.8141809290953546,0.17603911980440098
081P,08,1P,0,354,3,351,297,54,inf,0.00847457627118644,0.9915254237288136,0.8389830508474576,0.15254237288135594
081Q,08,1Q,0,434,4,430,349,81,inf,0.009216589861751152,0.9907834101382489,0.804147465437788,0.18663594470046083
081R,08,1R,0,376,2,374,325,49,inf,0.005319148936170213,0.9946808510638298,0.8643617021276596,0.13031914893617022
081S,08,1S,0,400,3,397,314,83,inf,0.0075,0.9925,0.785,0.2075
081T,08,1T,0,613,8,605,493,112,inf,0.013050570962479609,0.9869494290375204,0.8042414355628059,0.18270799347471453
081U,08,1U,0,352,2,350,210,140,inf,0.005681818181818182,0.9943181818181818,0.5965909090909091,0.3977272727272727
081V,08,1V,0,449,2,447,329,118,inf,0.004454342984409799,0.9955456570155902,0.732739420935412,0.26280623608017817
081W,08,1W,0,472,3,469,395,74,inf,0.006355932203389831,0.9936440677966102,0.836864406779661,0.15677966101694915
081X,08,1X,0,336,3,333,255,78,inf,0.008928571428571428,0.9910714285714286,0.7589285714285714,0.23214285714285715
081Y,08,1Y,0,423,5,418,331,87,inf,0.01182033096926714,0.9881796690307328,0.7825059101654847,0.20567375886524822
081Z,08,1Z,0,620,7,613,499,114,inf,0.01129032258064516,0.9887096774193549,0.8048387096774193,0.18387096774193548
082A,08,2A,0,440,2,438,338,100,inf,0.004545454545454545,0.9954545454545455,0.7681818181818182,0.22727272727272727
082AA,08,2AA,0,309,5,304,265,39,inf,0.016181229773462782,0.9838187702265372,0.8576051779935275,0.1262135922330097
082AB,08,2AB,0,263,5,258,207,51,inf,0.019011406844106463,0.9809885931558935,0.7870722433460076,0.19391634980988592
082B,08,2B,0,344,2,342,281,61,inf,0.005813953488372093,0.9941860465116279,0.8168604651162791,0.17732558139534885
082C,08,2C,0,335,3,332,296,36,inf,0.008955223880597015,0.991044776119403,0.8835820895522388,0.10746268656716418
082D,08,2D,0,359,5,354,297,57,inf,0.013927576601671309,0.9860724233983287,0.8272980501392758,0.15877437325905291
082E,08,2E,0,362,1,361,312,49,inf,0.0027624309392265192,0.9972375690607734,0.861878453038674,0.13535911602209943
082F,08,2F,0,393,7,386,307,79,inf,0.017811704834605598,0.9821882951653944,0.7811704834605598,0.2010178117048346
082G,08,2G,0,340,2,338,277,61,inf,0.0058823529411764705,0.9941176470588236,0.8147058823529412,0.17941176470588235
082H,08,2H,0,655,7,648,509,139,inf,0.010687022900763359,0.9893129770992366,0.7770992366412214,0.21221374045801528
082I,08,2I,0,369,3,366,311,55,inf,0.008130081300813009,0.991869918699187,0.8428184281842819,0.14905149051490515
082J,08,2J,0,380,3,377,321,56,inf,0.007894736842105263,0.9921052631578947,0.8447368421052631,0.14736842105263157
082K,08,2K,0,373,0,373,324,49,inf,0.0,1.0,0.868632707774799,0.13136729222520108
082L,08,2L,0,306,4,302,249,53,inf,0.013071895424836602,0.9869281045751634,0.8137254901960784,0.17320261437908496
082M,08,2M,0,324,0,324,263,61,inf,0.0,1.0,0.8117283950617284,0.1882716049382716
082N,08,2N,0,354,2,352,295,57,inf,0.005649717514124294,0.9943502824858758,0.8333333333333334,0.16101694915254236
082P,08,2P,0,327,2,325,266,59,inf,0.0061162079510703364,0.9938837920489296,0.8134556574923547,0.18042813455657492
082Q,08,2Q,0,460,2,458,384,74,inf,0.004347826086956522,0.9956521739130435,0.8347826086956521,0.1608695652173913
082R,08,2R,0,388,1,387,314,73,inf,0.002577319587628866,0.9974226804123711,0.8092783505154639,0.18814432989690721
082S,08,2S,0,364,0,364,291,73,inf,0.0,1.0,0.7994505494505495,0.20054945054945056
082T,08,2T,0,353,1,352,304,48,inf,0.0028328611898017,0.9971671388101983,0.8611898016997167,0.1359773371104816
082U,08,2U,0,356,6,350,291,59,inf,0.016853932584269662,0.9831460674157303,0.8174157303370787,0.16573033707865167
082V,08,2V,0,546,5,541,447,94,inf,0.009157509157509158,0.9908424908424909,0.8186813186813187,0.17216117216117216
082W,08,2W,0,343,1,342,295,47,inf,0.0029154518950437317,0.9970845481049563,0.8600583090379009,0.13702623906705538
082X,08,2X,0,361,1,360,293,67,inf,0.002770083102493075,0.997229916897507,0.8116343490304709,0.18559556786703602
082Y,08,2Y,0,346,5,341,299,42,inf,0.014450867052023121,0.9855491329479769,0.8641618497109826,0.12138728323699421
082Z,08,2Z,0,577,4,573,480,93,inf,0.006932409012131715,0.9930675909878682,0.8318890814558059,0.1611785095320624
083A,08,3A,0,655,7,648,523,125,inf,0.010687022900763359,0.9893129770992366,0.7984732824427481,0.19083969465648856
083B,08,3B,0,431,4,427,358,69,inf,0.009280742459396751,0.9907192575406032,0.8306264501160093,0.16009280742459397
083C,08,3C,0,344,2,342,297,45,inf,0.005813953488372093,0.9941860465116279,0.8633720930232558,0.1308139534883721
083D,08,3D,0,333,3,330,273,57,inf,0.009009009009009009,0.990990990990991,0.8198198198198198,0.17117117117117117
083E,08,3E,0,589,7,582,509,73,inf,0.011884550084889643,0.9881154499151104,0.8641765704584041,0.12393887945670629
083F,08,3F,0,332,2,330,268,62,inf,0.006024096385542169,0.9939759036144579,0.8072289156626506,0.18674698795180722
083G,08,3G,0,603,12,591,351,240,inf,0.01990049751243781,0.9800995024875622,0.582089552238806,0.39800995024875624
083H,08,3H,0,499,5,494,337,157,inf,0.01002004008016032,0.9899799599198397,0.6753507014028056,0.31462925851703405
083I,08,3I,0,557,8,549,367,182,inf,0.01436265709156194,0.9856373429084381,0.6588868940754039,0.3267504488330341
083J,08,3J,0,566,10,556,302,254,inf,0.0176678445229682,0.9823321554770318,0.5335689045936396,0.44876325088339225
083K,08,3K,0,499,5,494,339,155,inf,0.01002004008016032,0.9899799599198397,0.6793587174348698,0.3106212424849699
083L,08,3L,0,331,7,324,206,118,inf,0.021148036253776436,0.9788519637462235,0.622356495468278,0.3564954682779456
083M,08,3M,0,290,4,286,194,92,inf,0.013793103448275862,0.9862068965517241,0.6689655172413793,0.31724137931034485
083N,08,3N,0,607,3,604,400,204,inf,0.004942339373970346,0.9950576606260296,0.6589785831960461,0.33607907742998355
083P,08,3P,0,534,3,531,380,151,inf,0.0056179775280898875,0.9943820224719101,0.7116104868913857,0.28277153558052437
083Q,08,3Q,0,548,7,541,433,108,inf,0.012773722627737226,0.9872262773722628,0.7901459854014599,0.19708029197080293
083R,08,3R,0,476,25,451,339,112,inf,0.052521008403361345,0.9474789915966386,0.7121848739495799,0.23529411764705882
083S,08,3S,0,525,8,517,410,107,inf,0.015238095238095238,0.9847619047619047,0.780952380952381,0.2038095238095238
084A,08,4A,0,376,6,370,188,182,inf,0.015957446808510637,0.9840425531914894,0.5,0.48404255319148937
084B,08,4B,0,626,4,622,396,226,inf,0.006389776357827476,0.9936102236421726,0.6325878594249201,0.3610223642172524
084C,08,4C,0,422,2,420,173,247,inf,0.004739336492890996,0.995260663507109,0.4099526066350711,0.5853080568720379
084D,08,4D,0,332,6,326,165,161,inf,0.018072289156626505,0.9819277108433735,0.49698795180722893,0.48493975903614456
084E,08,4E,0,360,8,352,167,185,inf,0.022222222222222223,0.9777777777777777,0.4638888888888889,0.5138888888888888
084F,08,4F,0,439,10,429,176,253,inf,0.022779043280182234,0.9772209567198178,0.4009111617312073,0.5763097949886105
084G,08,4G,0,636,11,625,273,352,inf,0.01729559748427673,0.9827044025157232,0.42924528301886794,0.5534591194968553
084H,08,4H,0,378,5,373,134,239,inf,0.013227513227513227,0.9867724867724867,0.3544973544973545,0.6322751322751323
084I,08,4I,0,372,7,365,112,253,inf,0.01881720430107527,0.9811827956989247,0.3010752688172043,0.6801075268817204
084J,08,4J,0,412,6,406,169,237,inf,0.014563106796116505,0.9854368932038835,0.41019417475728154,0.5752427184466019
084K,08,4K,0,318,6,312,161,151,inf,0.018867924528301886,0.9811320754716981,0.5062893081761006,0.4748427672955975
084L,08,4L,0,335,29,306,157,149,inf,0.08656716417910448,0.9134328358208955,0.46865671641791046,0.44477611940298506
084M,08,4M,0,322,6,316,181,135,inf,0.018633540372670808,0.9813664596273292,0.562111801242236,0.4192546583850932
084N,08,4N,0,341,7,334,148,186,inf,0.020527859237536656,0.9794721407624634,0.4340175953079179,0.5454545454545454
084P,08,4P,0,272,3,269,162,107,inf,0.011029411764705883,0.9889705882352942,0.5955882352941176,0.39338235294117646
084Q,08,4Q,0,324,8,316,152,164,inf,0.024691358024691357,0.9753086419753086,0.4691358024691358,0.5061728395061729
084R,08,4R,0,321,1,320,172,148,inf,0.003115264797507788,0.9968847352024922,0.5358255451713395,0.46105919003115264
084S,08,4S,0,259,4,255,135,120,inf,0.015444015444015444,0.9845559845559846,0.5212355212355212,0.46332046332046334
084T,08,4T,0,347,4,343,196,147,inf,0.011527377521613832,0.9884726224783862,0.5648414985590778,0.42363112391930835
084U,08,4U,0,250,5,245,142,103,inf,0.02,0.98,0.568,0.412
084V,08,4V,0,472,10,462,270,192,inf,0.0211864406779661,0.9788135593220338,0.5720338983050848,0.4067796610169492
084W,08,4W,0,418,39,379,193,186,inf,0.09330143540669857,0.9066985645933014,0.46172248803827753,0.4449760765550239
084X,08,4X,0,270,4,266,95,171,inf,0.014814814814814815,0.9851851851851852,0.35185185185185186,0.6333333333333333
084Y,08,4Y,0,303,10,293,120,173,inf,0.033003300330033,0.966996699669967,0.39603960396039606,0.570957095709571
084Z,08,4Z,0,479,9,470,241,229,inf,0.018789144050104383,0.9812108559498957,0.5031315240083507,0.4780793319415449
085A,08,5A,0,306,2,304,186,118,inf,0.006535947712418301,0.9934640522875817,0.6078431372549019,0.38562091503267976
085AA,08,5AA,0,335,4,331,202,129,inf,0.011940298507462687,0.9880597014925373,0.6029850746268657,0.3850746268656716
085AB,08,5AB,0,344,7,337,183,154,inf,0.020348837209302327,0.9796511627906976,0.5319767441860465,0.4476744186046512
085AC,08,5AC,0,346,5,341,200,141,inf,0.014450867052023121,0.9855491329479769,0.5780346820809249,0.407514450867052
085B,08,5B,0,345,8,337,156,181,inf,0.02318840579710145,0.9768115942028985,0.45217391304347826,0.5246376811594203
085C,08,5C,0,342,10,332,171,161,inf,0.029239766081871343,0.9707602339181286,0.5,0.47076023391812866
085D,08,5D,0,574,7,567,314,253,inf,0.012195121951219513,0.9878048780487805,0.5470383275261324,0.44076655052264807
085E,08,5E,0,310,5,305,213,92,inf,0.016129032258064516,0.9838709677419355,0.6870967741935484,0.2967741935483871
085F,08,5F,0,538,6,532,187,345,inf,0.011152416356877323,0.9888475836431226,0.3475836431226766,0.6412639405204461
085G,08,5G,0,437,11,426,176,250,inf,0.02517162471395881,0.9748283752860412,0.40274599542334094,0.5720823798627003
085H,08,5H,0,360,6,354,176,178,inf,0.016666666666666666,0.9833333333333333,0.4888888888888889,0.49444444444444446
085I,08,5I,0,303,4,299,130,169,inf,0.013201320132013201,0.9867986798679867,0.429042904290429,0.5577557755775577
085J,08,5J,0,405,9,396,174,222,inf,0.022222222222222223,0.9777777777777777,0.42962962962962964,0.5481481481481482
085K,08,5K,0,367,5,362,179,183,inf,0.013623978201634877,0.9863760217983651,0.4877384196185286,0.4986376021798365
085L,08,5L,0,483,11,472,257,215,inf,0.022774327122153208,0.9772256728778468,0.5320910973084886,0.4451345755693582
085M,08,5M,0,354,7,347,157,190,inf,0.01977401129943503,0.980225988700565,0.4435028248587571,0.536723163841808
085N,08,5N,0,413,5,408,137,271,inf,0.012106537530266344,0.9878934624697336,0.33171912832929784,0.6561743341404358
085P,08,5P,0,351,3,348,142,206,inf,0.008547008547008548,0.9914529914529915,0.4045584045584046,0.5868945868945868
085Q,08,5Q,0,448,28,420,166,254,inf,0.0625,0.9375,0.3705357142857143,0.5669642857142857
085R,08,5R,0,632,5,627,297,330,inf,0.007911392405063292,0.9920886075949367,0.4699367088607595,0.5221518987341772
085S,08,5S,0,327,3,324,144,180,inf,0.009174311926605505,0.9908256880733946,0.44036697247706424,0.5504587155963303
085T,08,5T,0,464,11,453,245,208,inf,0.023706896551724137,0.9762931034482759,0.5280172413793104,0.4482758620689655
085U,08,5U,0,327,22,305,140,165,inf,0.0672782874617737,0.9327217125382263,0.42813455657492355,0.5045871559633027
085V,08,5V,0,361,31,330,146,184,inf,0.08587257617728532,0.9141274238227147,0.40443213296398894,0.5096952908587258
085W,08,5W,0,554,10,544,247,297,inf,0.018050541516245487,0.9819494584837545,0.44584837545126355,0.5361010830324909
085X,08,5X,0,531,5,526,262,264,inf,0.009416195856873822,0.9905838041431262,0.4934086629001883,0.4971751412429379
085Y,08,5Y,0,292,6,286,145,141,inf,0.02054794520547945,0.9794520547945206,0.4965753424657534,0.4828767123287671
085Z,08,5Z,0,228,4,224,95,129,inf,0.017543859649122806,0.9824561403508771,0.4166666666666667,0.5657894736842105
086A,08,6A,0,376,6,370,131,239,inf,0.015957446808510637,0.9840425531914894,0.3484042553191489,0.6356382978723404
086AA,08,6AA,0,318,4,314,110,204,inf,0.012578616352201259,0.9874213836477987,0.34591194968553457,0.6415094339622641
086B,08,6B,0,377,8,369,135,234,inf,0.021220159151193633,0.9787798408488063,0.35809018567639256,0.6206896551724138
086C,08,6C,0,288,6,282,100,182,inf,0.020833333333333332,0.9791666666666666,0.3472222222222222,0.6319444444444444
086D,08,6D,0,592,5,587,263,324,inf,0.008445945945945946,0.9915540540540541,0.44425675675675674,0.5472972972972973
086E,08,6E,0,534,7,527,215,312,inf,0.013108614232209739,0.9868913857677902,0.40262172284644193,0.5842696629213483
086F,08,6F,0,325,3,322,142,180,inf,0.009230769230769232,0.9907692307692307,0.4369230769230769,0.5538461538461539
086G,08,6G,0,312,7,305,100,205,inf,0.022435897435897436,0.9775641025641025,0.32051282051282054,0.657051282051282
086H,08,6H,0,199,1,198,109,89,inf,0.005025125628140704,0.9949748743718593,0.5477386934673367,0.4472361809045226
086I,08,6I,0,275,3,272,96,176,inf,0.01090909090909091,0.9890909090909091,0.3490909090909091,0.64
086J,08,6J,0,542,13,529,242,287,inf,0.023985239852398525,0.9760147601476015,0.44649446494464945,0.5295202952029521
086K,08,6K,0,474,3,471,184,287,inf,0.006329113924050633,0.9936708860759493,0.3881856540084388,0.6054852320675106
086L,08,6L,0,438,7,431,217,214,inf,0.01598173515981735,0.9840182648401826,0.4954337899543379,0.4885844748858447
086M,08,6M,0,621,16,605,193,412,inf,0.02576489533011272,0.9742351046698873,0.3107890499194847,0.6634460547504025
086N,08,6N,0,492,5,487,219,268,inf,0.01016260162601626,0.9898373983739838,0.4451219512195122,0.5447154471544715
086P,08,6P,0,554,10,544,242,302,inf,0.018050541516245487,0.9819494584837545,0.4368231046931408,0.5451263537906137
086Q,08,6Q,0,306,4,302,120,182,inf,0.013071895424836602,0.9869281045751634,0.39215686274509803,0.5947712418300654
086R,08,6R,0,379,4,375,142,233,inf,0.010554089709762533,0.9894459102902374,0.37467018469656993,0.6147757255936676
086S,08,6S,0,367,4,363,137,226,inf,0.010899182561307902,0.989100817438692,0.37329700272479566,0.6158038147138964
086T,08,6T,0,276,5,271,97,174,inf,0.018115942028985508,0.9818840579710145,0.35144927536231885,0.6304347826086957
086U,08,6U,0,311,4,307,120,187,inf,0.012861736334405145,0.9871382636655949,0.3858520900321543,0.6012861736334405
086V,08,6V,0,298,4,294,105,189,inf,0.013422818791946308,0.9865771812080537,0.3523489932885906,0.6342281879194631
086W,08,6W,0,356,9,347,126,221,inf,0.025280898876404494,0.9747191011235955,0.3539325842696629,0.6207865168539326
086X,08,6X,0,454,7,447,164,283,inf,0.015418502202643172,0.9845814977973568,0.36123348017621143,0.6233480176211453
086Y,08,6Y,0,513,9,504,309,195,inf,0.017543859649122806,0.9824561403508771,0.6023391812865497,0.38011695906432746
086Z,08,6Z,0,352,6,346,205,141,inf,0.017045454545454544,0.9829545454545454,0.5823863636363636,0.4005681818181818
09101,09,101,642,305,8,297,249,48,0.4750778816199377,0.02622950819672131,0.9737704918032787,0.8163934426229508,0.15737704918032788
09102,09,102,786,363,14,349,255,94,0.4618320610687023,0.03856749311294766,0.9614325068870524,0.7024793388429752,0.25895316804407714
09103,09,103,867,360,18,342,278,64,0.41522491349480967,0.05,0.95,0.7722222222222223,0.17777777777777778
09104,09,104,723,309,14,295,204,91,0.42738589211618255,0.045307443365695796,0.9546925566343042,0.6601941747572816,0.29449838187702265
09105,09,105,625,247,8,239,177,62,0.3952,0.032388663967611336,0.9676113360323887,0.7165991902834008,0.25101214574898784
09106,09,106,787,329,8,321,242,79,0.41804320203303685,0.0243161094224924,0.9756838905775076,0.7355623100303952,0.24012158054711247
09107,09,107,731,275,2,273,221,52,0.3761969904240766,0.007272727272727273,0.9927272727272727,0.8036363636363636,0.1890909090909091
09108,09,108,823,346,4,342,269,73,0.4204131227217497,0.011560693641618497,0.9884393063583815,0.7774566473988439,0.21098265895953758
09109,09,109,807,358,7,351,267,84,0.4436183395291202,0.019553072625698324,0.9804469273743017,0.7458100558659218,0.2346368715083799
09110,09,110,845,289,8,281,176,105,0.34201183431952664,0.02768166089965398,0.972318339100346,0.6089965397923875,0.3633217993079585
09111,09,111,634,225,2,223,180,43,0.3548895899053628,0.008888888888888889,0.9911111111111112,0.8,0.19111111111111112
09112,09,112,863,294,12,282,194,88,0.3406720741599073,0.04081632653061224,0.9591836734693877,0.6598639455782312,0.29931972789115646
09113,09,113,929,355,5,350,238,112,0.3821313240043057,0.014084507042253521,0.9859154929577465,0.6704225352112676,0.3154929577464789
09114,09,114,763,270,7,263,190,73,0.35386631716906947,0.025925925925925925,0.9740740740740741,0.7037037037037037,0.27037037037037037
09115,09,115,543,186,11,175,114,61,0.3425414364640884,0.05913978494623656,0.9408602150537635,0.6129032258064516,0.3279569892473118
09116,09,116,806,311,20,291,224,67,0.3858560794044665,0.06430868167202572,0.9356913183279743,0.7202572347266881,0.21543408360128619
09117,09,117,752,281,13,268,183,85,0.37367021276595747,0.046263345195729534,0.9537366548042705,0.6512455516014235,0.302491103202847
09118,09,118,947,373,4,369,288,81,0.3938753959873284,0.010723860589812333,0.9892761394101877,0.7721179624664879,0.21715817694369974
09119,09,119,859,384,13,371,258,113,0.4470314318975553,0.033854166666666664,0.9661458333333334,0.671875,0.2942708333333333
09120,09,120,747,344,13,331,234,97,0.4605087014725569,0.0377906976744186,0.9622093023255814,0.6802325581395349,0.2819767441860465
09121,09,121,894,349,11,338,255,83,0.39038031319910516,0.03151862464183381,0.9684813753581661,0.7306590257879656,0.23782234957020057
09122,09,122,808,299,6,293,227,66,0.37004950495049505,0.020066889632107024,0.979933110367893,0.7591973244147158,0.22073578595317725
09123,09,123,959,343,22,321,200,121,0.35766423357664234,0.0641399416909621,0.9358600583090378,0.5830903790087464,0.35276967930029157
09124,09,124,854,291,11,280,193,87,0.3407494145199063,0.037800687285223365,0.9621993127147767,0.6632302405498282,0.29896907216494845
09125,09,125,954,385,17,368,216,152,0.40356394129979034,0.04415584415584416,0.9558441558441558,0.561038961038961,0.3948051948051948
09126,09,126,908,435,11,424,302,122,0.4790748898678414,0.02528735632183908,0.9747126436781609,0.6942528735632184,0.28045977011494255
09127,09,127,994,354,16,338,238,100,0.3561368209255533,0.04519774011299435,0.9548022598870056,0.672316384180791,0.2824858757062147
09128,09,128,939,421,37,384,245,139,0.4483493077742279,0.08788598574821853,0.9121140142517815,0.5819477434679335,0.33016627078384797
09129,09,129,858,290,15,275,168,107,0.337995337995338,0.05172413793103448,0.9482758620689655,0.5793103448275863,0.3689655172413793
09130,09,130,961,371,9,362,230,132,0.38605619146722164,0.02425876010781671,0.9757412398921833,0.6199460916442049,0.3557951482479784
09131,09,131,1027,375,12,363,250,113,0.36514118792599803,0.032,0.968,0.6666666666666666,0.30133333333333334
09132,09,132,860,295,10,285,131,154,0.3430232558139535,0.03389830508474576,0.9661016949152542,0.4440677966101695,0.5220338983050847
09133,09,133,993,336,11,325,134,191,0.338368580060423,0.03273809523809524,0.9672619047619048,0.39880952380952384,0.5684523809523809
09134,09,134,760,301,9,292,201,91,0.3960526315789474,0.029900332225913623,0.9700996677740864,0.6677740863787376,0.3023255813953488
09135,09,135,772,286,9,277,184,93,0.3704663212435233,0.03146853146853147,0.9685314685314685,0.6433566433566433,0.32517482517482516
09136,09,136,842,367,6,361,253,108,0.4358669833729216,0.01634877384196185,0.9836512261580381,0.6893732970027248,0.29427792915531337
09137,09,137,800,305,6,299,202,97,0.38125,0.019672131147540985,0.980327868852459,0.6622950819672131,0.3180327868852459
09138,09,138,670,285,3,282,226,56,0.4253731343283582,0.010526315789473684,0.9894736842105263,0.7929824561403509,0.19649122807017544
09139,09,139,996,437,10,427,278,149,0.4387550200803213,0.02288329519450801,0.977116704805492,0.6361556064073226,0.34096109839816935
09140,09,140,864,332,9,323,222,101,0.38425925925925924,0.02710843373493976,0.9728915662650602,0.6686746987951807,0.3042168674698795
09141,09,141,622,253,6,247,138,109,0.4067524115755627,0.023715415019762844,0.9762845849802372,0.5454545454545454,0.4308300395256917
09142,09,142,871,333,5,328,239,89,0.3823191733639495,0.015015015015015015,0.984984984984985,0.7177177177177178,0.2672672672672673
09143,09,143,1015,418,13,405,295,110,0.41182266009852214,0.03110047846889952,0.9688995215311005,0.7057416267942583,0.2631578947368421
09201,09,201,943,353,14,339,202,137,0.3743372216330859,0.039660056657223795,0.9603399433427762,0.5722379603399433,0.3881019830028329
09202,09,202,899,288,15,273,169,104,0.3203559510567297,0.052083333333333336,0.9479166666666666,0.5868055555555556,0.3611111111111111
09203,09,203,804,278,16,262,168,94,0.34577114427860695,0.05755395683453238,0.9424460431654677,0.60431654676259,0.3381294964028777
09204,09,204,844,375,21,354,199,155,0.4443127962085308,0.056,0.944,0.5306666666666666,0.41333333333333333
09205,09,205,905,403,13,390,213,177,0.4453038674033149,0.03225806451612903,0.967741935483871,0.5285359801488834,0.4392059553349876
09206,09,206,830,348,16,332,199,133,0.41927710843373495,0.04597701149425287,0.9540229885057471,0.5718390804597702,0.382183908045977
09207,09,207,922,408,20,388,265,123,0.44251626898047725,0.049019607843137254,0.9509803921568627,0.6495098039215687,0.3014705882352941
09208,09,208,823,374,24,350,220,130,0.45443499392466585,0.06417112299465241,0.9358288770053476,0.5882352941176471,0.34759358288770054
09209,09,209,836,343,10,333,226,107,0.4102870813397129,0.029154518950437316,0.9708454810495627,0.6588921282798834,0.3119533527696793
09210,09,210,719,310,11,299,153,146,0.43115438108484005,0.035483870967741936,0.964516129032258,0.4935483870967742,0.47096774193548385
09211,09,211,976,429,7,422,184,238,0.4395491803278688,0.016317016317016316,0.9836829836829837,0.4289044289044289,0.5547785547785548
09212,09,212,983,365,12,353,154,199,0.3713123092573754,0.03287671232876712,0.9671232876712329,0.42191780821917807,0.5452054794520548
09213,09,213,998,389,20,369,237,132,0.3897795591182365,0.05141388174807198,0.9485861182519281,0.609254498714653,0.3393316195372751
09214,09,214,712,227,4,223,140,83,0.3188202247191011,0.01762114537444934,0.9823788546255506,0.6167400881057269,0.3656387665198238
09215,09,215,729,367,11,356,216,140,0.5034293552812071,0.02997275204359673,0.9700272479564033,0.5885558583106267,0.3814713896457766
09216,09,216,847,397,8,389,248,141,0.46871310507674147,0.020151133501259445,0.9798488664987406,0.6246851385390428,0.35516372795969775
09217,09,217,942,381,11,370,234,136,0.40445859872611467,0.028871391076115485,0.9711286089238845,0.6141732283464567,0.3569553805774278
09218,09,218,1059,373,9,364,249,115,0.352219074598678,0.024128686327077747,0.9758713136729222,0.6675603217158177,0.30831099195710454
09219,09,219,632,228,5,223,173,50,0.36075949367088606,0.021929824561403508,0.9780701754385965,0.7587719298245614,0.21929824561403508
09220,09,220,880,364,6,358,276,82,0.41363636363636364,0.016483516483516484,0.9835164835164835,0.7582417582417582,0.22527472527472528
09221,09,221,664,260,4,256,169,87,0.39156626506024095,0.015384615384615385,0.9846153846153847,0.65,0.3346153846153846
09222,09,222,614,253,3,250,185,65,0.41205211726384366,0.011857707509881422,0.9881422924901185,0.7312252964426877,0.25691699604743085
09223,09,223,824,364,13,351,230,121,0.441747572815534,0.03571428571428571,0.9642857142857143,0.6318681318681318,0.3324175824175824
09224,09,224,926,437,22,415,286,129,0.4719222462203024,0.05034324942791762,0.9496567505720824,0.6544622425629291,0.2951945080091533
09225,09,225,787,340,11,329,261,68,0.4320203303684879,0.03235294117647059,0.9676470588235294,0.7676470588235295,0.2
09226,09,226,854,388,9,379,246,133,0.45433255269320844,0.023195876288659795,0.9768041237113402,0.634020618556701,0.3427835051546392
09227,09,227,887,354,9,345,254,91,0.399098083427283,0.025423728813559324,0.9745762711864406,0.7175141242937854,0.2570621468926554
09228,09,228,809,356,13,343,253,90,0.4400494437577256,0.03651685393258427,0.9634831460674157,0.7106741573033708,0.25280898876404495
09229,09,229,846,328,9,319,238,81,0.3877068557919622,0.027439024390243903,0.9725609756097561,0.725609756097561,0.24695121951219512
09230,09,230,841,392,3,389,278,111,0.4661117717003567,0.007653061224489796,0.9923469387755102,0.7091836734693877,0.28316326530612246
09231,09,231,782,346,17,329,200,129,0.4424552429667519,0.049132947976878616,0.9508670520231214,0.5780346820809249,0.37283236994219654
09232,09,232,964,453,27,426,284,142,0.4699170124481328,0.059602649006622516,0.9403973509933775,0.6269315673289183,0.31346578366445915
09233,09,233,977,375,5,370,261,109,0.38382804503582396,0.013333333333333334,0.9866666666666667,0.696,0.2906666666666667
09234,09,234,1029,373,19,354,216,138,0.3624878522837707,0.05093833780160858,0.9490616621983914,0.579088471849866,0.3699731903485255
09235,09,235,925,401,13,388,248,140,0.4335135135135135,0.032418952618453865,0.9675810473815462,0.6184538653366584,0.3491271820448878
09236,09,236,876,383,11,372,271,101,0.4372146118721461,0.028720626631853787,0.9712793733681462,0.7075718015665796,0.26370757180156656
09237,09,237,872,375,9,366,230,136,0.43004587155963303,0.024,0.976,0.6133333333333333,0.3626666666666667
09238,09,238,952,362,15,347,206,141,0.3802521008403361,0.04143646408839779,0.9585635359116023,0.569060773480663,0.38950276243093923
09239,09,239,906,337,9,328,182,146,0.3719646799116998,0.026706231454005934,0.973293768545994,0.5400593471810089,0.4332344213649852
09240,09,240,824,270,10,260,190,70,0.3276699029126214,0.037037037037037035,0.9629629629629629,0.7037037037037037,0.25925925925925924
09241,09,241,1032,352,5,347,214,133,0.34108527131782945,0.014204545454545454,0.9857954545454546,0.6079545454545454,0.3778409090909091
09301,09,301,1018,459,15,444,193,251,0.45088408644400785,0.032679738562091505,0.9673202614379085,0.420479302832244,0.5468409586056645
09302,09,302,846,379,4,375,252,123,0.44799054373522457,0.010554089709762533,0.9894459102902374,0.6649076517150396,0.3245382585751979
09303,09,303,1118,460,12,448,275,173,0.41144901610017887,0.02608695652173913,0.9739130434782609,0.5978260869565217,0.3760869565217391
09304,09,304,900,372,14,358,234,124,0.41333333333333333,0.03763440860215054,0.9623655913978495,0.6290322580645161,0.3333333333333333
09305,09,305,804,353,15,338,209,129,0.43905472636815923,0.042492917847025496,0.9575070821529745,0.5920679886685553,0.3654390934844193
09306,09,306,890,370,12,358,197,161,0.4157303370786517,0.032432432432432434,0.9675675675675676,0.5324324324324324,0.43513513513513513
09307,09,307,762,328,10,318,231,87,0.4304461942257218,0.03048780487804878,0.9695121951219512,0.7042682926829268,0.2652439024390244
09308,09,308,895,374,17,357,229,128,0.41787709497206704,0.045454545454545456,0.9545454545454546,0.6122994652406417,0.3422459893048128
09309,09,309,930,424,7,417,276,141,0.4559139784946237,0.01650943396226415,0.9834905660377359,0.6509433962264151,0.33254716981132076
09310,09,310,945,435,30,405,260,145,0.4603174603174603,0.06896551724137931,0.9310344827586207,0.5977011494252874,0.3333333333333333
09311,09,311,914,416,16,400,249,151,0.4551422319474836,0.038461538461538464,0.9615384615384616,0.5985576923076923,0.3629807692307692
09312,09,312,873,348,15,333,202,131,0.39862542955326463,0.04310344827586207,0.9568965517241379,0.5804597701149425,0.3764367816091954
09313,09,313,793,289,16,273,168,105,0.3644388398486759,0.05536332179930796,0.9446366782006921,0.5813148788927336,0.3633217993079585
09314,09,314,709,265,9,256,171,85,0.37376586741889983,0.033962264150943396,0.9660377358490566,0.6452830188679245,0.32075471698113206
09315,09,315,747,258,8,250,132,118,0.3453815261044177,0.031007751937984496,0.9689922480620154,0.5116279069767442,0.4573643410852713
09316,09,316,876,357,6,351,187,164,0.4075342465753425,0.01680672268907563,0.9831932773109243,0.5238095238095238,0.45938375350140054
09317,09,317,892,333,10,323,171,152,0.37331838565022424,0.03003003003003003,0.96996996996997,0.5135135135135135,0.45645645645645644
09318,09,318,783,334,10,324,153,171,0.42656449553001274,0.029940119760479042,0.9700598802395209,0.45808383233532934,0.5119760479041916
09319,09,319,922,421,12,409,206,203,0.4566160520607375,0.028503562945368172,0.9714964370546318,0.48931116389548696,0.4821852731591449
09320,09,320,925,428,10,418,230,188,0.4627027027027027,0.02336448598130841,0.9766355140186916,0.5373831775700935,0.4392523364485981
09321,09,321,753,284,9,275,133,142,0.37715803452855245,0.03169014084507042,0.9683098591549296,0.46830985915492956,0.5
09322,09,322,917,392,11,381,198,183,0.42748091603053434,0.02806122448979592,0.9719387755102041,0.5051020408163265,0.46683673469387754
09323,09,323,841,379,6,373,175,198,0.450653983353151,0.0158311345646438,0.9841688654353562,0.46174142480211083,0.5224274406332454
09324,09,324,868,392,20,372,167,205,0.45161290322580644,0.05102040816326531,0.9489795918367347,0.4260204081632653,0.5229591836734694
09325,09,325,832,367,10,357,160,197,0.4411057692307692,0.027247956403269755,0.9727520435967303,0.4359673024523161,0.5367847411444142
09326,09,326,985,439,17,422,197,225,0.44568527918781725,0.0387243735763098,0.9612756264236902,0.44874715261959,0.5125284738041003
09327,09,327,893,501,7,494,311,183,0.561030235162374,0.013972055888223553,0.9860279441117764,0.6207584830339321,0.3652694610778443
09328,09,328,811,351,14,337,161,176,0.43279901356350187,0.039886039886039885,0.9601139601139601,0.4586894586894587,0.5014245014245015
09329,09,329,744,281,6,275,168,107,0.37768817204301075,0.021352313167259787,0.9786476868327402,0.597864768683274,0.3807829181494662
09330,09,330,772,308,7,301,198,103,0.39896373056994816,0.022727272727272728,0.9772727272727273,0.6428571428571429,0.3344155844155844
09331,09,331,813,367,9,358,243,115,0.45141451414514144,0.02452316076294278,0.9754768392370572,0.662125340599455,0.3133514986376022
09332,09,332,878,254,13,241,156,85,0.28929384965831434,0.051181102362204724,0.9488188976377953,0.6141732283464567,0.3346456692913386
09333,09,333,809,372,13,359,194,165,0.45982694684796044,0.03494623655913978,0.9650537634408602,0.521505376344086,0.4435483870967742
09334,09,334,785,334,4,330,192,138,0.42547770700636944,0.011976047904191617,0.9880239520958084,0.5748502994011976,0.41317365269461076
09335,09,335,852,374,17,357,159,198,0.43896713615023475,0.045454545454545456,0.9545454545454546,0.42513368983957217,0.5294117647058824
09336,09,336,1069,460,14,446,227,219,0.4303086997193639,0.030434782608695653,0.9695652173913043,0.4934782608695652,0.47608695652173916
09337,09,337,894,384,15,369,164,205,0.42953020134228187,0.0390625,0.9609375,0.4270833333333333,0.5338541666666666
09338,09,338,760,336,13,323,206,117,0.4421052631578947,0.03869047619047619,0.9613095238095238,0.6130952380952381,0.3482142857142857
09339,09,339,832,297,17,280,219,61,0.35697115384615385,0.05723905723905724,0.9427609427609428,0.7373737373737373,0.2053872053872054
09340,09,340,827,311,10,301,218,83,0.37605804111245467,0.03215434083601286,0.9678456591639871,0.7009646302250804,0.26688102893890675
09341,09,341,908,383,13,370,201,169,0.42180616740088106,0.033942558746736295,0.9660574412532638,0.5248041775456919,0.4412532637075718
09401,09,401,1066,447,23,424,224,200,0.41932457786116323,0.05145413870246085,0.9485458612975392,0.5011185682326622,0.44742729306487694
09402,09,402,1056,455,14,441,225,216,0.4308712121212121,0.03076923076923077,0.9692307692307692,0.4945054945054945,0.4747252747252747
09403,09,403,1031,406,13,393,188,205,0.3937924345295829,0.03201970443349754,0.9679802955665024,0.4630541871921182,0.5049261083743842
09404,09,404,847,311,17,294,153,141,0.36717827626918537,0.05466237942122187,0.9453376205787781,0.4919614147909968,0.4533762057877814
09405,09,405,815,361,12,349,172,177,0.4429447852760736,0.0332409972299169,0.9667590027700831,0.47645429362880887,0.4903047091412742
09406,09,406,796,336,14,322,151,171,0.4221105527638191,0.041666666666666664,0.9583333333333334,0.4494047619047619,0.5089285714285714
09407,09,407,893,451,19,432,212,220,0.5050391937290034,0.04212860310421286,0.9578713968957872,0.4700665188470067,0.4878048780487805
09408,09,408,887,426,15,411,183,228,0.48027057497181513,0.035211267605633804,0.9647887323943662,0.4295774647887324,0.5352112676056338
09409,09,409,814,389,21,368,172,196,0.47788697788697787,0.05398457583547558,0.9460154241645244,0.442159383033419,0.5038560411311054
09410,09,410,705,343,7,336,168,168,0.48652482269503544,0.02040816326530612,0.9795918367346939,0.4897959183673469,0.4897959183673469
09411,09,411,401,218,14,204,73,131,0.543640897755611,0.06422018348623854,0.9357798165137615,0.3348623853211009,0.6009174311926605
09412,09,412,882,455,24,431,216,215,0.5158730158730159,0.05274725274725275,0.9472527472527472,0.4747252747252747,0.4725274725274725
09413,09,413,771,409,9,400,194,206,0.5304798962386511,0.022004889975550123,0.9779951100244498,0.4743276283618582,0.5036674816625917
09414,09,414,760,313,8,305,152,153,0.4118421052631579,0.025559105431309903,0.9744408945686901,0.48562300319488816,0.48881789137380194
09415,09,415,790,309,9,300,162,138,0.3911392405063291,0.02912621359223301,0.970873786407767,0.5242718446601942,0.44660194174757284
09416,09,416,907,400,6,394,221,173,0.4410143329658214,0.015,0.985,0.5525,0.4325
09417,09,417,1089,416,19,397,224,173,0.3820018365472911,0.04567307692307692,0.9543269230769231,0.5384615384615384,0.41586538461538464
09418,09,418,1332,542,16,526,277,249,0.4069069069069069,0.02952029520295203,0.9704797047970479,0.511070110701107,0.45940959409594095
09419,09,419,840,364,14,350,180,170,0.43333333333333335,0.038461538461538464,0.9615384615384616,0.4945054945054945,0.46703296703296704
09420,09,420,799,349,10,339,247,92,0.43679599499374216,0.02865329512893983,0.9713467048710601,0.7077363896848138,0.2636103151862464
09421,09,421,763,296,9,287,165,122,0.38794233289646135,0.030405405405405407,0.9695945945945946,0.5574324324324325,0.41216216216216217
09422,09,422,814,331,10,321,219,102,0.40663390663390664,0.030211480362537766,0.9697885196374623,0.6616314199395771,0.3081570996978852
09423,09,423,882,400,13,387,262,125,0.45351473922902497,0.0325,0.9675,0.655,0.3125
09424,09,424,891,316,10,306,191,115,0.3546576879910213,0.03164556962025317,0.9683544303797469,0.6044303797468354,0.3639240506329114
09425,09,425,938,389,17,372,205,167,0.4147121535181237,0.043701799485861184,0.9562982005141388,0.5269922879177378,0.42930591259640105
09426,09,426,928,394,7,387,263,124,0.4245689655172414,0.017766497461928935,0.9822335025380711,0.6675126903553299,0.3147208121827411
09427,09,427,779,330,7,323,231,92,0.42362002567394097,0.021212121212121213,0.9787878787878788,0.7,0.2787878787878788
09428,09,428,926,377,7,370,238,132,0.40712742980561556,0.01856763925729443,0.9814323607427056,0.6312997347480106,0.35013262599469497
09429,09,429,986,372,12,360,211,149,0.3772819472616633,0.03225806451612903,0.967741935483871,0.5672043010752689,0.40053763440860213
09430,09,430,881,283,12,271,166,105,0.32122587968217936,0.04240282685512368,0.9575971731448764,0.5865724381625441,0.3710247349823322
09431,09,431,1007,450,20,430,273,157,0.4468718967229394,0.044444444444444446,0.9555555555555556,0.6066666666666667,0.3488888888888889
09432,09,432,882,369,7,362,217,145,0.41836734693877553,0.018970189701897018,0.981029810298103,0.5880758807588076,0.39295392953929537
09433,09,433,937,375,10,365,218,147,0.400213447171825,0.02666666666666667,0.9733333333333334,0.5813333333333334,0.392
09434,09,434,1065,340,13,327,191,136,0.3192488262910798,0.03823529411764706,0.961764705882353,0.5617647058823529,0.4
09435,09,435,912,324,7,317,184,133,0.35526315789473684,0.021604938271604937,0.9783950617283951,0.5679012345679012,0.4104938271604938
09436,09,436,962,412,17,395,237,158,0.4282744282744283,0.0412621359223301,0.9587378640776699,0.5752427184466019,0.38349514563106796
09437,09,437,907,421,10,411,281,130,0.46416758544652703,0.023752969121140142,0.9762470308788599,0.667458432304038,0.3087885985748218
09438,09,438,991,409,18,391,176,215,0.4127144298688194,0.044009779951100246,0.9559902200488998,0.43031784841075793,0.5256723716381418
09439,09,439,984,433,8,425,234,191,0.4400406504065041,0.018475750577367205,0.9815242494226328,0.5404157043879908,0.44110854503464203
09440,09,440,857,333,7,326,243,83,0.3885647607934656,0.021021021021021023,0.978978978978979,0.7297297297297297,0.24924924924924924
09501,09,501,886,435,19,416,272,144,0.4909706546275395,0.04367816091954023,0.9563218390804598,0.6252873563218391,0.3310344827586207
09502,09,502,877,370,8,362,239,123,0.4218928164196123,0.021621621621621623,0.9783783783783784,0.6459459459459459,0.3324324324324324
09503,09,503,900,348,11,337,230,107,0.38666666666666666,0.031609195402298854,0.9683908045977011,0.6609195402298851,0.3074712643678161
09504,09,504,912,336,24,312,190,122,0.3684210526315789,0.07142857142857142,0.9285714285714286,0.5654761904761905,0.3630952380952381
09505,09,505,945,335,18,317,209,108,0.3544973544973545,0.05373134328358209,0.9462686567164179,0.6238805970149254,0.32238805970149254
09506,09,506,908,333,14,319,198,121,0.3667400881057269,0.042042042042042045,0.9579579579579579,0.5945945945945946,0.3633633633633634
09507,09,507,766,330,12,318,203,115,0.4308093994778068,0.03636363636363636,0.9636363636363636,0.6151515151515151,0.3484848484848485
09508,09,508,822,389,22,367,229,138,0.4732360097323601,0.056555269922879174,0.9434447300771208,0.5886889460154242,0.35475578406169667
09509,09,509,1038,468,20,448,327,121,0.4508670520231214,0.042735042735042736,0.9572649572649573,0.6987179487179487,0.25854700854700857
09510,09,510,869,345,11,334,213,121,0.3970080552359033,0.03188405797101449,0.9681159420289855,0.6173913043478261,0.3507246376811594
09511,09,511,907,353,8,345,223,122,0.38919514884233736,0.0226628895184136,0.9773371104815864,0.6317280453257791,0.34560906515580736
09512,09,512,864,347,12,335,239,96,0.40162037037037035,0.0345821325648415,0.9654178674351584,0.6887608069164265,0.276657060518732
09513,09,513,820,297,7,290,171,119,0.3621951219512195,0.02356902356902357,0.9764309764309764,0.5757575757575758,0.4006734006734007
09514,09,514,778,282,8,274,161,113,0.36246786632390743,0.028368794326241134,0.9716312056737588,0.5709219858156028,0.40070921985815605
09515,09,515,862,356,12,344,200,144,0.41299303944315546,0.033707865168539325,0.9662921348314607,0.5617977528089888,0.4044943820224719
09516,09,516,956,434,17,417,220,197,0.45397489539748953,0.03917050691244239,0.9608294930875576,0.5069124423963134,0.4539170506912442
09517,09,517,907,349,18,331,188,143,0.38478500551267913,0.05157593123209169,0.9484240687679083,0.5386819484240688,0.40974212034383956
09518,09,518,957,369,11,358,152,206,0.38557993730407525,0.02981029810298103,0.9701897018970189,0.41192411924119243,0.5582655826558266
09519,09,519,953,398,19,379,173,206,0.4176285414480588,0.04773869346733668,0.9522613065326633,0.43467336683417085,0.5175879396984925
09520,09,520,1120,375,20,355,227,128,0.33482142857142855,0.05333333333333334,0.9466666666666667,0.6053333333333333,0.3413333333333333
09521,09,521,890,332,24,308,200,108,0.37303370786516854,0.07228915662650602,0.927710843373494,0.6024096385542169,0.3253012048192771
09522,09,522,925,351,19,332,175,157,0.37945945945945947,0.05413105413105413,0.9458689458689459,0.4985754985754986,0.4472934472934473
09523,09,523,980,371,18,353,223,130,0.37857142857142856,0.04851752021563342,0.9514824797843666,0.601078167115903,0.3504043126684636
09524,09,524,770,314,12,302,151,151,0.4077922077922078,0.03821656050955414,0.9617834394904459,0.48089171974522293,0.48089171974522293
09525,09,525,954,386,7,379,186,193,0.40461215932914046,0.018134715025906734,0.9818652849740933,0.48186528497409326,0.5
09526,09,526,879,363,18,345,190,155,0.4129692832764505,0.049586776859504134,0.9504132231404959,0.5234159779614325,0.42699724517906334
09527,09,527,897,356,31,325,165,160,0.39687848383500557,0.08707865168539326,0.9129213483146067,0.46348314606741575,0.449438202247191
09528,09,528,922,447,11,436,214,222,0.4848156182212581,0.024608501118568233,0.9753914988814317,0.47874720357941836,0.4966442953020134
09529,09,529,946,413,26,387,168,219,0.4365750528541226,0.06295399515738499,0.937046004842615,0.4067796610169492,0.5302663438256658
09530,09,530,907,381,15,366,146,220,0.42006615214994486,0.03937007874015748,0.9606299212598425,0.38320209973753283,0.5774278215223098
09531,09,531,1046,469,19,450,187,263,0.4483747609942639,0.04051172707889126,0.9594882729211087,0.39872068230277186,0.5607675906183369
09532,09,532,838,360,12,348,227,121,0.4295942720763723,0.03333333333333333,0.9666666666666667,0.6305555555555555,0.33611111111111114
09533,09,533,813,325,11,314,210,104,0.3997539975399754,0.033846153846153845,0.9661538461538461,0.6461538461538462,0.32
09601,09,601,841,370,10,360,162,198,0.4399524375743163,0.02702702702702703,0.972972972972973,0.43783783783783786,0.5351351351351351
09602,09,602,843,369,9,360,192,168,0.4377224199288256,0.024390243902439025,0.975609756097561,0.5203252032520326,0.45528455284552843
09603,09,603,933,408,12,396,188,208,0.43729903536977494,0.029411764705882353,0.9705882352941176,0.46078431372549017,0.5098039215686274
09604,09,604,777,366,24,342,199,143,0.47104247104247104,0.06557377049180328,0.9344262295081968,0.5437158469945356,0.3907103825136612
09605,09,605,913,421,21,400,250,150,0.4611171960569551,0.0498812351543943,0.9501187648456056,0.5938242280285035,0.35629453681710216
09606,09,606,1003,377,14,363,206,157,0.37587238285144564,0.03713527851458886,0.9628647214854111,0.5464190981432361,0.41644562334217505
09607,09,607,788,320,16,304,157,147,0.40609137055837563,0.05,0.95,0.490625,0.459375
09608,09,608,1032,405,19,386,180,206,0.39244186046511625,0.04691358024691358,0.9530864197530864,0.4444444444444444,0.508641975308642
09609,09,609,847,305,9,296,151,145,0.3600944510035419,0.029508196721311476,0.9704918032786886,0.49508196721311476,0.47540983606557374
09610,09,610,945,355,14,341,196,145,0.37566137566137564,0.03943661971830986,0.9605633802816902,0.5521126760563381,0.4084507042253521
09611,09,611,1056,523,27,496,292,204,0.4952651515151515,0.05162523900573614,0.9483747609942639,0.5583173996175909,0.390057361376673
09612,09,612,851,402,7,395,206,189,0.47238542890716806,0.017412935323383085,0.9825870646766169,0.5124378109452736,0.4701492537313433
09613,09,613,967,458,18,440,286,154,0.4736297828335057,0.039301310043668124,0.9606986899563319,0.6244541484716157,0.33624454148471616
09614,09,614,1056,415,21,394,257,137,0.39299242424242425,0.05060240963855422,0.9493975903614458,0.619277108433735,0.3301204819277108
09615,09,615,861,402,21,381,283,98,0.46689895470383275,0.05223880597014925,0.9477611940298507,0.7039800995024875,0.24378109452736318
09616,09,616,883,378,18,360,205,155,0.42808607021517553,0.047619047619047616,0.9523809523809523,0.5423280423280423,0.41005291005291006
09617,09,617,1006,365,30,335,191,144,0.3628230616302187,0.0821917808219178,0.9178082191780822,0.5232876712328767,0.39452054794520547
09618,09,618,988,427,18,409,252,157,0.43218623481781376,0.04215456674473068,0.9578454332552693,0.5901639344262295,0.36768149882903983
09619,09,619,892,340,21,319,213,106,0.3811659192825112,0.061764705882352944,0.9382352941176471,0.6264705882352941,0.31176470588235294
09620,09,620,1045,430,13,417,246,171,0.41148325358851673,0.030232558139534883,0.9697674418604652,0.5720930232558139,0.39767441860465114
09621,09,621,892,330,12,318,224,94,0.36995515695067266,0.03636363636363636,0.9636363636363636,0.6787878787878788,0.28484848484848485
09622,09,622,941,439,12,427,271,156,0.4665249734325186,0.02733485193621868,0.9726651480637813,0.6173120728929385,0.3553530751708428
09623,09,623,985,423,17,406,254,152,0.4294416243654822,0.04018912529550828,0.9598108747044918,0.6004728132387707,0.35933806146572106
09624,09,624,1001,419,14,405,287,118,0.41858141858141856,0.03341288782816229,0.9665871121718377,0.684964200477327,0.28162291169451076
09625,09,625,863,371,5,366,241,125,0.4298957126303592,0.013477088948787063,0.9865229110512129,0.6495956873315364,0.33692722371967654
09626,09,626,936,429,7,422,275,147,0.4583333333333333,0.016317016317016316,0.9836829836829837,0.6410256410256411,0.34265734265734266
09627,09,627,986,298,7,291,161,130,0.3022312373225152,0.02348993288590604,0.9765100671140939,0.540268456375839,0.436241610738255
09628,09,628,819,331,13,318,160,158,0.40415140415140416,0.03927492447129909,0.9607250755287009,0.48338368580060426,0.4773413897280967
09629,09,629,1032,435,24,411,205,206,0.42151162790697677,0.05517241379310345,0.9448275862068966,0.47126436781609193,0.4735632183908046
09630,09,630,924,373,8,365,163,202,0.4036796536796537,0.021447721179624665,0.9785522788203753,0.43699731903485256,0.5415549597855228
09631,09,631,814,360,11,349,151,198,0.44226044226044225,0.030555555555555555,0.9694444444444444,0.41944444444444445,0.55
09632,09,632,875,379,20,359,165,194,0.43314285714285716,0.052770448548812667,0.9472295514511874,0.43535620052770446,0.5118733509234829
09633,09,633,969,409,16,393,201,192,0.42208462332301344,0.039119804400977995,0.960880195599022,0.49144254278728605,0.46943765281173594
09634,09,634,983,378,17,361,173,188,0.38453713123092575,0.04497354497354497,0.955026455026455,0.4576719576719577,0.4973544973544973
09635,09,635,1288,591,28,563,259,304,0.4588509316770186,0.047377326565143825,0.9526226734348562,0.43824027072758037,0.5143824027072758
09636,09,636,967,433,25,408,170,238,0.44777662874870733,0.057736720554272515,0.9422632794457275,0.39260969976905313,0.5496535796766744
091A,09,1A,0,857,5,852,645,207,inf,0.005834305717619603,0.9941656942823804,0.7526254375729288,0.24154025670945156
091B,09,1B,0,494,3,491,361,130,inf,0.006072874493927126,0.9939271255060729,0.7307692307692307,0.2631578947368421
091C,09,1C,0,668,3,665,465,200,inf,0.004491017964071856,0.9955089820359282,0.6961077844311377,0.2994011976047904
091D,09,1D,0,578,5,573,447,126,inf,0.00865051903114187,0.9913494809688581,0.773356401384083,0.2179930795847751
091E,09,1E,0,553,2,551,427,124,inf,0.003616636528028933,0.9963833634719711,0.7721518987341772,0.22423146473779385
091F,09,1F,0,922,7,915,648,267,inf,0.007592190889370932,0.9924078091106291,0.702819956616052,0.289587852494577
091G,09,1G,0,482,4,478,333,145,inf,0.008298755186721992,0.991701244813278,0.6908713692946058,0.3008298755186722
091H,09,1H,0,471,6,465,329,136,inf,0.012738853503184714,0.9872611464968153,0.6985138004246284,0.28874734607218683
091I,09,1I,0,460,8,452,318,134,inf,0.017391304347826087,0.9826086956521739,0.691304347826087,0.29130434782608694
091J,09,1J,0,523,13,510,366,144,inf,0.0248565965583174,0.9751434034416826,0.6998087954110899,0.27533460803059273
091K,09,1K,0,565,11,554,380,174,inf,0.019469026548672566,0.9805309734513274,0.672566371681416,0.30796460176991153
091L,09,1L,0,478,10,468,321,147,inf,0.02092050209205021,0.9790794979079498,0.6715481171548117,0.3075313807531381
091M,09,1M,0,542,5,537,370,167,inf,0.00922509225092251,0.9907749077490775,0.6826568265682657,0.3081180811808118
091N,09,1N,0,696,8,688,470,218,inf,0.011494252873563218,0.9885057471264368,0.6752873563218391,0.3132183908045977
091P,09,1P,0,496,11,485,327,158,inf,0.02217741935483871,0.9778225806451613,0.6592741935483871,0.3185483870967742
091Q,09,1Q,0,748,18,730,500,230,inf,0.02406417112299465,0.9759358288770054,0.6684491978609626,0.3074866310160428
091R,09,1R,0,815,4,811,390,421,inf,0.0049079754601227,0.9950920245398773,0.4785276073619632,0.5165644171779141
091S,09,1S,0,681,6,675,523,152,inf,0.00881057268722467,0.9911894273127754,0.7679882525697503,0.22320117474302498
091T,09,1T,0,365,6,359,240,119,inf,0.01643835616438356,0.9835616438356164,0.6575342465753424,0.32602739726027397
091U,09,1U,0,657,10,647,428,219,inf,0.015220700152207,0.984779299847793,0.6514459665144596,0.3333333333333333
091V,09,1V,0,514,4,510,365,145,inf,0.007782101167315175,0.9922178988326849,0.7101167315175098,0.2821011673151751
092A,09,2A,0,705,5,700,454,246,inf,0.0070921985815602835,0.9929078014184397,0.6439716312056738,0.34893617021276596
092B,09,2B,0,525,8,517,322,195,inf,0.015238095238095238,0.9847619047619047,0.6133333333333333,0.37142857142857144
092C,09,2C,0,592,5,587,299,288,inf,0.008445945945945946,0.9915540540540541,0.5050675675675675,0.4864864864864865
092D,09,2D,0,441,3,438,313,125,inf,0.006802721088435374,0.9931972789115646,0.7097505668934241,0.2834467120181406
092E,09,2E,0,683,7,676,436,240,inf,0.010248901903367497,0.9897510980966325,0.6383601756954612,0.3513909224011713
092F,09,2F,0,522,5,517,322,195,inf,0.009578544061302681,0.9904214559386973,0.6168582375478927,0.3735632183908046
092G,09,2G,0,511,9,502,333,169,inf,0.01761252446183953,0.9823874755381604,0.6516634050880626,0.33072407045009783
092H,09,2H,0,642,10,632,336,296,inf,0.01557632398753894,0.9844236760124611,0.5233644859813084,0.46105919003115264
092I,09,2I,0,534,6,528,357,171,inf,0.011235955056179775,0.9887640449438202,0.6685393258426966,0.3202247191011236
092J,09,2J,0,651,10,641,454,187,inf,0.015360983102918587,0.9846390168970814,0.6973886328725039,0.2872503840245776
092K,09,2K,0,529,13,516,307,209,inf,0.024574669187145556,0.9754253308128544,0.5803402646502835,0.3950850661625709
092L,09,2L,0,680,14,666,427,239,inf,0.020588235294117647,0.9794117647058823,0.6279411764705882,0.3514705882352941
092M,09,2M,0,403,8,395,281,114,inf,0.019851116625310174,0.9801488833746899,0.6972704714640199,0.28287841191067
092N,09,2N,0,625,11,614,422,192,inf,0.0176,0.9824,0.6752,0.3072
092P,09,2P,0,522,8,514,376,138,inf,0.01532567049808429,0.9846743295019157,0.7203065134099617,0.26436781609195403
092Q,09,2Q,0,454,6,448,314,134,inf,0.013215859030837005,0.986784140969163,0.6916299559471366,0.29515418502202645
092R,09,2R,0,460,3,457,353,104,inf,0.006521739130434782,0.9934782608695653,0.7673913043478261,0.22608695652173913
092S,09,2S,0,414,6,408,291,117,inf,0.014492753623188406,0.9855072463768116,0.7028985507246377,0.2826086956521739
092T,09,2T,0,511,4,507,363,144,inf,0.007827788649706457,0.9921722113502935,0.7103718199608611,0.28180039138943247
092U,09,2U,0,451,8,443,316,127,inf,0.017738359201773836,0.9822616407982262,0.7006651884700665,0.28159645232815966
092V,09,2V,0,442,8,434,316,118,inf,0.01809954751131222,0.9819004524886877,0.7149321266968326,0.2669683257918552
093A,09,3A,0,653,14,639,352,287,inf,0.021439509954058193,0.9785604900459418,0.5390505359877489,0.43950995405819293
093B,09,3B,0,579,5,574,376,198,inf,0.008635578583765112,0.9913644214162349,0.6493955094991365,0.34196891191709844
093C,09,3C,0,549,11,538,349,189,inf,0.020036429872495445,0.9799635701275046,0.6357012750455373,0.3442622950819672
093D,09,3D,0,607,6,601,352,249,inf,0.009884678747940691,0.9901153212520593,0.5799011532125206,0.4102141680395387
093E,09,3E,0,441,10,431,287,144,inf,0.022675736961451247,0.9773242630385488,0.6507936507936508,0.32653061224489793
093F,09,3F,0,607,7,600,381,219,inf,0.011532125205930808,0.9884678747940692,0.627677100494234,0.36079077429983525
093G,09,3G,0,500,9,491,345,146,inf,0.018,0.982,0.69,0.292
093H,09,3H,0,702,5,697,339,358,inf,0.007122507122507123,0.9928774928774928,0.4829059829059829,0.50997150997151
093I,09,3I,0,582,8,574,252,322,inf,0.013745704467353952,0.9862542955326461,0.4329896907216495,0.5532646048109966
093J,09,3J,0,587,4,583,290,293,inf,0.0068143100511073255,0.9931856899488927,0.4940374787052811,0.4991482112436116
093K,09,3K,0,624,7,617,349,268,inf,0.011217948717948718,0.9887820512820513,0.5592948717948718,0.42948717948717946
093L,09,3L,0,592,5,587,315,272,inf,0.008445945945945946,0.9915540540540541,0.5320945945945946,0.4594594594594595
093M,09,3M,0,703,11,692,345,347,inf,0.015647226173541962,0.984352773826458,0.4907539118065434,0.49359886201991465
093N,09,3N,0,571,4,567,325,242,inf,0.0070052539404553416,0.9929947460595446,0.5691768826619965,0.4238178633975482
093P,09,3P,0,422,4,418,272,146,inf,0.009478672985781991,0.990521327014218,0.6445497630331753,0.3459715639810427
093Q,09,3Q,0,362,12,350,233,117,inf,0.03314917127071823,0.9668508287292817,0.643646408839779,0.32320441988950277
093R,09,3R,0,525,9,516,274,242,inf,0.017142857142857144,0.9828571428571429,0.5219047619047619,0.46095238095238095
093S,09,3S,0,576,38,538,303,235,inf,0.06597222222222222,0.9340277777777778,0.5260416666666666,0.4079861111111111
093T,09,3T,0,333,7,326,140,186,inf,0.021021021021021023,0.978978978978979,0.42042042042042044,0.5585585585585585
093U,09,3U,0,218,2,216,162,54,inf,0.009174311926605505,0.9908256880733946,0.7431192660550459,0.24770642201834864
093V,09,3V,0,344,4,340,207,133,inf,0.011627906976744186,0.9883720930232558,0.6017441860465116,0.3866279069767442
094A,09,4A,0,608,12,596,318,278,inf,0.019736842105263157,0.9802631578947368,0.5230263157894737,0.45723684210526316
094B,09,4B,0,691,8,683,343,340,inf,0.011577424023154847,0.9884225759768451,0.4963820549927641,0.492040520984081
094C,09,4C,0,603,10,593,326,267,inf,0.01658374792703151,0.9834162520729685,0.5406301824212272,0.4427860696517413
094D,09,4D,0,622,8,614,343,271,inf,0.012861736334405145,0.9871382636655949,0.5514469453376206,0.43569131832797425
094E,09,4E,0,643,8,635,338,297,inf,0.012441679626749611,0.9875583203732504,0.5256609642301711,0.4618973561430793
094F,09,4F,0,556,7,549,274,275,inf,0.012589928057553957,0.987410071942446,0.49280575539568344,0.49460431654676257
094G,09,4G,0,358,1,357,180,177,inf,0.002793296089385475,0.9972067039106145,0.5027932960893855,0.49441340782122906
094H,09,4H,0,671,10,661,346,315,inf,0.014903129657228018,0.9850968703427719,0.5156482861400894,0.46944858420268254
094I,09,4I,0,646,5,641,345,296,inf,0.007739938080495356,0.9922600619195047,0.5340557275541795,0.4582043343653251
094J,09,4J,0,589,9,580,348,232,inf,0.015280135823429542,0.9847198641765704,0.5908319185059423,0.3938879456706282
094K,09,4K,0,782,15,767,389,378,inf,0.01918158567774936,0.9808184143222506,0.49744245524296676,0.4833759590792839
094L,09,4L,0,336,3,333,241,92,inf,0.008928571428571428,0.9910714285714286,0.7172619047619048,0.27380952380952384
094M,09,4M,0,546,6,540,332,208,inf,0.01098901098901099,0.989010989010989,0.608058608058608,0.38095238095238093
094N,09,4N,0,561,8,553,355,198,inf,0.0142602495543672,0.9857397504456328,0.6327985739750446,0.35294117647058826
094P,09,4P,0,461,2,459,314,145,inf,0.004338394793926247,0.9956616052060737,0.6811279826464208,0.31453362255965295
094Q,09,4Q,0,789,13,776,456,320,inf,0.016476552598225603,0.9835234474017744,0.5779467680608364,0.4055766793409379
094R,09,4R,0,740,7,733,401,332,inf,0.00945945945945946,0.9905405405405405,0.5418918918918919,0.4486486486486487
094S,09,4S,0,702,13,689,457,232,inf,0.018518518518518517,0.9814814814814815,0.6509971509971509,0.33048433048433046
094T,09,4T,0,745,10,735,449,286,inf,0.013422818791946308,0.9865771812080537,0.6026845637583893,0.3838926174496644
094U,09,4U,0,473,1,472,328,144,inf,0.0021141649048625794,0.9978858350951374,0.693446088794926,0.3044397463002114
095A,09,5A,0,526,6,520,359,161,inf,0.011406844106463879,0.9885931558935361,0.6825095057034221,0.3060836501901141
095B,09,5B,0,510,1,509,366,143,inf,0.00196078431372549,0.9980392156862745,0.7176470588235294,0.2803921568627451
095C,09,5C,0,647,7,640,372,268,inf,0.010819165378670788,0.9891808346213292,0.5749613601236476,0.4142194744976816
095D,09,5D,0,555,10,545,386,159,inf,0.018018018018018018,0.9819819819819819,0.6954954954954955,0.2864864864864865
095E,09,5E,0,695,9,686,368,318,inf,0.012949640287769784,0.9870503597122302,0.5294964028776978,0.45755395683453237
095F,09,5F,0,680,6,674,349,325,inf,0.008823529411764706,0.9911764705882353,0.513235294117647,0.47794117647058826
095G,09,5G,0,679,10,669,367,302,inf,0.014727540500736377,0.9852724594992637,0.540500736377025,0.44477172312223856
095H,09,5H,0,668,6,662,311,351,inf,0.008982035928143712,0.9910179640718563,0.4655688622754491,0.5254491017964071
095I,09,5I,0,398,7,391,255,136,inf,0.017587939698492462,0.9824120603015075,0.6407035175879398,0.3417085427135678
095J,09,5J,0,805,55,750,424,326,inf,0.06832298136645963,0.9316770186335404,0.5267080745341615,0.4049689440993789
095K,09,5K,0,534,9,525,377,148,inf,0.016853932584269662,0.9831460674157303,0.7059925093632958,0.27715355805243447
095L,09,5L,0,474,6,468,302,166,inf,0.012658227848101266,0.9873417721518988,0.6371308016877637,0.350210970464135
095M,09,5M,0,667,10,657,457,200,inf,0.014992503748125937,0.9850074962518741,0.6851574212893553,0.29985007496251875
095N,09,5N,0,549,16,533,353,180,inf,0.029143897996357013,0.970856102003643,0.6429872495446266,0.32786885245901637
095P,09,5P,0,512,10,502,309,193,inf,0.01953125,0.98046875,0.603515625,0.376953125
095Q,09,5Q,0,719,1,718,399,319,inf,0.0013908205841446453,0.9986091794158554,0.5549374130737135,0.44367176634214184
095R,09,5R,0,376,11,365,242,123,inf,0.02925531914893617,0.9707446808510638,0.6436170212765957,0.3271276595744681
096A,09,6A,0,723,8,715,375,340,inf,0.011065006915629323,0.9889349930843707,0.5186721991701245,0.4702627939142462
096B,09,6B,0,705,4,701,373,328,inf,0.005673758865248227,0.9943262411347518,0.5290780141843971,0.4652482269503546
096C,09,6C,0,728,11,717,431,286,inf,0.01510989010989011,0.9848901098901099,0.592032967032967,0.39285714285714285
096D,09,6D,0,563,11,552,317,235,inf,0.019538188277087035,0.9804618117229129,0.5630550621669627,0.41740674955595025
096E,09,6E,0,492,4,488,312,176,inf,0.008130081300813009,0.991869918699187,0.6341463414634146,0.35772357723577236
096F,09,6F,0,674,5,669,392,277,inf,0.00741839762611276,0.9925816023738873,0.5816023738872403,0.41097922848664686
096G,09,6G,0,641,8,633,392,241,inf,0.0124804992199688,0.9875195007800313,0.6115444617784711,0.37597503900156004
096H,09,6H,0,728,14,714,448,266,inf,0.019230769230769232,0.9807692307692307,0.6153846153846154,0.36538461538461536
096I,09,6I,0,715,11,704,451,253,inf,0.015384615384615385,0.9846153846153847,0.6307692307692307,0.35384615384615387
096J,09,6J,0,853,7,846,474,372,inf,0.008206330597889801,0.9917936694021102,0.5556858147713951,0.4361078546307151
096K,09,6K,0,500,14,486,325,161,inf,0.028,0.972,0.65,0.322
096L,09,6L,0,686,7,679,452,227,inf,0.01020408163265306,0.9897959183673469,0.6588921282798834,0.33090379008746357
096M,09,6M,0,693,7,686,427,259,inf,0.010101010101010102,0.98989898989899,0.6161616161616161,0.37373737373737376
096N,09,6N,0,654,8,646,369,277,inf,0.012232415902140673,0.9877675840978594,0.5642201834862385,0.4235474006116208
096P,09,6P,0,744,15,729,395,334,inf,0.020161290322580645,0.9798387096774194,0.5309139784946236,0.4489247311827957
096Q,09,6Q,0,724,13,711,348,363,inf,0.017955801104972375,0.9820441988950276,0.48066298342541436,0.5013812154696132
096R,09,6R,0,723,7,716,325,391,inf,0.009681881051175657,0.9903181189488244,0.44951590594744123,0.5408022130013831
096S,09,6S,0,686,11,675,358,317,inf,0.016034985422740525,0.9839650145772595,0.521865889212828,0.4620991253644315
10101,10,101,1402,565,19,546,401,145,0.4029957203994294,0.033628318584070796,0.9663716814159292,0.7097345132743362,0.25663716814159293
10102,10,102,1395,561,21,540,387,153,0.4021505376344086,0.0374331550802139,0.9625668449197861,0.6898395721925134,0.2727272727272727
10103,10,103,1122,407,6,401,284,117,0.3627450980392157,0.014742014742014743,0.9852579852579852,0.6977886977886978,0.28746928746928746
10104,10,104,1332,540,19,521,349,172,0.40540540540540543,0.03518518518518519,0.9648148148148148,0.6462962962962963,0.31851851851851853
10105,10,105,1233,501,16,485,320,165,0.40632603406326034,0.031936127744510975,0.9680638722554891,0.6387225548902196,0.32934131736526945
10106,10,106,1218,512,24,488,354,134,0.42036124794745483,0.046875,0.953125,0.69140625,0.26171875
10107,10,107,1296,504,25,479,320,159,0.3888888888888889,0.0496031746031746,0.9503968253968254,0.6349206349206349,0.31547619047619047
10108,10,108,1303,448,16,432,310,122,0.34382194934765925,0.03571428571428571,0.9642857142857143,0.6919642857142857,0.27232142857142855
10109,10,109,1369,454,25,429,301,128,0.3316289262235208,0.05506607929515418,0.9449339207048458,0.6629955947136564,0.28193832599118945
10110,10,110,1304,409,22,387,266,121,0.3136503067484663,0.05378973105134474,0.9462102689486552,0.6503667481662592,0.29584352078239606
10111,10,111,1114,416,14,402,277,125,0.3734290843806104,0.03365384615384615,0.9663461538461539,0.6658653846153846,0.3004807692307692
10112,10,112,1097,403,19,384,264,120,0.3673655423883318,0.04714640198511166,0.9528535980148883,0.6550868486352357,0.2977667493796526
10113,10,113,1161,442,21,421,283,138,0.3807062876830319,0.04751131221719457,0.9524886877828054,0.6402714932126696,0.31221719457013575
10114,10,114,1519,546,26,520,359,161,0.35944700460829493,0.047619047619047616,0.9523809523809523,0.6575091575091575,0.2948717948717949
10115,10,115,1295,507,23,484,308,176,0.3915057915057915,0.045364891518737675,0.9546351084812623,0.6074950690335306,0.34714003944773175
10116,10,116,1158,451,23,428,327,101,0.38946459412780654,0.050997782705099776,0.9490022172949002,0.7250554323725056,0.22394678492239467
10117,10,117,1271,456,24,432,262,170,0.35877261998426435,0.05263157894736842,0.9473684210526315,0.5745614035087719,0.37280701754385964
10118,10,118,1262,575,28,547,330,217,0.45562599049128366,0.04869565217391304,0.951304347826087,0.5739130434782609,0.3773913043478261
10119,10,119,1230,495,10,485,294,191,0.4024390243902439,0.020202020202020204,0.9797979797979798,0.593939393939394,0.38585858585858585
10120,10,120,1166,409,10,399,280,119,0.3507718696397942,0.02444987775061125,0.9755501222493888,0.684596577017115,0.29095354523227385
10121,10,121,1273,506,18,488,188,300,0.3974862529457973,0.03557312252964427,0.9644268774703557,0.3715415019762846,0.5928853754940712
10122,10,122,1252,480,22,458,215,243,0.38338658146964855,0.04583333333333333,0.9541666666666667,0.4479166666666667,0.50625
10123,10,123,1244,535,22,513,356,157,0.430064308681672,0.041121495327102804,0.9588785046728971,0.6654205607476635,0.29345794392523367
10124,10,124,1177,439,21,418,291,127,0.372982158028887,0.04783599088838269,0.9521640091116174,0.662870159453303,0.28929384965831434
10125,10,125,1224,417,14,403,259,144,0.34068627450980393,0.03357314148681055,0.9664268585131894,0.6211031175059952,0.34532374100719426
10201,10,201,1334,518,38,480,310,170,0.38830584707646176,0.07335907335907337,0.9266409266409267,0.5984555984555985,0.3281853281853282
10202,10,202,1193,474,15,459,356,103,0.39731768650461025,0.03164556962025317,0.9683544303797469,0.7510548523206751,0.21729957805907174
10203,10,203,1203,378,12,366,239,127,0.314214463840399,0.031746031746031744,0.9682539682539683,0.6322751322751323,0.335978835978836
10204,10,204,1175,364,16,348,189,159,0.3097872340425532,0.04395604395604396,0.9560439560439561,0.5192307692307693,0.4368131868131868
10205,10,205,1188,409,27,382,244,138,0.3442760942760943,0.06601466992665037,0.9339853300733496,0.5965770171149144,0.3374083129584352
10206,10,206,1172,407,18,389,205,184,0.34726962457337884,0.044226044226044224,0.9557739557739557,0.5036855036855037,0.4520884520884521
10207,10,207,1211,423,19,404,256,148,0.34929810074318746,0.04491725768321513,0.9550827423167849,0.6052009456264775,0.34988179669030733
10208,10,208,1339,538,15,523,282,241,0.40179238237490666,0.027881040892193308,0.9721189591078067,0.5241635687732342,0.4479553903345725
10209,10,209,1344,503,14,489,276,213,0.3742559523809524,0.027833001988071572,0.9721669980119284,0.5487077534791253,0.4234592445328032
10210,10,210,1379,542,22,520,338,182,0.3930384336475707,0.04059040590405904,0.959409594095941,0.6236162361623616,0.33579335793357934
10211,10,211,1388,547,23,524,295,229,0.3940922190201729,0.04204753199268738,0.9579524680073126,0.5393053016453382,0.4186471663619744
10212,10,212,1296,842,428,414,226,188,0.6496913580246914,0.5083135391923991,0.4916864608076009,0.2684085510688836,0.22327790973871733
10213,10,213,1332,454,19,435,287,148,0.3408408408408408,0.04185022026431718,0.9581497797356828,0.6321585903083701,0.32599118942731276
10214,10,214,1340,607,9,598,409,189,0.45298507462686566,0.014827018121911038,0.985172981878089,0.6738056013179572,0.3113673805601318
10215,10,215,1346,473,21,452,300,152,0.3514115898959881,0.04439746300211417,0.9556025369978859,0.6342494714587738,0.321353065539112
10216,10,216,1154,496,19,477,343,134,0.42980935875216636,0.038306451612903226,0.9616935483870968,0.6915322580645161,0.2701612903225806
10217,10,217,1244,492,26,466,255,211,0.3954983922829582,0.052845528455284556,0.9471544715447154,0.5182926829268293,0.42886178861788615
10218,10,218,1197,517,24,493,268,225,0.4319131161236424,0.04642166344294004,0.9535783365570599,0.5183752417794971,0.43520309477756286
10219,10,219,1123,417,11,406,207,199,0.371326803205699,0.026378896882494004,0.973621103117506,0.49640287769784175,0.47721822541966424
10220,10,220,1154,405,18,387,231,156,0.3509532062391681,0.044444444444444446,0.9555555555555556,0.5703703703703704,0.3851851851851852
10221,10,221,1138,435,7,428,218,210,0.38224956063268895,0.016091954022988506,0.9839080459770115,0.5011494252873563,0.4827586206896552
10222,10,222,1164,461,22,439,214,225,0.3960481099656357,0.04772234273318872,0.9522776572668112,0.4642082429501085,0.4880694143167028
10223,10,223,1097,448,19,429,282,147,0.4083865086599818,0.04241071428571429,0.9575892857142857,0.6294642857142857,0.328125
10224,10,224,1103,425,23,402,244,158,0.38531278331822305,0.05411764705882353,0.9458823529411765,0.5741176470588235,0.37176470588235294
10225,10,225,1194,485,25,460,248,212,0.40619765494137355,0.05154639175257732,0.9484536082474226,0.511340206185567,0.43711340206185567
10226,10,226,1165,463,20,443,266,177,0.39742489270386266,0.04319654427645788,0.9568034557235421,0.5745140388768899,0.38228941684665224
10227,10,227,1062,318,12,306,171,135,0.2994350282485876,0.03773584905660377,0.9622641509433962,0.5377358490566038,0.42452830188679247
10301,10,301,1518,602,20,582,396,186,0.3965744400527009,0.03322259136212625,0.9667774086378738,0.6578073089700996,0.3089700996677741
10302,10,302,1449,563,20,543,393,150,0.388543823326432,0.035523978685612786,0.9644760213143873,0.6980461811722913,0.2664298401420959
10303,10,303,1418,476,10,466,349,117,0.33568406205923834,0.02100840336134454,0.9789915966386554,0.7331932773109243,0.24579831932773108
10304,10,304,1267,356,16,340,257,83,0.2809786898184688,0.0449438202247191,0.9550561797752809,0.7219101123595506,0.23314606741573032
10305,10,305,1398,477,12,465,340,125,0.34120171673819744,0.025157232704402517,0.9748427672955975,0.7127882599580713,0.2620545073375262
10306,10,306,1172,380,9,371,268,103,0.3242320819112628,0.02368421052631579,0.9763157894736842,0.7052631578947368,0.2710526315789474
10307,10,307,976,397,12,385,242,143,0.4067622950819672,0.030226700251889168,0.9697732997481109,0.6095717884130982,0.3602015113350126
10308,10,308,1342,507,12,495,268,227,0.37779433681073027,0.023668639053254437,0.9763313609467456,0.5285996055226825,0.4477317554240631
10309,10,309,1376,540,23,517,300,217,0.39244186046511625,0.04259259259259259,0.9574074074074074,0.5555555555555556,0.40185185185185185
10310,10,310,1273,500,15,485,271,214,0.3927729772191673,0.03,0.97,0.542,0.428
10311,10,311,861,349,10,339,250,89,0.40534262485482,0.02865329512893983,0.9713467048710601,0.7163323782234957,0.25501432664756446
10312,10,312,1058,384,13,371,273,98,0.3629489603024575,0.033854166666666664,0.9661458333333334,0.7109375,0.2552083333333333
10313,10,313,1137,444,13,431,309,122,0.39050131926121373,0.02927927927927928,0.9707207207207207,0.6959459459459459,0.2747747747747748
10314,10,314,972,362,33,329,229,100,0.3724279835390947,0.09116022099447514,0.9088397790055248,0.6325966850828729,0.27624309392265195
10315,10,315,1240,467,11,456,317,139,0.37661290322580643,0.023554603854389723,0.9764453961456103,0.6788008565310493,0.29764453961456105
10316,10,316,1286,523,23,500,348,152,0.40668740279937793,0.04397705544933078,0.9560229445506692,0.6653919694072657,0.29063097514340347
10317,10,317,1209,420,14,406,309,97,0.34739454094292804,0.03333333333333333,0.9666666666666667,0.7357142857142858,0.23095238095238096
10318,10,318,1182,468,20,448,335,113,0.39593908629441626,0.042735042735042736,0.9572649572649573,0.7158119658119658,0.24145299145299146
10319,10,319,1122,418,5,413,306,107,0.37254901960784315,0.011961722488038277,0.9880382775119617,0.7320574162679426,0.25598086124401914
10320,10,320,1112,491,20,471,346,125,0.44154676258992803,0.04073319755600815,0.9592668024439919,0.7046843177189409,0.2545824847250509
10321,10,321,1409,496,16,480,316,164,0.3520227111426544,0.03225806451612903,0.967741935483871,0.6370967741935484,0.33064516129032256
10322,10,322,1383,502,24,478,274,204,0.36297903109182933,0.04780876494023904,0.952191235059761,0.545816733067729,0.4063745019920319
10323,10,323,1043,377,10,367,226,141,0.36145733461169705,0.026525198938992044,0.9734748010610079,0.5994694960212201,0.3740053050397878
10324,10,324,1392,560,18,542,337,205,0.40229885057471265,0.03214285714285714,0.9678571428571429,0.6017857142857143,0.36607142857142855
10325,10,325,1105,442,11,431,280,151,0.4,0.024886877828054297,0.9751131221719457,0.6334841628959276,0.3416289592760181
10326,10,326,1204,548,24,524,315,209,0.45514950166112955,0.043795620437956206,0.9562043795620438,0.5748175182481752,0.3813868613138686
10327,10,327,1178,486,23,463,279,184,0.41256366723259763,0.047325102880658436,0.9526748971193416,0.5740740740740741,0.3786008230452675
10401,10,401,1219,425,16,409,283,126,0.34864643150123054,0.03764705882352941,0.9623529411764706,0.6658823529411765,0.2964705882352941
10402,10,402,1199,406,13,393,251,142,0.3386155129274395,0.03201970443349754,0.9679802955665024,0.6182266009852216,0.3497536945812808
10403,10,403,1210,505,23,482,354,128,0.41735537190082644,0.04554455445544554,0.9544554455445544,0.700990099009901,0.25346534653465347
10404,10,404,1174,455,16,439,291,148,0.38756388415672915,0.035164835164835165,0.9648351648351648,0.6395604395604395,0.3252747252747253
10405,10,405,1189,463,7,456,312,144,0.3894028595458368,0.01511879049676026,0.9848812095032398,0.673866090712743,0.31101511879049676
10406,10,406,1335,485,20,465,322,143,0.36329588014981273,0.041237113402061855,0.9587628865979382,0.6639175257731958,0.2948453608247423
10407,10,407,766,360,16,344,176,168,0.4699738903394256,0.044444444444444446,0.9555555555555556,0.4888888888888889,0.4666666666666667
10408,10,408,753,328,8,320,150,170,0.4355909694555113,0.024390243902439025,0.975609756097561,0.4573170731707317,0.5182926829268293
10409,10,409,1308,417,10,407,243,164,0.31880733944954126,0.023980815347721823,0.9760191846522782,0.5827338129496403,0.3932853717026379
10410,10,410,1223,425,10,415,265,150,0.3475061324611611,0.023529411764705882,0.9764705882352941,0.6235294117647059,0.35294117647058826
10411,10,411,1119,421,27,394,268,126,0.3762287756925827,0.06413301662707839,0.9358669833729216,0.6365795724465558,0.2992874109263658
10412,10,412,1239,468,12,456,207,249,0.37772397094430993,0.02564102564102564,0.9743589743589743,0.4423076923076923,0.532051282051282
10413,10,413,1248,864,436,428,198,230,0.6923076923076923,0.5046296296296297,0.49537037037037035,0.22916666666666666,0.2662037037037037
10414,10,414,1112,432,8,424,211,213,0.38848920863309355,0.018518518518518517,0.9814814814814815,0.48842592592592593,0.4930555555555556
10415,10,415,1113,381,13,368,255,113,0.3423180592991914,0.03412073490813648,0.9658792650918635,0.6692913385826772,0.29658792650918636
10416,10,416,1255,578,38,540,289,251,0.4605577689243028,0.0657439446366782,0.9342560553633218,0.5,0.4342560553633218
10417,10,417,1150,489,32,457,281,176,0.4252173913043478,0.065439672801636,0.934560327198364,0.5746421267893661,0.35991820040899797
10418,10,418,1188,450,10,440,318,122,0.3787878787878788,0.022222222222222223,0.9777777777777777,0.7066666666666667,0.27111111111111114
10419,10,419,1241,400,10,390,179,211,0.32232070910556004,0.025,0.975,0.4475,0.5275
10420,10,420,1356,471,8,463,214,249,0.3473451327433628,0.016985138004246284,0.9830148619957537,0.4543524416135881,0.5286624203821656
10421,10,421,1276,552,13,539,280,259,0.43260188087774293,0.02355072463768116,0.9764492753623188,0.5072463768115942,0.4692028985507246
10422,10,422,663,243,9,234,161,73,0.3665158371040724,0.037037037037037035,0.9629629629629629,0.6625514403292181,0.3004115226337449
10423,10,423,1013,387,12,375,167,208,0.3820335636722606,0.031007751937984496,0.9689922480620154,0.4315245478036176,0.537467700258398
10424,10,424,758,336,9,327,105,222,0.44327176781002636,0.026785714285714284,0.9732142857142857,0.3125,0.6607142857142857
10425,10,425,1138,445,18,427,184,243,0.39103690685413006,0.04044943820224719,0.9595505617977528,0.4134831460674157,0.5460674157303371
10426,10,426,1062,481,23,458,169,289,0.4529190207156309,0.04781704781704782,0.9521829521829522,0.35135135135135137,0.6008316008316008
10427,10,427,1121,439,17,422,201,221,0.39161462979482603,0.0387243735763098,0.9612756264236902,0.45785876993166286,0.5034168564920274
10428,10,428,1060,402,17,385,152,233,0.37924528301886795,0.04228855721393035,0.9577114427860697,0.3781094527363184,0.5796019900497512
10429,10,429,1083,438,8,430,203,227,0.40443213296398894,0.0182648401826484,0.9817351598173516,0.4634703196347032,0.5182648401826484
10430,10,430,1062,472,26,446,197,249,0.4444444444444444,0.05508474576271186,0.9449152542372882,0.4173728813559322,0.527542372881356
10431,10,431,1178,492,18,474,229,245,0.41765704584040747,0.036585365853658534,0.9634146341463414,0.4654471544715447,0.49796747967479676
10501,10,501,1207,449,18,431,185,246,0.371996685998343,0.0400890868596882,0.9599109131403119,0.41202672605790647,0.5478841870824054
10502,10,502,1228,452,10,442,196,246,0.36807817589576547,0.022123893805309734,0.9778761061946902,0.4336283185840708,0.5442477876106194
10503,10,503,1217,438,14,424,175,249,0.3599013968775678,0.0319634703196347,0.9680365296803652,0.3995433789954338,0.5684931506849316
10504,10,504,1220,497,8,489,179,310,0.40737704918032785,0.01609657947686117,0.9839034205231388,0.36016096579476864,0.6237424547283702
10505,10,505,1166,466,8,458,169,289,0.3996569468267582,0.017167381974248927,0.9828326180257511,0.3626609442060086,0.6201716738197425
10506,10,506,1168,565,18,547,231,316,0.4837328767123288,0.03185840707964602,0.968141592920354,0.4088495575221239,0.5592920353982301
10507,10,507,1260,474,14,460,237,223,0.3761904761904762,0.029535864978902954,0.9704641350210971,0.5,0.4704641350210971
10508,10,508,1038,431,12,419,209,210,0.41522157996146436,0.027842227378190254,0.9721577726218097,0.48491879350348027,0.4872389791183295
10509,10,509,1076,410,7,403,181,222,0.38104089219330856,0.01707317073170732,0.9829268292682927,0.44146341463414634,0.5414634146341464
10510,10,510,1014,414,24,390,180,210,0.40828402366863903,0.057971014492753624,0.9420289855072463,0.43478260869565216,0.5072463768115942
10511,10,511,1155,482,20,462,208,254,0.4173160173160173,0.04149377593360996,0.9585062240663901,0.4315352697095436,0.5269709543568465
10512,10,512,1123,500,13,487,268,219,0.4452359750667854,0.026,0.974,0.536,0.438
10513,10,513,1172,496,17,479,198,281,0.4232081911262799,0.034274193548387094,0.9657258064516129,0.39919354838709675,0.5665322580645161
10514,10,514,1089,431,18,413,178,235,0.3957759412304867,0.04176334106728538,0.9582366589327146,0.41299303944315546,0.5452436194895591
10515,10,515,1050,439,22,417,176,241,0.4180952380952381,0.05011389521640091,0.9498861047835991,0.4009111617312073,0.5489749430523918
10516,10,516,1059,488,7,481,197,284,0.46081208687440983,0.014344262295081968,0.985655737704918,0.4036885245901639,0.5819672131147541
10517,10,517,1064,469,26,443,187,256,0.4407894736842105,0.05543710021321962,0.9445628997867804,0.39872068230277186,0.5458422174840085
10518,10,518,1069,470,11,459,194,265,0.43966323666978485,0.023404255319148935,0.9765957446808511,0.4127659574468085,0.5638297872340425
10519,10,519,1076,504,19,485,195,290,0.4684014869888476,0.037698412698412696,0.9623015873015873,0.3869047619047619,0.5753968253968254
10520,10,520,1150,461,18,443,181,262,0.4008695652173913,0.039045553145336226,0.9609544468546638,0.3926247288503254,0.5683297180043384
10521,10,521,1103,440,16,424,178,246,0.3989120580235721,0.03636363636363636,0.9636363636363636,0.40454545454545454,0.5590909090909091
10522,10,522,1060,466,8,458,190,268,0.439622641509434,0.017167381974248927,0.9828326180257511,0.40772532188841204,0.575107296137339
10523,10,523,1075,453,13,440,173,267,0.4213953488372093,0.02869757174392936,0.9713024282560706,0.3818984547461369,0.5894039735099338
10524,10,524,1066,468,25,443,174,269,0.43902439024390244,0.053418803418803416,0.9465811965811965,0.3717948717948718,0.5747863247863247
10525,10,525,1059,485,18,467,178,289,0.45797922568460814,0.03711340206185567,0.9628865979381444,0.3670103092783505,0.5958762886597938
10526,10,526,1027,458,16,442,198,244,0.4459591041869523,0.034934497816593885,0.9650655021834061,0.43231441048034935,0.5327510917030568
10527,10,527,1144,501,13,488,208,280,0.4379370629370629,0.02594810379241517,0.9740518962075848,0.4151696606786427,0.5588822355289421
10528,10,528,1165,503,16,487,247,240,0.4317596566523605,0.03180914512922465,0.9681908548707754,0.49105367793240556,0.47713717693836977
10529,10,529,1083,440,8,432,195,237,0.40627885503231764,0.01818181818181818,0.9818181818181818,0.4431818181818182,0.5386363636363637
10530,10,530,1246,493,13,480,219,261,0.3956661316211878,0.02636916835699797,0.973630831643002,0.44421906693711966,0.5294117647058824
10601,10,601,1301,441,13,428,301,127,0.3389700230591852,0.02947845804988662,0.9705215419501134,0.6825396825396826,0.28798185941043086
10602,10,602,1333,529,21,508,324,184,0.3968492123030758,0.03969754253308128,0.9603024574669187,0.6124763705103969,0.34782608695652173
10603,10,603,1300,493,18,475,340,135,0.3792307692307692,0.036511156186612576,0.9634888438133874,0.6896551724137931,0.2738336713995943
10604,10,604,1387,520,19,501,285,216,0.3749098774333093,0.03653846153846154,0.9634615384615385,0.5480769230769231,0.4153846153846154
10605,10,605,1331,550,17,533,311,222,0.4132231404958678,0.03090909090909091,0.9690909090909091,0.5654545454545454,0.4036363636363636
10606,10,606,1257,509,24,485,303,182,0.4049323786793954,0.047151277013752456,0.9528487229862476,0.5952848722986247,0.3575638506876228
10607,10,607,1271,514,17,497,345,152,0.4044059795436664,0.033073929961089495,0.9669260700389105,0.6712062256809338,0.29571984435797666
10608,10,608,1275,402,4,398,242,156,0.31529411764705884,0.009950248756218905,0.9900497512437811,0.6019900497512438,0.3880597014925373
10609,10,609,1260,541,32,509,356,153,0.42936507936507934,0.059149722735674676,0.9408502772643254,0.6580406654343808,0.2828096118299446
10610,10,610,1140,451,17,434,289,145,0.3956140350877193,0.037694013303769404,0.9623059866962306,0.6407982261640798,0.3215077605321508
10611,10,611,1143,457,17,440,328,112,0.399825021872266,0.037199124726477024,0.962800875273523,0.7177242888402626,0.24507658643326038
10612,10,612,887,309,12,297,204,93,0.3483652762119504,0.038834951456310676,0.9611650485436893,0.6601941747572816,0.30097087378640774
10613,10,613,1277,514,26,488,306,182,0.4025058731401723,0.05058365758754864,0.9494163424124513,0.5953307392996109,0.3540856031128405
10614,10,614,1288,393,17,376,221,155,0.3051242236024845,0.043256997455470736,0.9567430025445293,0.5623409669211196,0.3944020356234097
10615,10,615,1244,538,28,510,271,239,0.432475884244373,0.05204460966542751,0.9479553903345725,0.5037174721189591,0.44423791821561337
10616,10,616,1124,483,17,466,230,236,0.4297153024911032,0.035196687370600416,0.9648033126293996,0.47619047619047616,0.4886128364389234
10617,10,617,1135,463,8,455,212,243,0.4079295154185022,0.017278617710583154,0.9827213822894169,0.45788336933045354,0.5248380129589633
10618,10,618,1089,424,12,412,249,163,0.38934802571166205,0.02830188679245283,0.9716981132075472,0.5872641509433962,0.38443396226415094
10619,10,619,1079,415,9,406,195,211,0.38461538461538464,0.021686746987951807,0.9783132530120482,0.46987951807228917,0.5084337349397591
10620,10,620,1112,426,18,408,163,245,0.3830935251798561,0.04225352112676056,0.9577464788732394,0.3826291079812207,0.5751173708920188
10621,10,621,1179,486,9,477,332,145,0.4122137404580153,0.018518518518518517,0.9814814814814815,0.6831275720164609,0.29835390946502055
10622,10,622,1213,466,7,459,315,144,0.3841714756801319,0.015021459227467811,0.9849785407725322,0.6759656652360515,0.3090128755364807
10623,10,623,1222,456,10,446,306,140,0.37315875613747956,0.021929824561403508,0.9780701754385965,0.6710526315789473,0.30701754385964913
10624,10,624,1020,319,8,311,236,75,0.3127450980392157,0.025078369905956112,0.9749216300940439,0.7398119122257053,0.23510971786833856
10625,10,625,1165,404,13,391,296,95,0.34678111587982835,0.03217821782178218,0.9678217821782178,0.7326732673267327,0.23514851485148514
10626,10,626,1235,535,20,515,276,239,0.4331983805668016,0.037383177570093455,0.9626168224299065,0.5158878504672897,0.44672897196261685
101A,10,1A,0,501,4,497,336,161,inf,0.007984031936127744,0.9920159680638723,0.6706586826347305,0.3213572854291417
101B,10,1B,0,452,7,445,316,129,inf,0.015486725663716814,0.9845132743362832,0.6991150442477876,0.2853982300884956
101C,10,1C,0,390,9,381,252,129,inf,0.023076923076923078,0.9769230769230769,0.6461538461538462,0.33076923076923076
101D,10,1D,0,466,10,456,335,121,inf,0.02145922746781116,0.9785407725321889,0.7188841201716738,0.259656652360515
101E,10,1E,0,592,10,582,392,190,inf,0.016891891891891893,0.9831081081081081,0.6621621621621622,0.32094594594594594
101F,10,1F,0,633,4,629,440,189,inf,0.00631911532385466,0.9936808846761453,0.6951026856240127,0.2985781990521327
101G,10,1G,0,610,7,603,415,188,inf,0.011475409836065573,0.9885245901639345,0.680327868852459,0.3081967213114754
101H,10,1H,0,465,14,451,321,130,inf,0.030107526881720432,0.9698924731182795,0.6903225806451613,0.27956989247311825
101J,10,1J,0,661,11,650,443,207,inf,0.01664145234493192,0.983358547655068,0.670196671709531,0.31316187594553707
101K,10,1K,0,563,8,555,322,233,inf,0.014209591474245116,0.9857904085257548,0.5719360568383659,0.413854351687389
101L,10,1L,0,592,10,582,340,242,inf,0.016891891891891893,0.9831081081081081,0.5743243243243243,0.40878378378378377
101M,10,1M,0,443,10,433,280,153,inf,0.022573363431151242,0.9774266365688488,0.6320541760722348,0.345372460496614
102A,10,2A,0,592,6,586,389,197,inf,0.010135135135135136,0.9898648648648649,0.6570945945945946,0.3327702702702703
102B,10,2B,0,732,11,721,403,318,inf,0.015027322404371584,0.9849726775956285,0.5505464480874317,0.4344262295081967
102C,10,2C,0,281,7,274,181,93,inf,0.02491103202846975,0.9750889679715302,0.6441281138790036,0.3309608540925267
102D,10,2D,0,636,6,630,380,250,inf,0.009433962264150943,0.9905660377358491,0.5974842767295597,0.39308176100628933
102E,10,2E,0,379,7,372,209,163,inf,0.018469656992084433,0.9815303430079155,0.5514511873350924,0.43007915567282323
102F,10,2F,0,362,8,354,224,130,inf,0.022099447513812154,0.9779005524861878,0.6187845303867403,0.35911602209944754
102G,10,2G,0,375,11,364,190,174,inf,0.029333333333333333,0.9706666666666667,0.5066666666666667,0.464
102H,10,2H,0,667,28,639,331,308,inf,0.041979010494752625,0.9580209895052474,0.4962518740629685,0.4617691154422789
102J,10,2J,0,342,4,338,255,83,inf,0.011695906432748537,0.9883040935672515,0.7456140350877193,0.24269005847953215
102K,10,2K,0,541,5,536,364,172,inf,0.009242144177449169,0.9907578558225508,0.6728280961182994,0.3179297597042514
102L,10,2L,0,660,13,647,422,225,inf,0.019696969696969695,0.9803030303030303,0.6393939393939394,0.3409090909090909
102M,10,2M,0,350,3,347,195,152,inf,0.008571428571428572,0.9914285714285714,0.5571428571428572,0.4342857142857143
102N,10,2N,0,407,6,401,217,184,inf,0.014742014742014743,0.9852579852579852,0.5331695331695332,0.4520884520884521
102P,10,2P,0,316,5,311,184,127,inf,0.015822784810126583,0.9841772151898734,0.5822784810126582,0.40189873417721517
102Q,10,2Q,0,381,4,377,185,192,inf,0.010498687664041995,0.989501312335958,0.48556430446194226,0.5039370078740157
102R,10,2R,0,557,9,548,328,220,inf,0.01615798922800718,0.9838420107719928,0.5888689407540395,0.39497307001795334
102S,10,2S,0,632,13,619,351,268,inf,0.020569620253164556,0.9794303797468354,0.555379746835443,0.4240506329113924
102T,10,2T,0,612,11,601,346,255,inf,0.017973856209150325,0.9820261437908496,0.565359477124183,0.4166666666666667
103A,10,3A,0,477,7,470,339,131,inf,0.014675052410901468,0.9853249475890985,0.710691823899371,0.2746331236897275
103B,10,3B,0,415,11,404,300,104,inf,0.02650602409638554,0.9734939759036144,0.7228915662650602,0.25060240963855424
103C,10,3C,0,491,0,491,391,100,inf,0.0,1.0,0.7963340122199593,0.20366598778004075
103D,10,3D,0,408,5,403,284,119,inf,0.012254901960784314,0.9877450980392157,0.696078431372549,0.2916666666666667
103E,10,3E,0,606,5,601,359,242,inf,0.00825082508250825,0.9917491749174917,0.5924092409240924,0.39933993399339934
103F,10,3F,0,391,5,386,251,135,inf,0.01278772378516624,0.9872122762148338,0.6419437340153452,0.3452685421994885
103G,10,3G,0,405,5,400,285,115,inf,0.012345679012345678,0.9876543209876543,0.7037037037037037,0.2839506172839506
103H,10,3H,0,514,9,505,366,139,inf,0.017509727626459144,0.9824902723735408,0.7120622568093385,0.2704280155642023
103J,10,3J,0,500,3,497,382,115,inf,0.006,0.994,0.764,0.23
103K,10,3K,0,237,4,233,189,44,inf,0.016877637130801686,0.9831223628691983,0.7974683544303798,0.18565400843881857
103L,10,3L,0,675,12,663,472,191,inf,0.017777777777777778,0.9822222222222222,0.6992592592592592,0.28296296296296297
103M,10,3M,0,669,18,651,424,227,inf,0.026905829596412557,0.9730941704035875,0.6337817638266069,0.3393124065769806
103N,10,3N,0,617,12,605,387,218,inf,0.019448946515397084,0.9805510534846029,0.6272285251215559,0.353322528363047
103P,10,3P,0,732,4,728,462,266,inf,0.00546448087431694,0.994535519125683,0.6311475409836066,0.3633879781420765
104A,10,4A,0,396,4,392,260,132,inf,0.010101010101010102,0.98989898989899,0.6565656565656566,0.3333333333333333
104B,10,4B,0,704,9,695,447,248,inf,0.01278409090909091,0.9872159090909091,0.6349431818181818,0.3522727272727273
104C,10,4C,0,331,5,326,236,90,inf,0.015105740181268883,0.9848942598187311,0.7129909365558912,0.2719033232628399
104D,10,4D,0,324,5,319,229,90,inf,0.015432098765432098,0.9845679012345679,0.7067901234567902,0.2777777777777778
104E,10,4E,0,398,3,395,269,126,inf,0.007537688442211055,0.992462311557789,0.6758793969849246,0.3165829145728643
104F,10,4F,0,449,8,441,250,191,inf,0.017817371937639197,0.9821826280623608,0.5567928730512249,0.42538975501113585
104G,10,4G,0,447,7,440,275,165,inf,0.015659955257270694,0.9843400447427293,0.6152125279642058,0.3691275167785235
104H,10,4H,0,762,18,744,484,260,inf,0.023622047244094488,0.9763779527559056,0.6351706036745407,0.34120734908136485
104J,10,4J,0,504,24,480,207,273,inf,0.047619047619047616,0.9523809523809523,0.4107142857142857,0.5416666666666666
104K,10,4K,0,597,13,584,286,298,inf,0.021775544388609715,0.9782244556113903,0.47906197654941374,0.4991624790619765
104L,10,4L,0,446,7,439,235,204,inf,0.01569506726457399,0.984304932735426,0.5269058295964125,0.45739910313901344
104M,10,4M,0,638,9,629,409,220,inf,0.014106583072100314,0.9858934169278997,0.6410658307210031,0.3448275862068966
104N,10,4N,0,589,13,576,389,187,inf,0.022071307300509338,0.9779286926994907,0.6604414261460102,0.3174872665534805
104P,10,4P,0,546,9,537,294,243,inf,0.016483516483516484,0.9835164835164835,0.5384615384615384,0.44505494505494503
104Q,10,4Q,0,631,5,626,316,310,inf,0.00792393026941363,0.9920760697305864,0.5007923930269413,0.49128367670364503
104R,10,4R,0,519,4,515,313,202,inf,0.007707129094412331,0.9922928709055877,0.603082851637765,0.3892100192678227
104S,10,4S,0,183,2,181,128,53,inf,0.01092896174863388,0.9890710382513661,0.6994535519125683,0.2896174863387978
104T,10,4T,0,685,12,673,311,362,inf,0.017518248175182483,0.9824817518248176,0.454014598540146,0.5284671532846715
104V,10,4V,0,465,12,453,218,235,inf,0.025806451612903226,0.9741935483870968,0.46881720430107526,0.5053763440860215
104W,10,4W,0,477,6,471,184,287,inf,0.012578616352201259,0.9874213836477987,0.3857442348008386,0.6016771488469602
104X,10,4X,0,508,7,501,224,277,inf,0.013779527559055118,0.9862204724409449,0.4409448818897638,0.5452755905511811
104Y,10,4Y,0,477,2,475,231,244,inf,0.0041928721174004195,0.9958071278825996,0.48427672955974843,0.5115303983228512
104ZA,10,4ZA,0,443,12,431,216,215,inf,0.02708803611738149,0.9729119638826185,0.48758465011286684,0.4853273137697517
104ZB,10,4ZB,0,391,3,388,208,180,inf,0.0076726342710997444,0.9923273657289002,0.5319693094629157,0.46035805626598464
104ZC,10,4ZC,0,411,4,407,227,180,inf,0.009732360097323601,0.9902676399026764,0.5523114355231143,0.43795620437956206
105A,10,5A,0,553,12,541,287,254,inf,0.0216998191681736,0.9783001808318263,0.5189873417721519,0.4593128390596745
105B,10,5B,0,511,6,505,231,274,inf,0.011741682974559686,0.9882583170254403,0.4520547945205479,0.5362035225048923
105C,10,5C,0,561,12,549,276,273,inf,0.0213903743315508,0.9786096256684492,0.4919786096256685,0.48663101604278075
105D,10,5D,0,526,7,519,246,273,inf,0.013307984790874524,0.9866920152091255,0.467680608365019,0.5190114068441065
105E,10,5E,0,515,10,505,233,272,inf,0.019417475728155338,0.9805825242718447,0.4524271844660194,0.5281553398058253
105F,10,5F,0,427,7,420,214,206,inf,0.01639344262295082,0.9836065573770492,0.5011709601873536,0.48243559718969553
105G,10,5G,0,512,10,502,271,231,inf,0.01953125,0.98046875,0.529296875,0.451171875
105H,10,5H,0,434,8,426,222,204,inf,0.018433179723502304,0.9815668202764977,0.511520737327189,0.4700460829493088
105J,10,5J,0,420,3,417,231,186,inf,0.007142857142857143,0.9928571428571429,0.55,0.44285714285714284
105K,10,5K,0,448,4,444,244,200,inf,0.008928571428571428,0.9910714285714286,0.5446428571428571,0.44642857142857145
105L,10,5L,0,449,10,439,239,200,inf,0.022271714922048998,0.977728285077951,0.532293986636971,0.44543429844098
105M,10,5M,0,397,7,390,208,182,inf,0.017632241813602016,0.982367758186398,0.5239294710327456,0.45843828715365237
105N,10,5N,0,462,7,455,242,213,inf,0.015151515151515152,0.9848484848484849,0.5238095238095238,0.461038961038961
105P,10,5P,0,490,6,484,246,238,inf,0.012244897959183673,0.9877551020408163,0.5020408163265306,0.4857142857142857
105Q,10,5Q,0,447,5,442,213,229,inf,0.011185682326621925,0.9888143176733781,0.47651006711409394,0.5123042505592841
105R,10,5R,0,417,6,411,176,235,inf,0.014388489208633094,0.9856115107913669,0.42206235011990406,0.5635491606714629
105S,10,5S,0,433,15,418,184,234,inf,0.03464203233256351,0.9653579676674365,0.42494226327944573,0.5404157043879908
105T,10,5T,0,455,7,448,219,229,inf,0.015384615384615385,0.9846153846153847,0.48131868131868133,0.5032967032967033
105V,10,5V,0,394,2,392,180,212,inf,0.005076142131979695,0.9949238578680203,0.45685279187817257,0.5380710659898477
105W,10,5W,0,517,15,502,216,286,inf,0.029013539651837523,0.9709864603481625,0.41779497098646035,0.5531914893617021
105X,10,5X,0,451,5,446,209,237,inf,0.011086474501108648,0.9889135254988913,0.4634146341463415,0.5254988913525499
105Y,10,5Y,0,405,4,401,185,216,inf,0.009876543209876543,0.9901234567901235,0.4567901234567901,0.5333333333333333
105ZA,10,5ZA,0,468,6,462,238,224,inf,0.01282051282051282,0.9871794871794872,0.5085470085470085,0.47863247863247865
105ZB,10,5ZB,0,427,4,423,195,228,inf,0.00936768149882904,0.990632318501171,0.4566744730679157,0.5339578454332553
105ZC,10,5ZC,0,423,2,421,201,220,inf,0.004728132387706856,0.9952718676122931,0.475177304964539,0.5200945626477541
105ZD,10,5ZD,0,424,6,418,222,196,inf,0.014150943396226415,0.9858490566037735,0.5235849056603774,0.46226415094339623
105ZE,10,5ZE,0,462,5,457,211,246,inf,0.010822510822510822,0.9891774891774892,0.45670995670995673,0.5324675324675324
105ZF,10,5ZF,0,465,16,449,224,225,inf,0.034408602150537634,0.9655913978494624,0.4817204301075269,0.4838709677419355
105ZG,10,5ZG,0,421,3,418,189,229,inf,0.007125890736342043,0.9928741092636579,0.4489311163895487,0.5439429928741093
105ZH,10,5ZH,0,518,6,512,283,229,inf,0.011583011583011582,0.9884169884169884,0.5463320463320464,0.4420849420849421
106A,10,6A,0,525,3,522,353,169,inf,0.005714285714285714,0.9942857142857143,0.6723809523809524,0.3219047619047619
106B,10,6B,0,626,7,619,371,248,inf,0.011182108626198083,0.9888178913738019,0.5926517571884984,0.3961661341853035
106C,10,6C,0,574,7,567,362,205,inf,0.012195121951219513,0.9878048780487805,0.6306620209059234,0.35714285714285715
106D,10,6D,0,721,5,716,496,220,inf,0.006934812760055479,0.9930651872399445,0.6879334257975035,0.30513176144244103
106E,10,6E,0,488,4,484,348,136,inf,0.00819672131147541,0.9918032786885246,0.7131147540983607,0.2786885245901639
106F,10,6F,0,558,4,554,402,152,inf,0.007168458781362007,0.992831541218638,0.7204301075268817,0.2724014336917563
106G,10,6G,0,688,10,678,461,217,inf,0.014534883720930232,0.9854651162790697,0.6700581395348837,0.31540697674418605
106H,10,6H,0,424,11,413,202,211,inf,0.025943396226415096,0.9740566037735849,0.47641509433962265,0.49764150943396224
106J,10,6J,0,421,7,414,215,199,inf,0.0166270783847981,0.9833729216152018,0.5106888361045131,0.47268408551068886
106K,10,6K,0,813,15,798,430,368,inf,0.01845018450184502,0.981549815498155,0.5289052890528906,0.45264452644526443
106L,10,6L,0,412,7,405,208,197,inf,0.01699029126213592,0.9830097087378641,0.5048543689320388,0.47815533980582525
106M,10,6M,0,500,7,493,249,244,inf,0.014,0.986,0.498,0.488
106N,10,6N,0,457,3,454,313,141,inf,0.006564551422319475,0.9934354485776805,0.6849015317286652,0.3085339168490153
106P,10,6P,0,442,3,439,331,108,inf,0.006787330316742082,0.9932126696832579,0.748868778280543,0.24434389140271492
106Q,10,6Q,0,482,3,479,285,194,inf,0.006224066390041493,0.9937759336099585,0.5912863070539419,0.4024896265560166
11101,11,101,1041,454,24,430,280,150,0.43611911623439004,0.05286343612334802,0.947136563876652,0.6167400881057269,0.3303964757709251
11102,11,102,1073,551,22,529,210,319,0.5135135135135135,0.039927404718693285,0.9600725952813067,0.3811252268602541,0.5789473684210527
11103,11,103,1278,596,15,581,254,327,0.46635367762128327,0.025167785234899327,0.9748322147651006,0.4261744966442953,0.5486577181208053
11104,11,104,1000,475,24,451,276,175,0.475,0.05052631578947368,0.9494736842105264,0.5810526315789474,0.3684210526315789
11105,11,105,836,431,11,420,179,241,0.5155502392344498,0.025522041763341066,0.974477958236659,0.41531322505800466,0.5591647331786543
11106,11,106,1024,398,26,372,253,119,0.388671875,0.06532663316582915,0.9346733668341709,0.635678391959799,0.2989949748743719
11107,11,107,980,388,10,378,270,108,0.39591836734693875,0.02577319587628866,0.9742268041237113,0.6958762886597938,0.27835051546391754
11108,11,108,1027,271,11,260,178,82,0.2638753651411879,0.04059040590405904,0.959409594095941,0.6568265682656826,0.3025830258302583
11109,11,109,1107,366,23,343,184,159,0.33062330623306235,0.06284153005464481,0.9371584699453552,0.5027322404371585,0.4344262295081967
11110,11,110,946,337,14,323,236,87,0.3562367864693446,0.04154302670623145,0.9584569732937686,0.7002967359050445,0.258160237388724
11111,11,111,1108,421,27,394,188,206,0.3799638989169675,0.06413301662707839,0.9358669833729216,0.44655581947743467,0.48931116389548696
11112,11,112,917,384,27,357,230,127,0.4187568157033806,0.0703125,0.9296875,0.5989583333333334,0.3307291666666667
11113,11,113,1007,430,38,392,255,137,0.4270109235352532,0.08837209302325581,0.9116279069767442,0.5930232558139535,0.3186046511627907
11114,11,114,668,230,11,219,156,63,0.344311377245509,0.04782608695652174,0.9521739130434783,0.6782608695652174,0.27391304347826084
11115,11,115,678,270,7,263,146,117,0.39823008849557523,0.025925925925925925,0.9740740740740741,0.5407407407407407,0.43333333333333335
11116,11,116,895,378,14,364,237,127,0.4223463687150838,0.037037037037037035,0.9629629629629629,0.626984126984127,0.335978835978836
11117,11,117,888,358,13,345,206,139,0.40315315315315314,0.036312849162011177,0.9636871508379888,0.5754189944134078,0.388268156424581
11118,11,118,940,422,17,405,179,226,0.44893617021276594,0.04028436018957346,0.9597156398104265,0.42417061611374407,0.5355450236966824
11119,11,119,948,385,34,351,263,88,0.4061181434599156,0.08831168831168831,0.9116883116883117,0.6831168831168831,0.22857142857142856
11120,11,120,852,335,9,326,227,99,0.3931924882629108,0.026865671641791045,0.9731343283582089,0.6776119402985075,0.2955223880597015
11121,11,121,799,366,23,343,231,112,0.45807259073842305,0.06284153005464481,0.9371584699453552,0.6311475409836066,0.30601092896174864
11122,11,122,924,324,10,314,214,100,0.35064935064935066,0.030864197530864196,0.9691358024691358,0.6604938271604939,0.30864197530864196
11123,11,123,920,355,7,348,265,83,0.3858695652173913,0.01971830985915493,0.9802816901408451,0.7464788732394366,0.23380281690140844
11124,11,124,1108,546,23,523,340,183,0.4927797833935018,0.04212454212454213,0.9578754578754579,0.6227106227106227,0.33516483516483514
11125,11,125,1044,380,10,370,270,100,0.36398467432950193,0.02631578947368421,0.9736842105263158,0.7105263157894737,0.2631578947368421
11126,11,126,886,340,14,326,144,182,0.3837471783295711,0.041176470588235294,0.9588235294117647,0.4235294117647059,0.5352941176470588
11127,11,127,977,437,30,407,238,169,0.44728761514841353,0.06864988558352403,0.931350114416476,0.5446224256292906,0.38672768878718533
11128,11,128,842,290,9,281,218,63,0.34441805225653205,0.03103448275862069,0.9689655172413794,0.7517241379310344,0.21724137931034482
11129,11,129,1006,335,17,318,241,77,0.33300198807157055,0.050746268656716415,0.9492537313432836,0.7194029850746269,0.2298507462686567
11130,11,130,890,368,22,346,230,116,0.4134831460674157,0.059782608695652176,0.9402173913043478,0.625,0.31521739130434784
11131,11,131,634,299,6,293,198,95,0.471608832807571,0.020066889632107024,0.979933110367893,0.6622073578595318,0.3177257525083612
11132,11,132,969,389,9,380,169,211,0.40144478844169246,0.02313624678663239,0.9768637532133676,0.43444730077120824,0.5424164524421594
11133,11,133,863,376,16,360,161,199,0.43568945538818077,0.0425531914893617,0.9574468085106383,0.42819148936170215,0.5292553191489362
11134,11,134,777,346,3,343,219,124,0.4453024453024453,0.008670520231213872,0.9913294797687862,0.6329479768786127,0.3583815028901734
11135,11,135,1135,484,34,450,287,163,0.426431718061674,0.07024793388429752,0.9297520661157025,0.5929752066115702,0.3367768595041322
11136,11,136,809,378,27,351,220,131,0.4672435105067985,0.07142857142857142,0.9285714285714286,0.582010582010582,0.34656084656084657
11201,11,201,926,343,13,330,191,139,0.37041036717062636,0.037900874635568516,0.9620991253644315,0.5568513119533528,0.40524781341107874
11202,11,202,1020,371,12,359,231,128,0.3637254901960784,0.03234501347708895,0.967654986522911,0.6226415094339622,0.3450134770889488
11203,11,203,1081,450,18,432,283,149,0.4162812210915819,0.04,0.96,0.6288888888888889,0.33111111111111113
11204,11,204,919,327,20,307,202,105,0.3558215451577802,0.06116207951070336,0.9388379204892966,0.617737003058104,0.3211009174311927
11205,11,205,1016,436,13,423,288,135,0.42913385826771655,0.02981651376146789,0.9701834862385321,0.6605504587155964,0.30963302752293576
11206,11,206,959,365,11,354,240,114,0.3806047966631908,0.030136986301369864,0.9698630136986301,0.6575342465753424,0.31232876712328766
11207,11,207,857,370,16,354,221,133,0.43173862310385064,0.043243243243243246,0.9567567567567568,0.5972972972972973,0.35945945945945945
11208,11,208,1131,487,20,467,210,257,0.4305923961096375,0.04106776180698152,0.9589322381930184,0.43121149897330596,0.5277207392197125
11209,11,209,1056,445,16,429,197,232,0.42140151515151514,0.035955056179775284,0.9640449438202248,0.44269662921348313,0.5213483146067416
11210,11,210,965,396,16,380,216,164,0.41036269430051814,0.04040404040404041,0.9595959595959596,0.5454545454545454,0.41414141414141414
11211,11,211,942,438,20,418,237,181,0.46496815286624205,0.045662100456621,0.954337899543379,0.541095890410959,0.4132420091324201
11212,11,212,862,396,18,378,198,180,0.4593967517401392,0.045454545454545456,0.9545454545454546,0.5,0.45454545454545453
11213,11,213,768,323,11,312,185,127,0.4205729166666667,0.034055727554179564,0.9659442724458205,0.5727554179566563,0.3931888544891641
11214,11,214,913,301,3,298,218,80,0.32968236582694416,0.009966777408637873,0.9900332225913622,0.7242524916943521,0.26578073089701
11215,11,215,946,388,14,374,166,208,0.41014799154334036,0.03608247422680412,0.9639175257731959,0.42783505154639173,0.5360824742268041
11216,11,216,1105,503,12,491,264,227,0.45520361990950226,0.02385685884691849,0.9761431411530815,0.5248508946322068,0.45129224652087474
11217,11,217,1014,441,13,428,198,230,0.4349112426035503,0.02947845804988662,0.9705215419501134,0.4489795918367347,0.5215419501133787
11218,11,218,827,327,10,317,226,91,0.3954050785973398,0.03058103975535168,0.9694189602446484,0.691131498470948,0.2782874617737003
11219,11,219,890,336,13,323,151,172,0.3775280898876405,0.03869047619047619,0.9613095238095238,0.4494047619047619,0.5119047619047619
11220,11,220,925,340,11,329,156,173,0.3675675675675676,0.03235294117647059,0.9676470588235294,0.4588235294117647,0.5088235294117647
11221,11,221,1049,345,13,332,169,163,0.328884652049571,0.03768115942028986,0.9623188405797102,0.48985507246376814,0.47246376811594204
11222,11,222,1051,457,20,437,248,189,0.43482397716460514,0.0437636761487965,0.9562363238512035,0.5426695842450766,0.4135667396061269
11223,11,223,876,355,11,344,224,120,0.4052511415525114,0.030985915492957747,0.9690140845070423,0.6309859154929578,0.3380281690140845
11224,11,224,874,406,16,390,205,185,0.4645308924485126,0.03940886699507389,0.9605911330049262,0.5049261083743842,0.45566502463054187
11225,11,225,898,428,17,411,232,179,0.4766146993318486,0.0397196261682243,0.9602803738317757,0.5420560747663551,0.4182242990654206
11226,11,226,1135,536,28,508,344,164,0.4722466960352423,0.05223880597014925,0.9477611940298507,0.6417910447761194,0.30597014925373134
11227,11,227,977,375,7,368,244,124,0.38382804503582396,0.018666666666666668,0.9813333333333333,0.6506666666666666,0.33066666666666666
11228,11,228,970,398,6,392,189,203,0.41030927835051545,0.01507537688442211,0.9849246231155779,0.4748743718592965,0.5100502512562815
11229,11,229,994,426,15,411,222,189,0.42857142857142855,0.035211267605633804,0.9647887323943662,0.5211267605633803,0.44366197183098594
11230,11,230,865,318,12,306,187,119,0.3676300578034682,0.03773584905660377,0.9622641509433962,0.5880503144654088,0.3742138364779874
11231,11,231,1083,446,17,429,318,111,0.4118190212373038,0.03811659192825112,0.9618834080717489,0.7130044843049327,0.24887892376681614
11232,11,232,1463,564,24,540,354,186,0.38550922761449075,0.0425531914893617,0.9574468085106383,0.6276595744680851,0.32978723404255317
11233,11,233,950,453,3,450,295,155,0.4768421052631579,0.006622516556291391,0.9933774834437086,0.6512141280353201,0.34216335540838855
11234,11,234,872,350,17,333,202,131,0.4013761467889908,0.04857142857142857,0.9514285714285714,0.5771428571428572,0.3742857142857143
11301,11,301,1072,446,20,426,267,159,0.416044776119403,0.04484304932735426,0.9551569506726457,0.5986547085201793,0.35650224215246634
11302,11,302,1050,443,20,423,225,198,0.4219047619047619,0.045146726862302484,0.9548532731376975,0.5079006772009029,0.4469525959367946
11303,11,303,959,400,21,379,185,194,0.4171011470281543,0.0525,0.9475,0.4625,0.485
11304,11,304,919,370,13,357,261,96,0.40261153427638735,0.03513513513513514,0.9648648648648649,0.7054054054054054,0.2594594594594595
11305,11,305,1005,391,23,368,205,163,0.3890547263681592,0.058823529411764705,0.9411764705882353,0.5242966751918159,0.41687979539641945
11306,11,306,998,398,9,389,217,172,0.39879759519038077,0.022613065326633167,0.9773869346733668,0.5452261306532663,0.4321608040201005
11307,11,307,1011,444,13,431,312,119,0.4391691394658754,0.02927927927927928,0.9707207207207207,0.7027027027027027,0.268018018018018
11308,11,308,982,372,18,354,254,100,0.3788187372708758,0.04838709677419355,0.9516129032258065,0.6827956989247311,0.26881720430107525
11309,11,309,992,368,21,347,244,103,0.3709677419354839,0.057065217391304345,0.9429347826086957,0.6630434782608695,0.2798913043478261
11310,11,310,1047,338,10,328,222,106,0.3228271251193887,0.029585798816568046,0.9704142011834319,0.6568047337278107,0.3136094674556213
11311,11,311,1221,499,22,477,300,177,0.4086814086814087,0.04408817635270541,0.9559118236472945,0.6012024048096193,0.35470941883767537
11312,11,312,1194,499,27,472,286,186,0.41792294807370184,0.05410821643286573,0.9458917835671342,0.5731462925851704,0.3727454909819639
11313,11,313,1236,405,25,380,197,183,0.3276699029126214,0.06172839506172839,0.9382716049382716,0.48641975308641977,0.45185185185185184
11314,11,314,1002,317,16,301,193,108,0.31636726546906185,0.050473186119873815,0.9495268138801262,0.6088328075709779,0.34069400630914826
11315,11,315,962,344,16,328,207,121,0.3575883575883576,0.046511627906976744,0.9534883720930233,0.6017441860465116,0.35174418604651164
11316,11,316,872,396,22,374,207,167,0.4541284403669725,0.05555555555555555,0.9444444444444444,0.5227272727272727,0.4217171717171717
11317,11,317,905,393,14,379,208,171,0.43425414364640885,0.035623409669211195,0.9643765903307888,0.5292620865139949,0.4351145038167939
11318,11,318,866,271,5,266,173,93,0.312933025404157,0.01845018450184502,0.981549815498155,0.6383763837638377,0.34317343173431736
11319,11,319,828,184,5,179,107,72,0.2222222222222222,0.02717391304347826,0.9728260869565217,0.5815217391304348,0.391304347826087
11320,11,320,1047,403,22,381,211,170,0.384909264565425,0.05459057071960298,0.9454094292803971,0.5235732009925558,0.4218362282878412
11321,11,321,960,358,7,351,247,104,0.3729166666666667,0.019553072625698324,0.9804469273743017,0.6899441340782123,0.2905027932960894
11322,11,322,777,311,9,302,196,106,0.40025740025740025,0.028938906752411574,0.9710610932475884,0.6302250803858521,0.3408360128617363
11323,11,323,978,383,17,366,218,148,0.39161554192229037,0.044386422976501305,0.9556135770234987,0.5691906005221932,0.38642297650130547
11324,11,324,692,249,4,245,150,95,0.3598265895953757,0.01606425702811245,0.9839357429718876,0.6024096385542169,0.3815261044176707
11325,11,325,945,426,14,412,279,133,0.4507936507936508,0.03286384976525822,0.9671361502347418,0.6549295774647887,0.31220657276995306
11326,11,326,651,289,15,274,147,127,0.44393241167434716,0.05190311418685121,0.9480968858131488,0.5086505190311419,0.43944636678200694
11327,11,327,865,361,7,354,256,98,0.41734104046242776,0.019390581717451522,0.9806094182825484,0.7091412742382271,0.27146814404432135
11328,11,328,1205,408,10,398,286,112,0.3385892116182573,0.024509803921568627,0.9754901960784313,0.7009803921568627,0.27450980392156865
11329,11,329,767,324,7,317,200,117,0.42242503259452413,0.021604938271604937,0.9783950617283951,0.6172839506172839,0.3611111111111111
11330,11,330,986,336,13,323,218,105,0.3407707910750507,0.03869047619047619,0.9613095238095238,0.6488095238095238,0.3125
11331,11,331,955,398,21,377,268,109,0.4167539267015707,0.052763819095477386,0.9472361809045227,0.6733668341708543,0.27386934673366836
11332,11,332,924,334,9,325,220,105,0.36147186147186144,0.02694610778443114,0.9730538922155688,0.6586826347305389,0.3143712574850299
11333,11,333,963,392,14,378,258,120,0.407061266874351,0.03571428571428571,0.9642857142857143,0.6581632653061225,0.30612244897959184
11334,11,334,687,263,10,253,183,70,0.38282387190684136,0.03802281368821293,0.9619771863117871,0.6958174904942965,0.2661596958174905
11335,11,335,860,297,8,289,196,93,0.3453488372093023,0.026936026936026935,0.9730639730639731,0.6599326599326599,0.31313131313131315
11336,11,336,785,361,8,353,230,123,0.45987261146496816,0.0221606648199446,0.9778393351800554,0.6371191135734072,0.3407202216066482
11401,11,401,1067,416,17,399,297,102,0.3898781630740394,0.040865384615384616,0.9591346153846154,0.7139423076923077,0.24519230769230768
11402,11,402,918,418,13,405,206,199,0.4553376906318083,0.03110047846889952,0.9688995215311005,0.49282296650717705,0.47607655502392343
11403,11,403,997,363,5,358,257,101,0.3640922768304915,0.013774104683195593,0.9862258953168044,0.7079889807162535,0.27823691460055094
11404,11,404,935,398,20,378,239,139,0.42566844919786095,0.05025125628140704,0.949748743718593,0.6005025125628141,0.3492462311557789
11405,11,405,1016,437,19,418,257,161,0.4301181102362205,0.043478260869565216,0.9565217391304348,0.5881006864988558,0.3684210526315789
11406,11,406,933,360,9,351,191,160,0.3858520900321543,0.025,0.975,0.5305555555555556,0.4444444444444444
11407,11,407,1036,417,11,406,258,148,0.4025096525096525,0.026378896882494004,0.973621103117506,0.6187050359712231,0.354916067146283
11408,11,408,1016,385,13,372,198,174,0.37893700787401574,0.033766233766233764,0.9662337662337662,0.5142857142857142,0.45194805194805193
11409,11,409,992,427,18,409,244,165,0.43044354838709675,0.04215456674473068,0.9578454332552693,0.5714285714285714,0.3864168618266979
11410,11,410,1055,405,6,399,272,127,0.38388625592417064,0.014814814814814815,0.9851851851851852,0.671604938271605,0.3135802469135803
11411,11,411,829,298,9,289,208,81,0.3594692400482509,0.030201342281879196,0.9697986577181208,0.697986577181208,0.27181208053691275
11412,11,412,802,330,9,321,196,125,0.4114713216957606,0.02727272727272727,0.9727272727272728,0.593939393939394,0.3787878787878788
11413,11,413,912,380,16,364,266,98,0.4166666666666667,0.042105263157894736,0.9578947368421052,0.7,0.2578947368421053
11414,11,414,992,330,10,320,215,105,0.3326612903225806,0.030303030303030304,0.9696969696969697,0.6515151515151515,0.3181818181818182
11415,11,415,709,274,5,269,122,147,0.38645980253878703,0.01824817518248175,0.9817518248175182,0.44525547445255476,0.5364963503649635
11416,11,416,1156,444,12,432,282,150,0.38408304498269896,0.02702702702702703,0.972972972972973,0.6351351351351351,0.33783783783783783
11417,11,417,994,394,15,379,233,146,0.3963782696177062,0.03807106598984772,0.9619289340101523,0.5913705583756346,0.37055837563451777
11418,11,418,1026,399,12,387,298,89,0.3888888888888889,0.03007518796992481,0.9699248120300752,0.7468671679197995,0.22305764411027568
11419,11,419,946,418,25,393,285,108,0.4418604651162791,0.05980861244019139,0.9401913875598086,0.6818181818181818,0.2583732057416268
11420,11,420,992,407,14,393,281,112,0.4102822580645161,0.0343980343980344,0.9656019656019657,0.6904176904176904,0.2751842751842752
11421,11,421,1008,413,11,402,282,120,0.4097222222222222,0.026634382566585957,0.9733656174334141,0.6828087167070218,0.29055690072639223
11422,11,422,969,392,10,382,255,127,0.40454076367389064,0.025510204081632654,0.9744897959183674,0.6505102040816326,0.3239795918367347
11423,11,423,862,328,4,324,217,107,0.3805104408352668,0.012195121951219513,0.9878048780487805,0.6615853658536586,0.32621951219512196
11424,11,424,823,305,5,300,228,72,0.370595382746051,0.01639344262295082,0.9836065573770492,0.7475409836065574,0.2360655737704918
11425,11,425,879,345,10,335,253,82,0.3924914675767918,0.028985507246376812,0.9710144927536232,0.7333333333333333,0.23768115942028986
11426,11,426,988,389,3,386,294,92,0.3937246963562753,0.007712082262210797,0.9922879177377892,0.7557840616966581,0.2365038560411311
11427,11,427,1076,419,20,399,284,115,0.38940520446096655,0.0477326968973747,0.9522673031026253,0.6778042959427207,0.2744630071599045
11428,11,428,915,380,6,374,264,110,0.41530054644808745,0.015789473684210527,0.9842105263157894,0.6947368421052632,0.2894736842105263
11429,11,429,1033,409,30,379,298,81,0.3959341723136496,0.07334963325183375,0.9266503667481663,0.7286063569682152,0.1980440097799511
11430,11,430,725,287,14,273,197,76,0.39586206896551723,0.04878048780487805,0.9512195121951219,0.686411149825784,0.26480836236933797
11431,11,431,866,352,6,346,217,129,0.4064665127020785,0.017045454545454544,0.9829545454545454,0.6164772727272727,0.3664772727272727
11432,11,432,883,398,16,382,276,106,0.4507361268403171,0.04020100502512563,0.9597989949748744,0.6934673366834171,0.2663316582914573
11433,11,433,831,348,3,345,256,89,0.4187725631768953,0.008620689655172414,0.9913793103448276,0.735632183908046,0.2557471264367816
11434,11,434,851,365,8,357,278,79,0.4289071680376028,0.021917808219178082,0.9780821917808219,0.7616438356164383,0.21643835616438356
11435,11,435,831,365,15,350,239,111,0.43922984356197353,0.0410958904109589,0.958904109589041,0.6547945205479452,0.3041095890410959
11436,11,436,1023,479,5,474,357,117,0.4682306940371456,0.010438413361169102,0.9895615866388309,0.7453027139874739,0.24425887265135698
11501,11,501,800,339,4,335,242,93,0.42375,0.011799410029498525,0.9882005899705014,0.7138643067846607,0.2743362831858407
11502,11,502,1027,392,8,384,268,116,0.38169425511197663,0.02040816326530612,0.9795918367346939,0.6836734693877551,0.29591836734693877
11503,11,503,1031,402,11,391,258,133,0.38991270611057227,0.02736318407960199,0.972636815920398,0.6417910447761194,0.3308457711442786
11504,11,504,854,365,14,351,200,151,0.4274004683840749,0.038356164383561646,0.9616438356164384,0.547945205479452,0.4136986301369863
11505,11,505,823,326,9,317,195,122,0.39611178614823817,0.027607361963190184,0.9723926380368099,0.598159509202454,0.37423312883435583
11506,11,506,982,292,13,279,183,96,0.2973523421588595,0.04452054794520548,0.9554794520547946,0.6267123287671232,0.3287671232876712
11507,11,507,1091,478,11,467,340,127,0.4381301558203483,0.02301255230125523,0.9769874476987448,0.7112970711297071,0.26569037656903766
11508,11,508,1021,446,9,437,339,98,0.43682664054848186,0.020179372197309416,0.9798206278026906,0.7600896860986547,0.21973094170403587
11509,11,509,1281,537,8,529,364,165,0.41920374707259955,0.0148975791433892,0.9851024208566108,0.6778398510242085,0.30726256983240224
11510,11,510,1152,474,24,450,277,173,0.4114583333333333,0.05063291139240506,0.9493670886075949,0.5843881856540084,0.3649789029535865
11511,11,511,956,376,5,371,292,79,0.39330543933054396,0.013297872340425532,0.9867021276595744,0.776595744680851,0.21010638297872342
11512,11,512,910,358,10,348,241,107,0.3934065934065934,0.027932960893854747,0.9720670391061452,0.6731843575418994,0.2988826815642458
11513,11,513,1025,460,11,449,308,141,0.44878048780487806,0.02391304347826087,0.9760869565217392,0.6695652173913044,0.3065217391304348
11514,11,514,1038,462,15,447,310,137,0.44508670520231214,0.032467532467532464,0.9675324675324676,0.670995670995671,0.29653679653679654
11515,11,515,1005,374,21,353,235,118,0.37213930348258706,0.05614973262032086,0.9438502673796791,0.6283422459893048,0.3155080213903743
11516,11,516,994,428,17,411,259,152,0.4305835010060362,0.0397196261682243,0.9602803738317757,0.6051401869158879,0.35514018691588783
11517,11,517,1022,408,11,397,308,89,0.39921722113502933,0.02696078431372549,0.9730392156862745,0.7549019607843137,0.2181372549019608
11518,11,518,864,379,8,371,270,101,0.4386574074074074,0.021108179419525065,0.978891820580475,0.712401055408971,0.26649076517150394
11519,11,519,935,375,12,363,253,110,0.40106951871657753,0.032,0.968,0.6746666666666666,0.29333333333333333
11520,11,520,861,325,20,305,209,96,0.37746806039488967,0.06153846153846154,0.9384615384615385,0.6430769230769231,0.2953846153846154
11521,11,521,1063,393,18,375,246,129,0.36970837253057387,0.04580152671755725,0.9541984732824428,0.6259541984732825,0.3282442748091603
11522,11,522,997,376,13,363,257,106,0.37713139418254765,0.034574468085106384,0.9654255319148937,0.6835106382978723,0.28191489361702127
11523,11,523,1013,417,12,405,303,102,0.4116485686080948,0.02877697841726619,0.9712230215827338,0.7266187050359713,0.2446043165467626
11524,11,524,879,375,8,367,287,80,0.42662116040955633,0.021333333333333333,0.9786666666666667,0.7653333333333333,0.21333333333333335
11525,11,525,959,408,8,400,298,102,0.4254431699687174,0.0196078431372549,0.9803921568627451,0.7303921568627451,0.25
11526,11,526,1054,466,6,460,292,168,0.44212523719165087,0.012875536480686695,0.9871244635193133,0.6266094420600858,0.3605150214592275
11527,11,527,922,372,8,364,242,122,0.403470715835141,0.021505376344086023,0.978494623655914,0.6505376344086021,0.3279569892473118
11528,11,528,960,402,14,388,261,127,0.41875,0.03482587064676617,0.9651741293532339,0.6492537313432836,0.31592039800995025
11529,11,529,1129,429,18,411,271,140,0.3799822852081488,0.04195804195804196,0.958041958041958,0.6317016317016317,0.32634032634032634
11530,11,530,1033,377,14,363,226,137,0.3649564375605034,0.03713527851458886,0.9628647214854111,0.5994694960212201,0.363395225464191
11531,11,531,951,408,17,391,224,167,0.42902208201892744,0.041666666666666664,0.9583333333333334,0.5490196078431373,0.40931372549019607
11532,11,532,1106,400,10,390,264,126,0.3616636528028933,0.025,0.975,0.66,0.315
11533,11,533,896,370,11,359,255,104,0.41294642857142855,0.02972972972972973,0.9702702702702702,0.6891891891891891,0.2810810810810811
11534,11,534,1142,444,18,426,293,133,0.38879159369527144,0.04054054054054054,0.9594594594594594,0.6599099099099099,0.29954954954954954
11601,11,601,970,459,15,444,303,141,0.4731958762886598,0.032679738562091505,0.9673202614379085,0.6601307189542484,0.30718954248366015
11602,11,602,890,358,9,349,195,154,0.40224719101123596,0.025139664804469275,0.9748603351955307,0.5446927374301676,0.4301675977653631
11603,11,603,830,398,8,390,163,227,0.4795180722891566,0.020100502512562814,0.9798994974874372,0.40954773869346733,0.5703517587939698
11604,11,604,941,358,7,351,254,97,0.3804463336875664,0.019553072625698324,0.9804469273743017,0.7094972067039106,0.2709497206703911
11605,11,605,998,381,22,359,227,132,0.3817635270541082,0.05774278215223097,0.9422572178477691,0.5958005249343832,0.3464566929133858
11606,11,606,1067,396,15,381,249,132,0.3711340206185567,0.03787878787878788,0.9621212121212122,0.6287878787878788,0.3333333333333333
11607,11,607,1468,600,31,569,381,188,0.4087193460490463,0.051666666666666666,0.9483333333333334,0.635,0.31333333333333335
11608,11,608,889,386,17,369,225,144,0.4341957255343082,0.04404145077720207,0.9559585492227979,0.582901554404145,0.37305699481865284
11609,11,609,973,373,12,361,149,212,0.38335046248715315,0.032171581769437,0.967828418230563,0.39946380697050937,0.5683646112600537
11610,11,610,989,365,16,349,237,112,0.3690596562184024,0.043835616438356165,0.9561643835616438,0.6493150684931507,0.30684931506849317
11611,11,611,946,399,13,386,247,139,0.42177589852008457,0.03258145363408521,0.9674185463659147,0.6190476190476191,0.3483709273182957
11612,11,612,812,354,5,349,230,119,0.43596059113300495,0.014124293785310734,0.9858757062146892,0.6497175141242938,0.3361581920903955
11613,11,613,1018,416,10,406,266,140,0.4086444007858546,0.02403846153846154,0.9759615384615384,0.6394230769230769,0.33653846153846156
11614,11,614,776,317,12,305,212,93,0.40850515463917525,0.03785488958990536,0.9621451104100947,0.668769716088328,0.29337539432176657
11615,11,615,940,385,7,378,198,180,0.4095744680851064,0.01818181818181818,0.9818181818181818,0.5142857142857142,0.4675324675324675
11616,11,616,1075,455,28,427,260,167,0.4232558139534884,0.06153846153846154,0.9384615384615385,0.5714285714285714,0.367032967032967
11617,11,617,859,334,8,326,203,123,0.38882421420256114,0.023952095808383235,0.9760479041916168,0.6077844311377245,0.36826347305389223
11618,11,618,798,370,6,364,222,142,0.46365914786967416,0.016216216216216217,0.9837837837837838,0.6,0.3837837837837838
11619,11,619,801,331,14,317,191,126,0.4132334581772784,0.04229607250755287,0.9577039274924471,0.5770392749244713,0.3806646525679758
11620,11,620,738,368,3,365,149,216,0.4986449864498645,0.008152173913043478,0.9918478260869565,0.4048913043478261,0.5869565217391305
11621,11,621,824,336,1,335,174,161,0.4077669902912621,0.002976190476190476,0.9970238095238095,0.5178571428571429,0.4791666666666667
11622,11,622,792,366,6,360,194,166,0.4621212121212121,0.01639344262295082,0.9836065573770492,0.5300546448087432,0.453551912568306
11623,11,623,956,463,10,453,248,205,0.48430962343096234,0.02159827213822894,0.978401727861771,0.5356371490280778,0.4427645788336933
11624,11,624,921,404,15,389,250,139,0.4386536373507057,0.03712871287128713,0.9628712871287128,0.6188118811881188,0.34405940594059403
11625,11,625,864,382,10,372,228,144,0.44212962962962965,0.02617801047120419,0.9738219895287958,0.5968586387434555,0.3769633507853403
11626,11,626,878,392,3,389,199,190,0.44646924829157175,0.007653061224489796,0.9923469387755102,0.5076530612244898,0.4846938775510204
11627,11,627,942,374,5,369,197,172,0.3970276008492569,0.013368983957219251,0.9866310160427807,0.5267379679144385,0.45989304812834225
11628,11,628,847,377,11,366,225,141,0.44510035419126326,0.029177718832891247,0.9708222811671088,0.596816976127321,0.3740053050397878
11629,11,629,878,388,17,371,231,140,0.4419134396355353,0.04381443298969072,0.9561855670103093,0.595360824742268,0.36082474226804123
11630,11,630,892,365,8,357,215,142,0.40919282511210764,0.021917808219178082,0.9780821917808219,0.589041095890411,0.38904109589041097
11631,11,631,786,359,10,349,243,106,0.45674300254452926,0.027855153203342618,0.9721448467966574,0.6768802228412256,0.29526462395543174
11632,11,632,828,350,10,340,190,150,0.4227053140096618,0.02857142857142857,0.9714285714285714,0.5428571428571428,0.42857142857142855
11633,11,633,917,449,21,428,232,196,0.48964013086150493,0.0467706013363029,0.9532293986636972,0.5167037861915368,0.4365256124721604
11634,11,634,655,291,1,290,100,190,0.4442748091603053,0.003436426116838488,0.9965635738831615,0.3436426116838488,0.6529209621993127
111A,11,1A,0,597,5,592,342,250,inf,0.008375209380234505,0.9916247906197655,0.5728643216080402,0.4187604690117253
111B,11,1B,0,459,3,456,270,186,inf,0.006535947712418301,0.9934640522875817,0.5882352941176471,0.40522875816993464
111C,11,1C,0,644,12,632,347,285,inf,0.018633540372670808,0.9813664596273292,0.5388198757763976,0.44254658385093165
111D,11,1D,0,602,14,588,377,211,inf,0.023255813953488372,0.9767441860465116,0.6262458471760798,0.3504983388704319
111E,11,1E,0,378,5,373,254,119,inf,0.013227513227513227,0.9867724867724867,0.671957671957672,0.3148148148148148
111F,11,1F,0,568,17,551,303,248,inf,0.02992957746478873,0.9700704225352113,0.5334507042253521,0.43661971830985913
111G,11,1G,0,456,4,452,305,147,inf,0.008771929824561403,0.9912280701754386,0.668859649122807,0.3223684210526316
111H,11,1H,0,452,5,447,251,196,inf,0.011061946902654867,0.9889380530973452,0.5553097345132744,0.4336283185840708
111I,11,1I,0,402,3,399,271,128,inf,0.007462686567164179,0.9925373134328358,0.6741293532338308,0.31840796019900497
111K,11,1K,0,356,8,348,205,143,inf,0.02247191011235955,0.9775280898876404,0.5758426966292135,0.40168539325842695
111L,11,1L,0,419,5,414,266,148,inf,0.011933174224343675,0.9880668257756563,0.6348448687350835,0.3532219570405728
111M,11,1M,0,432,6,426,215,211,inf,0.013888888888888888,0.9861111111111112,0.4976851851851852,0.48842592592592593
111N,11,1N,0,572,12,560,246,314,inf,0.02097902097902098,0.9790209790209791,0.43006993006993005,0.548951048951049
111P,11,1P,0,515,12,503,323,180,inf,0.02330097087378641,0.9766990291262136,0.6271844660194175,0.34951456310679613
111Q,11,1Q,0,261,3,258,164,94,inf,0.011494252873563218,0.9885057471264368,0.6283524904214559,0.36015325670498083
111R,11,1R,0,364,3,361,276,85,inf,0.008241758241758242,0.9917582417582418,0.7582417582417582,0.23351648351648352
111S,11,1S,0,358,6,352,247,105,inf,0.01675977653631285,0.9832402234636871,0.6899441340782123,0.29329608938547486
111T,11,1T,0,344,7,337,249,88,inf,0.020348837209302327,0.9796511627906976,0.7238372093023255,0.2558139534883721
112A,11,2A,0,542,9,533,349,184,inf,0.016605166051660517,0.9833948339483395,0.6439114391143912,0.33948339483394835
112B,11,2B,0,428,9,419,307,112,inf,0.02102803738317757,0.9789719626168224,0.7172897196261683,0.2616822429906542
112C,11,2C,0,417,5,412,311,101,inf,0.011990407673860911,0.988009592326139,0.7458033573141487,0.2422062350119904
112D,11,2D,0,595,6,589,337,252,inf,0.010084033613445379,0.9899159663865547,0.5663865546218487,0.4235294117647059
112E,11,2E,0,711,6,705,384,321,inf,0.008438818565400843,0.9915611814345991,0.540084388185654,0.45147679324894513
112F,11,2F,0,490,3,487,288,199,inf,0.006122448979591836,0.9938775510204082,0.5877551020408164,0.4061224489795918
112G,11,2G,0,552,4,548,333,215,inf,0.007246376811594203,0.9927536231884058,0.6032608695652174,0.3894927536231884
112H,11,2H,0,775,12,763,382,381,inf,0.015483870967741935,0.984516129032258,0.49290322580645163,0.4916129032258065
112I,11,2I,0,502,9,493,297,196,inf,0.017928286852589643,0.9820717131474104,0.5916334661354582,0.3904382470119522
112K,11,2K,0,523,4,519,311,208,inf,0.0076481835564053535,0.9923518164435946,0.5946462715105163,0.3977055449330784
112L,11,2L,0,715,7,708,385,323,inf,0.009790209790209791,0.9902097902097902,0.5384615384615384,0.45174825174825173
112M,11,2M,0,617,8,609,363,246,inf,0.012965964343598054,0.9870340356564019,0.5883306320907618,0.3987034035656402
112N,11,2N,0,655,6,649,384,265,inf,0.00916030534351145,0.9908396946564886,0.5862595419847328,0.40458015267175573
112P,11,2P,0,556,7,549,369,180,inf,0.012589928057553957,0.987410071942446,0.6636690647482014,0.3237410071942446
112Q,11,2Q,0,608,13,595,376,219,inf,0.02138157894736842,0.9786184210526315,0.618421052631579,0.36019736842105265
112R,11,2R,0,712,14,698,501,197,inf,0.019662921348314606,0.9803370786516854,0.7036516853932584,0.27668539325842695
112S,11,2S,0,604,3,601,400,201,inf,0.004966887417218543,0.9950331125827815,0.6622516556291391,0.33278145695364236
113A,11,3A,0,678,5,673,398,275,inf,0.007374631268436578,0.9926253687315634,0.5870206489675516,0.4056047197640118
113B,11,3B,0,620,5,615,384,231,inf,0.008064516129032258,0.9919354838709677,0.6193548387096774,0.3725806451612903
113C,11,3C,0,542,7,535,382,153,inf,0.012915129151291513,0.9870848708487084,0.7047970479704797,0.2822878228782288
113D,11,3D,0,569,9,560,390,170,inf,0.015817223198594025,0.984182776801406,0.6854130052724078,0.29876977152899825
113E,11,3E,0,614,6,608,396,212,inf,0.009771986970684038,0.990228013029316,0.6449511400651465,0.34527687296416937
113F,11,3F,0,707,5,702,373,329,inf,0.007072135785007072,0.9929278642149929,0.5275813295615276,0.46534653465346537
113G,11,3G,0,608,11,597,375,222,inf,0.018092105263157895,0.9819078947368421,0.6167763157894737,0.3651315789473684
113H,11,3H,0,406,7,399,221,178,inf,0.017241379310344827,0.9827586206896551,0.5443349753694581,0.43842364532019706
113I,11,3I,0,553,7,546,326,220,inf,0.012658227848101266,0.9873417721518988,0.5895117540687161,0.39783001808318263
113K,11,3K,0,457,3,454,249,205,inf,0.006564551422319475,0.9934354485776805,0.5448577680525164,0.4485776805251641
113L,11,3L,0,734,7,727,464,263,inf,0.009536784741144414,0.9904632152588556,0.6321525885558583,0.3583106267029973
113M,11,3M,0,515,6,509,334,175,inf,0.011650485436893204,0.9883495145631068,0.6485436893203883,0.33980582524271846
113N,11,3N,0,719,4,715,532,183,inf,0.005563282336578581,0.9944367176634215,0.7399165507649513,0.2545201668984701
113P,11,3P,0,548,8,540,367,173,inf,0.014598540145985401,0.9854014598540146,0.6697080291970803,0.3156934306569343
113Q,11,3Q,0,534,1,533,353,180,inf,0.0018726591760299626,0.99812734082397,0.6610486891385767,0.33707865168539325
113R,11,3R,0,418,1,417,304,113,inf,0.0023923444976076554,0.9976076555023924,0.7272727272727273,0.2703349282296651
113S,11,3S,0,473,2,471,303,168,inf,0.004228329809725159,0.9957716701902748,0.6405919661733616,0.35517970401691334
114A,11,4A,0,597,4,593,382,211,inf,0.006700167504187605,0.9932998324958124,0.6398659966499163,0.35343383584589616
114B,11,4B,0,602,5,597,369,228,inf,0.008305647840531562,0.9916943521594684,0.6129568106312292,0.3787375415282392
114C,11,4C,0,591,6,585,285,300,inf,0.01015228426395939,0.9898477157360406,0.48223350253807107,0.5076142131979695
114D,11,4D,0,540,6,534,316,218,inf,0.011111111111111112,0.9888888888888889,0.5851851851851851,0.40370370370370373
114E,11,4E,0,612,6,606,341,265,inf,0.00980392156862745,0.9901960784313726,0.5571895424836601,0.43300653594771243
114F,11,4F,0,590,4,586,450,136,inf,0.006779661016949152,0.9932203389830508,0.7627118644067796,0.2305084745762712
114G,11,4G,0,588,6,582,400,182,inf,0.01020408163265306,0.9897959183673469,0.6802721088435374,0.30952380952380953
114H,11,4H,0,829,6,823,575,248,inf,0.007237635705669481,0.9927623642943305,0.6936067551266586,0.2991556091676719
114I,11,4I,0,726,5,721,526,195,inf,0.006887052341597796,0.9931129476584022,0.7245179063360881,0.26859504132231404
114K,11,4K,0,574,3,571,353,218,inf,0.005226480836236934,0.9947735191637631,0.6149825783972126,0.3797909407665505
114L,11,4L,0,525,6,519,373,146,inf,0.011428571428571429,0.9885714285714285,0.7104761904761905,0.2780952380952381
114M,11,4M,0,660,5,655,468,187,inf,0.007575757575757576,0.9924242424242424,0.7090909090909091,0.2833333333333333
114N,11,4N,0,650,9,641,476,165,inf,0.013846153846153847,0.9861538461538462,0.7323076923076923,0.25384615384615383
114P,11,4P,0,576,11,565,403,162,inf,0.019097222222222224,0.9809027777777778,0.6996527777777778,0.28125
114Q,11,4Q,0,472,1,471,355,116,inf,0.00211864406779661,0.9978813559322034,0.7521186440677966,0.2457627118644068
114R,11,4R,0,527,8,519,362,157,inf,0.015180265654648957,0.9848197343453511,0.6869070208728653,0.29791271347248577
114S,11,4S,0,630,8,622,465,157,inf,0.012698412698412698,0.9873015873015873,0.7380952380952381,0.2492063492063492
114T,11,4T,0,677,7,670,472,198,inf,0.0103397341211226,0.9896602658788775,0.6971935007385525,0.29246676514032494
115A,11,5A,0,549,3,546,391,155,inf,0.00546448087431694,0.994535519125683,0.7122040072859745,0.28233151183970856
115B,11,5B,0,693,6,687,461,226,inf,0.008658008658008658,0.9913419913419913,0.6652236652236653,0.32611832611832614
115C,11,5C,0,528,9,519,354,165,inf,0.017045454545454544,0.9829545454545454,0.6704545454545454,0.3125
115D,11,5D,0,657,14,643,428,215,inf,0.0213089802130898,0.9786910197869102,0.6514459665144596,0.3272450532724505
115E,11,5E,0,514,3,511,363,148,inf,0.005836575875486381,0.9941634241245136,0.7062256809338522,0.28793774319066145
115F,11,5F,0,595,6,589,474,115,inf,0.010084033613445379,0.9899159663865547,0.7966386554621848,0.19327731092436976
115G,11,5G,0,618,3,615,465,150,inf,0.0048543689320388345,0.9951456310679612,0.7524271844660194,0.24271844660194175
115H,11,5H,0,686,12,674,470,204,inf,0.01749271137026239,0.9825072886297376,0.685131195335277,0.29737609329446063
115I,11,5I,0,556,5,551,410,141,inf,0.008992805755395683,0.9910071942446043,0.737410071942446,0.25359712230215825
115K,11,5K,0,615,12,603,414,189,inf,0.01951219512195122,0.9804878048780488,0.6731707317073171,0.3073170731707317
115L,11,5L,0,684,8,676,448,228,inf,0.011695906432748537,0.9883040935672515,0.6549707602339181,0.3333333333333333
115M,11,5M,0,674,4,670,522,148,inf,0.005934718100890208,0.9940652818991098,0.7744807121661721,0.2195845697329377
115N,11,5N,0,792,7,785,537,248,inf,0.008838383838383838,0.9911616161616161,0.678030303030303,0.31313131313131315
115P,11,5P,0,628,9,619,467,152,inf,0.014331210191082803,0.9856687898089171,0.7436305732484076,0.24203821656050956
115Q,11,5Q,0,712,12,700,488,212,inf,0.016853932584269662,0.9831460674157303,0.6853932584269663,0.29775280898876405
115R,11,5R,0,641,13,628,419,209,inf,0.0202808112324493,0.9797191887675507,0.6536661466458659,0.32605304212168484
115S,11,5S,0,594,9,585,401,184,inf,0.015151515151515152,0.9848484848484849,0.6750841750841751,0.30976430976430974
116A,11,6A,0,690,9,681,458,223,inf,0.013043478260869565,0.9869565217391304,0.663768115942029,0.32318840579710145
116B,11,6B,0,709,18,691,476,215,inf,0.02538787023977433,0.9746121297602257,0.6713681241184767,0.3032440056417489
116C,11,6C,0,613,7,606,311,295,inf,0.011419249592169658,0.9885807504078303,0.5073409461663948,0.4812398042414356
116D,11,6D,0,613,4,609,406,203,inf,0.0065252854812398045,0.9934747145187602,0.6623164763458401,0.33115823817292006
116E,11,6E,0,702,7,695,398,297,inf,0.009971509971509971,0.99002849002849,0.5669515669515669,0.4230769230769231
116F,11,6F,0,620,7,613,342,271,inf,0.01129032258064516,0.9887096774193549,0.5516129032258065,0.43709677419354837
116G,11,6G,0,635,5,630,380,250,inf,0.007874015748031496,0.9921259842519685,0.5984251968503937,0.3937007874015748
116H,11,6H,0,559,4,555,353,202,inf,0.007155635062611807,0.9928443649373881,0.631484794275492,0.3613595706618962
116I,11,6I,0,716,8,708,421,287,inf,0.0111731843575419,0.9888268156424581,0.5879888268156425,0.40083798882681565
116K,11,6K,0,695,13,682,435,247,inf,0.01870503597122302,0.981294964028777,0.6258992805755396,0.3553956834532374
116L,11,6L,0,624,5,619,395,224,inf,0.008012820512820512,0.9919871794871795,0.6330128205128205,0.358974358974359
116M,11,6M,0,758,8,750,449,301,inf,0.010554089709762533,0.9894459102902374,0.5923482849604221,0.3970976253298153
116N,11,6N,0,598,7,591,290,301,inf,0.011705685618729096,0.9882943143812709,0.48494983277591974,0.5033444816053512
116P,11,6P,0,643,6,637,391,246,inf,0.00933125972006221,0.9906687402799378,0.6080870917573873,0.38258164852255055
116Q,11,6Q,0,723,11,712,433,279,inf,0.015214384508990318,0.9847856154910097,0.598893499308437,0.38589211618257263
116R,11,6R,0,663,6,657,424,233,inf,0.00904977375565611,0.9909502262443439,0.6395173453996983,0.3514328808446455
116S,11,6S,0,661,10,651,308,343,inf,0.015128593040847202,0.9848714069591528,0.4659606656580938,0.518910741301059
12101,12,101,1145,421,30,391,187,204,0.36768558951965064,0.07125890736342043,0.9287410926365796,0.44418052256532065,0.4845605700712589
12102,12,102,863,334,21,313,208,105,0.3870220162224797,0.06287425149700598,0.937125748502994,0.6227544910179641,0.3143712574850299
12103,12,103,803,309,23,286,192,94,0.3848069738480697,0.0744336569579288,0.9255663430420712,0.6213592233009708,0.3042071197411003
12104,12,104,846,361,13,348,233,115,0.42671394799054374,0.036011080332409975,0.96398891966759,0.6454293628808865,0.3185595567867036
12105,12,105,974,326,11,315,234,81,0.3347022587268994,0.03374233128834356,0.9662576687116564,0.7177914110429447,0.24846625766871167
12106,12,106,1137,440,23,417,282,135,0.38698328935795956,0.05227272727272727,0.9477272727272728,0.6409090909090909,0.3068181818181818
12107,12,107,862,377,9,368,186,182,0.43735498839907194,0.023872679045092837,0.9761273209549072,0.493368700265252,0.4827586206896552
12108,12,108,1167,497,28,469,285,184,0.4258783204798629,0.056338028169014086,0.9436619718309859,0.5734406438631791,0.3702213279678068
12109,12,109,888,292,11,281,175,106,0.32882882882882886,0.03767123287671233,0.9623287671232876,0.5993150684931506,0.363013698630137
12110,12,110,912,304,11,293,173,120,0.3333333333333333,0.03618421052631579,0.9638157894736842,0.569078947368421,0.39473684210526316
12111,12,111,1147,450,25,425,278,147,0.3923278116826504,0.05555555555555555,0.9444444444444444,0.6177777777777778,0.32666666666666666
12112,12,112,1199,436,11,425,225,200,0.36363636363636365,0.02522935779816514,0.9747706422018348,0.5160550458715596,0.45871559633027525
12113,12,113,947,412,14,398,241,157,0.4350580781414995,0.03398058252427184,0.9660194174757282,0.5849514563106796,0.38106796116504854
12114,12,114,1422,480,30,450,330,120,0.33755274261603374,0.0625,0.9375,0.6875,0.25
12115,12,115,1016,393,20,373,263,110,0.3868110236220472,0.05089058524173028,0.9491094147582697,0.6692111959287532,0.27989821882951654
12116,12,116,1034,430,17,413,283,130,0.4158607350096712,0.03953488372093023,0.9604651162790697,0.6581395348837209,0.3023255813953488
12117,12,117,1093,367,15,352,236,116,0.3357731015553522,0.04087193460490463,0.9591280653950953,0.6430517711171662,0.31607629427792916
12118,12,118,1142,361,19,342,222,120,0.3161120840630473,0.05263157894736842,0.9473684210526315,0.6149584487534626,0.33240997229916897
12119,12,119,1282,462,2,460,290,170,0.36037441497659906,0.004329004329004329,0.9956709956709957,0.6277056277056277,0.36796536796536794
12120,12,120,1287,530,29,501,312,189,0.41181041181041184,0.05471698113207547,0.9452830188679245,0.5886792452830188,0.35660377358490564
12121,12,121,1125,427,9,418,281,137,0.37955555555555553,0.02107728337236534,0.9789227166276346,0.65807962529274,0.32084309133489464
12122,12,122,1155,436,21,415,289,126,0.3774891774891775,0.0481651376146789,0.9518348623853211,0.6628440366972477,0.2889908256880734
12123,12,123,1205,408,16,392,246,146,0.3385892116182573,0.0392156862745098,0.9607843137254902,0.6029411764705882,0.35784313725490197
12124,12,124,1152,447,18,429,292,137,0.3880208333333333,0.040268456375838924,0.959731543624161,0.6532438478747203,0.30648769574944074
12125,12,125,1202,475,24,451,309,142,0.3951747088186356,0.05052631578947368,0.9494736842105264,0.6505263157894737,0.29894736842105263
12126,12,126,1329,534,27,507,350,157,0.4018058690744921,0.05056179775280899,0.949438202247191,0.6554307116104869,0.2940074906367041
12201,12,201,1072,464,41,423,243,180,0.43283582089552236,0.08836206896551724,0.9116379310344828,0.5237068965517241,0.3879310344827586
12202,12,202,1150,405,8,397,242,155,0.3521739130434783,0.019753086419753086,0.980246913580247,0.5975308641975309,0.38271604938271603
12203,12,203,1164,507,11,496,171,325,0.43556701030927836,0.021696252465483234,0.9783037475345168,0.33727810650887574,0.6410256410256411
12204,12,204,955,377,19,358,154,204,0.3947643979057592,0.050397877984084884,0.9496021220159151,0.40848806366047746,0.5411140583554377
12205,12,205,759,344,8,336,174,162,0.45322793148880103,0.023255813953488372,0.9767441860465116,0.5058139534883721,0.47093023255813954
12206,12,206,1282,394,2,392,189,203,0.3073322932917317,0.005076142131979695,0.9949238578680203,0.4796954314720812,0.5152284263959391
12207,12,207,1323,504,27,477,317,160,0.38095238095238093,0.05357142857142857,0.9464285714285714,0.628968253968254,0.31746031746031744
12208,12,208,1221,486,29,457,301,156,0.39803439803439805,0.059670781893004114,0.9403292181069959,0.6193415637860082,0.32098765432098764
12209,12,209,1228,442,27,415,252,163,0.35993485342019543,0.06108597285067873,0.9389140271493213,0.5701357466063348,0.36877828054298645
12210,12,210,1216,387,19,368,201,167,0.3182565789473684,0.04909560723514212,0.9509043927648578,0.5193798449612403,0.4315245478036176
12211,12,211,1333,537,28,509,248,261,0.4028507126781695,0.0521415270018622,0.9478584729981379,0.4618249534450652,0.4860335195530726
12212,12,212,1262,479,48,431,243,188,0.3795562599049128,0.10020876826722339,0.8997912317327766,0.5073068893528184,0.3924843423799583
12213,12,213,1132,463,26,437,250,187,0.4090106007067138,0.056155507559395246,0.9438444924406048,0.5399568034557235,0.4038876889848812
12214,12,214,1261,492,22,470,276,194,0.3901665344964314,0.044715447154471545,0.9552845528455285,0.5609756097560976,0.3943089430894309
12215,12,215,1345,527,23,504,274,230,0.39182156133828994,0.04364326375711575,0.9563567362428842,0.5199240986717267,0.4364326375711575
12216,12,216,924,353,30,323,208,115,0.38203463203463206,0.08498583569405099,0.9150141643059491,0.5892351274787535,0.32577903682719545
12217,12,217,1201,471,23,448,269,179,0.39217318900915904,0.04883227176220807,0.9511677282377919,0.5711252653927813,0.38004246284501064
12218,12,218,1006,294,13,281,197,84,0.2922465208747515,0.04421768707482993,0.95578231292517,0.6700680272108843,0.2857142857142857
12219,12,219,1015,402,16,386,225,161,0.3960591133004926,0.03980099502487562,0.9601990049751243,0.5597014925373134,0.40049751243781095
12220,12,220,1196,452,8,444,317,127,0.3779264214046823,0.017699115044247787,0.9823008849557522,0.7013274336283186,0.2809734513274336
12221,12,221,1275,445,37,408,238,170,0.34901960784313724,0.08314606741573034,0.9168539325842696,0.5348314606741573,0.38202247191011235
12222,12,222,1306,522,13,509,356,153,0.3996937212863706,0.02490421455938697,0.975095785440613,0.6819923371647509,0.29310344827586204
12223,12,223,564,290,13,277,106,171,0.5141843971631206,0.04482758620689655,0.9551724137931035,0.36551724137931035,0.5896551724137931
12224,12,224,330,152,8,144,84,60,0.46060606060606063,0.05263157894736842,0.9473684210526315,0.5526315789473685,0.39473684210526316
12225,12,225,1158,432,24,408,221,187,0.37305699481865284,0.05555555555555555,0.9444444444444444,0.5115740740740741,0.43287037037037035
12226,12,226,965,376,39,337,189,148,0.38963730569948185,0.10372340425531915,0.8962765957446809,0.5026595744680851,0.39361702127659576
12301,12,301,1313,603,23,580,158,422,0.45925361766945927,0.03814262023217247,0.9618573797678275,0.2620232172470978,0.6998341625207297
12302,12,302,1232,527,25,502,180,322,0.4277597402597403,0.04743833017077799,0.952561669829222,0.3415559772296015,0.6110056925996205
12303,12,303,1230,535,15,520,196,324,0.4349593495934959,0.028037383177570093,0.9719626168224299,0.3663551401869159,0.6056074766355141
12304,12,304,1032,404,15,389,136,253,0.39147286821705424,0.03712871287128713,0.9628712871287128,0.33663366336633666,0.6262376237623762
12305,12,305,1247,533,43,490,169,321,0.42742582197273454,0.08067542213883677,0.9193245778611632,0.3170731707317073,0.6022514071294559
12306,12,306,1375,587,14,573,206,367,0.4269090909090909,0.02385008517887564,0.9761499148211243,0.35093696763202725,0.6252129471890971
12307,12,307,1357,601,25,576,192,384,0.44288872512896094,0.04159733777038269,0.9584026622296173,0.3194675540765391,0.6389351081530782
12308,12,308,1264,498,14,484,168,316,0.3939873417721519,0.028112449799196786,0.9718875502008032,0.3373493975903614,0.6345381526104418
12309,12,309,1288,522,26,496,224,272,0.4052795031055901,0.04980842911877394,0.9501915708812261,0.42911877394636017,0.5210727969348659
12310,12,310,1181,496,9,487,172,315,0.41998306519898393,0.018145161290322582,0.9818548387096774,0.3467741935483871,0.6350806451612904
12311,12,311,1210,495,25,470,166,304,0.4090909090909091,0.050505050505050504,0.9494949494949495,0.33535353535353535,0.6141414141414141
12312,12,312,1334,540,17,523,182,341,0.4047976011994003,0.03148148148148148,0.9685185185185186,0.337037037037037,0.6314814814814815
12313,12,313,1256,518,23,495,188,307,0.4124203821656051,0.0444015444015444,0.9555984555984556,0.36293436293436293,0.5926640926640927
12314,12,314,1210,513,28,485,251,234,0.42396694214876035,0.05458089668615984,0.9454191033138402,0.48927875243664715,0.45614035087719296
12315,12,315,1187,480,16,464,145,319,0.4043807919123842,0.03333333333333333,0.9666666666666667,0.3020833333333333,0.6645833333333333
12316,12,316,1315,528,14,514,274,240,0.40152091254752853,0.026515151515151516,0.9734848484848485,0.5189393939393939,0.45454545454545453
12317,12,317,1270,480,45,435,226,209,0.3779527559055118,0.09375,0.90625,0.4708333333333333,0.4354166666666667
12318,12,318,1193,550,16,534,164,370,0.46102263202011734,0.02909090909090909,0.9709090909090909,0.29818181818181816,0.6727272727272727
12319,12,319,1357,518,49,469,266,203,0.3817243920412675,0.0945945945945946,0.9054054054054054,0.5135135135135135,0.3918918918918919
12320,12,320,1137,421,30,391,258,133,0.3702726473175022,0.07125890736342043,0.9287410926365796,0.6128266033254157,0.3159144893111639
12321,12,321,1275,561,31,530,302,228,0.44,0.05525846702317291,0.9447415329768271,0.5383244206773619,0.40641711229946526
12322,12,322,1363,573,42,531,313,218,0.4203961848862803,0.07329842931937172,0.9267015706806283,0.5462478184991274,0.38045375218150085
12323,12,323,1072,443,21,422,138,284,0.41324626865671643,0.04740406320541761,0.9525959367945824,0.3115124153498871,0.6410835214446953
12324,12,324,250,127,5,122,50,72,0.508,0.03937007874015748,0.9606299212598425,0.3937007874015748,0.5669291338582677
12325,12,325,1221,519,29,490,216,274,0.4250614250614251,0.055876685934489405,0.9441233140655106,0.4161849710982659,0.5279383429672447
12401,12,401,1454,647,18,629,235,394,0.4449793672627235,0.027820710973724884,0.9721792890262752,0.36321483771251933,0.6089644513137558
12402,12,402,1223,479,12,467,238,229,0.39165985282093213,0.025052192066805846,0.9749478079331941,0.4968684759916493,0.4780793319415449
12403,12,403,1147,404,16,388,174,214,0.35222319093286836,0.039603960396039604,0.9603960396039604,0.4306930693069307,0.5297029702970297
12404,12,404,1184,420,22,398,279,119,0.3547297297297297,0.05238095238095238,0.9476190476190476,0.6642857142857143,0.2833333333333333
12405,12,405,1318,495,46,449,289,160,0.37556904400606983,0.09292929292929293,0.907070707070707,0.5838383838383838,0.32323232323232326
12406,12,406,1325,516,20,496,266,230,0.38943396226415095,0.03875968992248062,0.9612403100775194,0.5155038759689923,0.44573643410852715
12407,12,407,1152,565,20,545,228,317,0.4904513888888889,0.035398230088495575,0.9646017699115044,0.40353982300884955,0.5610619469026549
12408,12,408,1396,658,24,634,281,353,0.4713467048710602,0.0364741641337386,0.9635258358662614,0.4270516717325228,0.5364741641337386
12409,12,409,1153,467,15,452,193,259,0.40503035559410233,0.032119914346895075,0.9678800856531049,0.4132762312633833,0.5546038543897216
12410,12,410,1027,506,35,471,241,230,0.49269717624148,0.0691699604743083,0.9308300395256917,0.4762845849802372,0.45454545454545453
12411,12,411,887,418,19,399,182,217,0.47125140924464487,0.045454545454545456,0.9545454545454546,0.4354066985645933,0.5191387559808612
12412,12,412,1363,619,26,593,299,294,0.4541452677916361,0.0420032310177706,0.9579967689822294,0.48303715670436187,0.47495961227786754
12413,12,413,1331,525,17,508,213,295,0.3944402704733283,0.03238095238095238,0.9676190476190476,0.4057142857142857,0.5619047619047619
12414,12,414,1420,593,17,576,297,279,0.4176056338028169,0.02866779089376054,0.9713322091062394,0.5008431703204047,0.47048903878583476
12415,12,415,1347,530,27,503,292,211,0.39346696362286565,0.0509433962264151,0.9490566037735849,0.5509433962264151,0.39811320754716983
12416,12,416,1346,583,10,573,343,230,0.43313521545319467,0.017152658662092625,0.9828473413379074,0.5883361921097771,0.39451114922813035
12417,12,417,1382,500,27,473,189,284,0.361794500723589,0.054,0.946,0.378,0.568
12418,12,418,1369,548,27,521,296,225,0.40029218407596784,0.04927007299270073,0.9507299270072993,0.5401459854014599,0.41058394160583944
12419,12,419,1440,539,28,511,226,285,0.37430555555555556,0.05194805194805195,0.948051948051948,0.41929499072356213,0.5287569573283859
12420,12,420,1302,527,0,527,300,227,0.40476190476190477,0.0,1.0,0.5692599620493358,0.4307400379506641
12421,12,421,1117,553,22,531,235,296,0.495076096687556,0.039783001808318265,0.9602169981916817,0.42495479204339964,0.5352622061482821
12422,12,422,1164,565,26,539,259,280,0.4853951890034364,0.04601769911504425,0.9539823008849557,0.4584070796460177,0.49557522123893805
12423,12,423,1291,563,23,540,313,227,0.4360960495739737,0.04085257548845471,0.9591474245115453,0.5559502664298401,0.40319715808170514
12424,12,424,1295,463,26,437,178,259,0.3575289575289575,0.056155507559395246,0.9438444924406048,0.38444924406047515,0.5593952483801296
12425,12,425,994,480,31,449,207,242,0.482897384305835,0.06458333333333334,0.9354166666666667,0.43125,0.5041666666666667
12426,12,426,953,332,16,316,176,140,0.3483735571878279,0.04819277108433735,0.9518072289156626,0.5301204819277109,0.42168674698795183
12427,12,427,1241,424,13,411,240,171,0.3416599516518936,0.030660377358490566,0.9693396226415094,0.5660377358490566,0.4033018867924528
12501,12,501,1192,539,25,514,203,311,0.4521812080536913,0.04638218923933209,0.9536178107606679,0.37662337662337664,0.5769944341372912
12502,12,502,1269,514,23,491,189,302,0.40504334121355395,0.04474708171206226,0.9552529182879378,0.36770428015564205,0.5875486381322957
12503,12,503,1344,582,23,559,223,336,0.4330357142857143,0.03951890034364261,0.9604810996563574,0.38316151202749144,0.5773195876288659
12504,12,504,1231,464,19,445,287,158,0.37692932575142163,0.040948275862068964,0.959051724137931,0.6185344827586207,0.34051724137931033
12505,12,505,842,355,16,339,160,179,0.42161520190023755,0.04507042253521127,0.9549295774647887,0.4507042253521127,0.504225352112676
12506,12,506,855,391,15,376,199,177,0.45730994152046783,0.03836317135549872,0.9616368286445013,0.5089514066496164,0.45268542199488493
12507,12,507,804,315,12,303,214,89,0.3917910447761194,0.0380952380952381,0.9619047619047619,0.6793650793650794,0.28253968253968254
12508,12,508,626,260,23,237,165,72,0.41533546325878595,0.08846153846153847,0.9115384615384615,0.6346153846153846,0.27692307692307694
12509,12,509,958,389,35,354,235,119,0.40605427974947805,0.08997429305912596,0.910025706940874,0.6041131105398457,0.3059125964010283
12510,12,510,736,271,13,258,165,93,0.36820652173913043,0.04797047970479705,0.9520295202952029,0.6088560885608856,0.34317343173431736
12511,12,511,1140,410,20,390,263,127,0.35964912280701755,0.04878048780487805,0.9512195121951219,0.6414634146341464,0.3097560975609756
12512,12,512,958,425,35,390,241,149,0.44363256784968685,0.08235294117647059,0.9176470588235294,0.5670588235294117,0.35058823529411764
12513,12,513,1177,422,17,405,256,149,0.35853865760407816,0.04028436018957346,0.9597156398104265,0.6066350710900474,0.35308056872037913
12514,12,514,1220,393,31,362,252,110,0.3221311475409836,0.07888040712468193,0.9211195928753181,0.6412213740458015,0.27989821882951654
12515,12,515,822,326,30,296,177,119,0.39659367396593675,0.09202453987730061,0.9079754601226994,0.5429447852760736,0.36503067484662577
12516,12,516,1233,503,26,477,310,167,0.40794809407948096,0.05168986083499006,0.94831013916501,0.6163021868787276,0.3320079522862823
12517,12,517,920,641,337,304,221,83,0.6967391304347826,0.5257410296411856,0.47425897035881437,0.34477379095163807,0.1294851794071763
12518,12,518,1141,452,41,411,218,193,0.39614373356704646,0.09070796460176991,0.9092920353982301,0.4823008849557522,0.4269911504424779
12519,12,519,1076,436,31,405,247,158,0.4052044609665427,0.07110091743119266,0.9288990825688074,0.5665137614678899,0.3623853211009174
12520,12,520,981,280,27,253,168,85,0.2854230377166157,0.09642857142857143,0.9035714285714286,0.6,0.30357142857142855
12521,12,521,1031,369,14,355,160,195,0.35790494665373423,0.037940379403794036,0.962059620596206,0.43360433604336046,0.5284552845528455
12522,12,522,784,264,16,248,152,96,0.336734693877551,0.06060606060606061,0.9393939393939394,0.5757575757575758,0.36363636363636365
12523,12,523,1158,498,31,467,311,156,0.43005181347150256,0.06224899598393574,0.9377510040160643,0.6244979919678715,0.3132530120481928
12524,12,524,1104,432,22,410,269,141,0.391304347826087,0.05092592592592592,0.9490740740740741,0.6226851851851852,0.3263888888888889
12525,12,525,781,322,15,307,123,184,0.41229193341869397,0.046583850931677016,0.953416149068323,0.38198757763975155,0.5714285714285714
12526,12,526,1243,510,29,481,280,201,0.4102976669348351,0.056862745098039215,0.9431372549019608,0.5490196078431373,0.3941176470588235
12601,12,601,266,154,8,146,95,51,0.5789473684210527,0.05194805194805195,0.948051948051948,0.6168831168831169,0.33116883116883117
12602,12,602,1313,688,29,659,182,477,0.523990860624524,0.04215116279069767,0.9578488372093024,0.26453488372093026,0.6933139534883721
12603,12,603,1172,538,15,523,189,334,0.4590443686006826,0.027881040892193308,0.9721189591078067,0.3513011152416357,0.620817843866171
12604,12,604,1035,456,9,447,117,330,0.4405797101449275,0.019736842105263157,0.9802631578947368,0.2565789473684211,0.7236842105263158
12605,12,605,902,406,16,390,125,265,0.4501108647450111,0.03940886699507389,0.9605911330049262,0.3078817733990148,0.6527093596059114
12606,12,606,1232,540,19,521,144,377,0.4383116883116883,0.03518518518518519,0.9648148148148148,0.26666666666666666,0.6981481481481482
12607,12,607,1009,467,19,448,137,311,0.4628344895936571,0.04068522483940043,0.9593147751605996,0.29336188436830835,0.6659528907922913
12608,12,608,722,293,16,277,73,204,0.40581717451523547,0.05460750853242321,0.9453924914675768,0.24914675767918087,0.6962457337883959
12609,12,609,1270,534,23,511,147,364,0.4204724409448819,0.04307116104868914,0.9569288389513109,0.2752808988764045,0.6816479400749064
12610,12,610,988,433,31,402,144,258,0.4382591093117409,0.07159353348729793,0.9284064665127021,0.3325635103926097,0.5958429561200924
12611,12,611,827,381,9,372,106,266,0.4607013301088271,0.023622047244094488,0.9763779527559056,0.2782152230971129,0.6981627296587927
12612,12,612,1244,480,14,466,133,333,0.3858520900321543,0.029166666666666667,0.9708333333333333,0.27708333333333335,0.69375
12613,12,613,1081,448,18,430,146,284,0.4144310823311748,0.04017857142857143,0.9598214285714286,0.32589285714285715,0.6339285714285714
12614,12,614,1261,506,16,490,202,288,0.401268834258525,0.03162055335968379,0.9683794466403162,0.39920948616600793,0.5691699604743083
12615,12,615,1300,548,16,532,186,346,0.42153846153846153,0.029197080291970802,0.9708029197080292,0.33941605839416056,0.6313868613138686
12616,12,616,1221,516,30,486,147,339,0.4226044226044226,0.05813953488372093,0.9418604651162791,0.28488372093023256,0.6569767441860465
12617,12,617,1220,500,16,484,219,265,0.4098360655737705,0.032,0.968,0.438,0.53
12618,12,618,1255,541,13,528,211,317,0.43107569721115535,0.024029574861367836,0.9759704251386322,0.3900184842883549,0.5859519408502772
12619,12,619,1291,641,32,609,195,414,0.4965143299767622,0.0499219968798752,0.9500780031201248,0.3042121684867395,0.6458658346333853
12620,12,620,1005,460,20,440,155,285,0.4577114427860697,0.043478260869565216,0.9565217391304348,0.33695652173913043,0.6195652173913043
12621,12,621,944,429,18,411,166,245,0.4544491525423729,0.04195804195804196,0.958041958041958,0.38694638694638694,0.5710955710955711
12622,12,622,1078,475,42,433,119,314,0.44063079777365494,0.08842105263157894,0.911578947368421,0.2505263157894737,0.6610526315789473
12623,12,623,892,391,7,384,124,260,0.4383408071748879,0.017902813299232736,0.9820971867007673,0.3171355498721228,0.6649616368286445
12624,12,624,1155,543,22,521,229,292,0.4701298701298701,0.040515653775322284,0.9594843462246777,0.42173112338858193,0.5377532228360957
12625,12,625,1120,531,32,499,193,306,0.47410714285714284,0.060263653483992465,0.9397363465160076,0.3634651600753296,0.576271186440678
12626,12,626,1211,514,18,496,152,344,0.4244426094137077,0.03501945525291829,0.9649805447470817,0.29571984435797666,0.669260700389105
121A,12,1A,0,584,9,575,326,249,inf,0.015410958904109588,0.9845890410958904,0.5582191780821918,0.4263698630136986
121B,12,1B,0,397,8,389,240,149,inf,0.020151133501259445,0.9798488664987406,0.6045340050377834,0.37531486146095716
121C,12,1C,0,459,10,449,277,172,inf,0.02178649237472767,0.9782135076252724,0.6034858387799564,0.3747276688453159
121D,12,1D,0,445,6,439,243,196,inf,0.01348314606741573,0.9865168539325843,0.5460674157303371,0.4404494382022472
121E,12,1E,0,397,6,391,231,160,inf,0.015113350125944584,0.9848866498740554,0.5818639798488665,0.40302267002518893
121F,12,1F,0,589,8,581,373,208,inf,0.013582342954159592,0.9864176570458404,0.633276740237691,0.3531409168081494
121G,12,1G,0,688,14,674,366,308,inf,0.020348837209302327,0.9796511627906976,0.5319767441860465,0.4476744186046512
121H,12,1H,0,461,10,451,295,156,inf,0.021691973969631236,0.9783080260303688,0.6399132321041214,0.3383947939262473
121I,12,1I,0,506,13,493,312,181,inf,0.025691699604743084,0.974308300395257,0.616600790513834,0.3577075098814229
121J,12,1J,0,648,7,641,398,243,inf,0.010802469135802469,0.9891975308641975,0.6141975308641975,0.375
121K,12,1K,0,540,1,539,330,209,inf,0.001851851851851852,0.9981481481481481,0.6111111111111112,0.387037037037037
121L,12,1L,0,642,8,634,411,223,inf,0.012461059190031152,0.9875389408099688,0.6401869158878505,0.34735202492211836
121M,12,1M,0,562,6,556,403,153,inf,0.010676156583629894,0.9893238434163701,0.7170818505338078,0.2722419928825623
122A,12,2A,0,592,6,586,311,275,inf,0.010135135135135136,0.9898648648648649,0.5253378378378378,0.46452702702702703
122B,12,2B,0,791,24,767,434,333,inf,0.03034134007585335,0.9696586599241467,0.5486725663716814,0.42098609355246525
122C,12,2C,0,490,54,436,163,273,inf,0.11020408163265306,0.889795918367347,0.3326530612244898,0.5571428571428572
122D,12,2D,0,565,11,554,270,284,inf,0.019469026548672566,0.9805309734513274,0.4778761061946903,0.5026548672566372
122E,12,2E,0,642,13,629,355,274,inf,0.020249221183800622,0.9797507788161994,0.5529595015576324,0.42679127725856697
122F,12,2F,0,670,16,654,337,317,inf,0.023880597014925373,0.9761194029850746,0.5029850746268657,0.47313432835820896
122G,12,2G,0,740,16,724,358,366,inf,0.021621621621621623,0.9783783783783784,0.4837837837837838,0.4945945945945946
122H,12,2H,0,617,7,610,344,266,inf,0.011345218800648298,0.9886547811993517,0.5575364667747164,0.43111831442463533
122I,12,2I,0,612,8,604,297,307,inf,0.013071895424836602,0.9869281045751634,0.4852941176470588,0.5016339869281046
122J,12,2J,0,415,6,409,241,168,inf,0.014457831325301205,0.9855421686746988,0.5807228915662651,0.40481927710843374
122K,12,2K,0,643,10,633,330,303,inf,0.015552099533437015,0.9844479004665629,0.5132192846034215,0.4712286158631415
122L,12,2L,0,487,6,481,257,224,inf,0.012320328542094456,0.9876796714579056,0.5277207392197125,0.459958932238193
122M,12,2M,0,480,8,472,252,220,inf,0.016666666666666666,0.9833333333333333,0.525,0.4583333333333333
123A,12,3A,0,507,7,500,163,337,inf,0.013806706114398421,0.9861932938856016,0.3214990138067061,0.6646942800788954
123B,12,3B,0,916,14,902,356,546,inf,0.015283842794759825,0.9847161572052402,0.388646288209607,0.5960698689956332
123C,12,3C,0,566,7,559,209,350,inf,0.012367491166077738,0.9876325088339223,0.36925795053003535,0.6183745583038869
123D,12,3D,0,834,9,825,329,496,inf,0.01079136690647482,0.9892086330935251,0.39448441247002397,0.5947242206235012
123E,12,3E,0,1122,15,1107,358,749,inf,0.013368983957219251,0.9866310160427807,0.31907308377896615,0.6675579322638147
123F,12,3F,0,1114,16,1098,366,732,inf,0.01436265709156194,0.9856373429084381,0.32854578096947934,0.6570915619389587
123G,12,3G,0,486,5,481,156,325,inf,0.0102880658436214,0.9897119341563786,0.32098765432098764,0.668724279835391
123H,12,3H,0,948,13,935,312,623,inf,0.013713080168776372,0.9862869198312236,0.3291139240506329,0.6571729957805907
123I,12,3I,0,939,11,928,324,604,inf,0.011714589989350373,0.9882854100106496,0.3450479233226837,0.6432374866879659
123J,12,3J,0,877,5,872,441,431,inf,0.005701254275940707,0.9942987457240593,0.5028506271379704,0.49144811858608894
123K,12,3K,0,745,14,731,391,340,inf,0.01879194630872483,0.9812080536912752,0.5248322147651007,0.4563758389261745
123L,12,3L,0,356,9,347,190,157,inf,0.025280898876404494,0.9747191011235955,0.5337078651685393,0.4410112359550562
123M,12,3M,0,617,13,604,364,240,inf,0.02106969205834684,0.9789303079416531,0.5899513776337115,0.3889789303079417
123N,12,3N,0,444,5,439,198,241,inf,0.01126126126126126,0.9887387387387387,0.44594594594594594,0.5427927927927928
123P,12,3P,0,497,6,491,181,310,inf,0.012072434607645875,0.9879275653923542,0.3641851106639839,0.6237424547283702
124A,12,4A,0,909,28,881,346,535,inf,0.030803080308030802,0.9691969196919692,0.38063806380638066,0.5885588558855885
124B,12,4B,0,725,15,710,298,412,inf,0.020689655172413793,0.9793103448275862,0.4110344827586207,0.5682758620689655
124C,12,4C,0,511,10,501,336,165,inf,0.019569471624266144,0.9804305283757339,0.6575342465753424,0.32289628180039137
124D,12,4D,0,878,11,867,414,453,inf,0.012528473804100227,0.9874715261958997,0.4715261958997722,0.5159453302961275
124E,12,4E,0,952,12,940,389,551,inf,0.012605042016806723,0.9873949579831933,0.40861344537815125,0.5787815126050421
124F,12,4F,0,943,63,880,401,479,inf,0.06680805938494168,0.9331919406150583,0.4252386002120891,0.5079533404029692
124G,12,4G,0,702,11,691,286,405,inf,0.01566951566951567,0.9843304843304843,0.4074074074074074,0.5769230769230769
124H,12,4H,0,812,14,798,398,400,inf,0.017241379310344827,0.9827586206896551,0.49014778325123154,0.49261083743842365
124I,12,4I,0,735,12,723,377,346,inf,0.0163265306122449,0.9836734693877551,0.5129251700680272,0.4707482993197279
124J,12,4J,0,525,12,513,188,325,inf,0.022857142857142857,0.9771428571428571,0.3580952380952381,0.6190476190476191
124K,12,4K,0,706,14,692,326,366,inf,0.019830028328611898,0.9801699716713881,0.46175637393767704,0.5184135977337111
124L,12,4L,0,580,11,569,273,296,inf,0.01896551724137931,0.9810344827586207,0.4706896551724138,0.5103448275862069
124M,12,4M,0,729,14,715,341,374,inf,0.019204389574759947,0.9807956104252401,0.46776406035665297,0.5130315500685871
124N,12,4N,0,818,11,807,449,358,inf,0.013447432762836185,0.9865525672371638,0.5488997555012225,0.43765281173594134
125A,12,5A,0,907,11,896,384,512,inf,0.012127894156560088,0.9878721058434399,0.42337375964718854,0.5644983461962514
125B,12,5B,0,639,10,629,250,379,inf,0.01564945226917058,0.9843505477308294,0.39123630672926446,0.593114241001565
125C,12,5C,0,617,16,601,297,304,inf,0.02593192868719611,0.9740680713128039,0.4813614262560778,0.49270664505672607
125D,12,5D,0,428,12,416,246,170,inf,0.028037383177570093,0.9719626168224299,0.5747663551401869,0.397196261682243
125E,12,5E,0,430,13,417,229,188,inf,0.030232558139534883,0.9697674418604652,0.5325581395348837,0.4372093023255814
125F,12,5F,0,483,6,477,264,213,inf,0.012422360248447204,0.9875776397515528,0.546583850931677,0.4409937888198758
125G,12,5G,0,557,14,543,297,246,inf,0.025134649910233394,0.9748653500897666,0.533213644524237,0.44165170556552963
125H,12,5H,0,626,21,605,296,309,inf,0.03354632587859425,0.9664536741214057,0.4728434504792332,0.4936102236421725
125I,12,5I,0,760,14,746,361,385,inf,0.018421052631578946,0.9815789473684211,0.475,0.506578947368421
125J,12,5J,0,431,5,426,262,164,inf,0.01160092807424594,0.988399071925754,0.6078886310904872,0.3805104408352668
126A,12,6A,0,529,13,516,175,341,inf,0.024574669187145556,0.9754253308128544,0.33081285444234404,0.6446124763705104
126B,12,6B,0,415,3,412,156,256,inf,0.007228915662650603,0.9927710843373494,0.3759036144578313,0.6168674698795181
126C,12,6C,0,541,13,528,141,387,inf,0.024029574861367836,0.9759704251386322,0.26062846580406657,0.7153419593345656
126D,12,6D,0,368,0,368,109,259,inf,0.0,1.0,0.296195652173913,0.7038043478260869
126E,12,6E,0,434,4,430,108,322,inf,0.009216589861751152,0.9907834101382489,0.2488479262672811,0.7419354838709677
126F,12,6F,0,364,1,363,116,247,inf,0.0027472527472527475,0.9972527472527473,0.31868131868131866,0.6785714285714286
126G,12,6G,0,638,7,631,176,455,inf,0.0109717868338558,0.9890282131661442,0.27586206896551724,0.713166144200627
126H,12,6H,0,563,8,555,167,388,inf,0.014209591474245116,0.9857904085257548,0.2966252220248668,0.6891651865008881
126I,12,6I,0,526,6,520,165,355,inf,0.011406844106463879,0.9885931558935361,0.31368821292775667,0.6749049429657795
126J,12,6J,0,874,4,870,286,584,inf,0.004576659038901602,0.9954233409610984,0.32723112128146453,0.6681922196796338
126K,12,6K,0,474,7,467,184,283,inf,0.014767932489451477,0.9852320675105485,0.3881856540084388,0.5970464135021097
126L,12,6L,0,500,7,493,163,330,inf,0.014,0.986,0.326,0.66
126M,12,6M,0,545,3,542,171,371,inf,0.005504587155963303,0.9944954128440368,0.3137614678899083,0.6807339449541284
126N,12,6N,0,495,7,488,207,281,inf,0.014141414141414142,0.9858585858585859,0.41818181818181815,0.5676767676767677
126P,12,6P,0,510,8,502,203,299,inf,0.01568627450980392,0.984313725490196,0.3980392156862745,0.5862745098039216
126Q,12,6Q,0,449,6,443,186,257,inf,0.013363028953229399,0.9866369710467706,0.4142538975501114,0.5723830734966593
126R,12,6R,0,407,5,402,138,264,inf,0.012285012285012284,0.9877149877149877,0.33906633906633904,0.6486486486486487
126S,12,6S,0,761,12,749,264,485,inf,0.01576872536136662,0.9842312746386334,0.3469119579500657,0.6373193166885677
126T,12,6T,0,449,7,442,127,315,inf,0.015590200445434299,0.9844097995545658,0.2828507795100223,0.7015590200445434
126U,12,6U,0,399,4,395,171,224,inf,0.010025062656641603,0.9899749373433584,0.42857142857142855,0.5614035087719298
126V,12,6V,0,373,4,369,175,194,inf,0.010723860589812333,0.9892761394101877,0.4691689008042895,0.5201072386058981
126W,12,6W,0,520,2,518,181,337,inf,0.0038461538461538464,0.9961538461538462,0.34807692307692306,0.6480769230769231
